AnyPadro;Seccio;GrupEdat;Dones;Homes;Total;IdSeccio
1997;306;00-02;19;14;33;SEC_306
1997;418;25-34;83;104;187;SEC_418
1997;439;25-34;102;103;205;SEC_439
1997;424;03-11;16;11;27;SEC_424
1997;231;25-34;96;81;177;SEC_231
1997;224;16-17;8;6;14;SEC_224
1997;206;03-11;30;28;58;SEC_206
1997;103;75 i +;43;24;67;SEC_103
1997;324;00-02;12;10;22;SEC_324
1997;106;18-24;129;171;300;SEC_106
1997;527;03-11;39;28;67;SEC_527
1997;106;00-02;16;14;30;SEC_106
1997;416;16-17;11;6;17;SEC_416
1997;105;00-02;10;18;28;SEC_105
1997;246;35-49;91;85;176;SEC_246
1997;415;12-15;14;13;27;SEC_415
1997;409;18-24;42;45;87;SEC_409
1997;133;25-34;75;76;151;SEC_133
1997;318;35-49;127;133;260;SEC_318
1997;113;00-02;7;13;20;SEC_113
1997;407;50-64;109;97;206;SEC_407
1997;206;75 i +;63;32;95;SEC_206
1997;536;16-17;10;14;24;SEC_536
1997;238;16-17;5;12;17;SEC_238
1997;530;35-49;106;107;213;SEC_530
1997;114;03-11;52;40;92;SEC_114
1997;317;75 i +;48;19;67;SEC_317
1997;249;12-15;13;22;35;SEC_249
1997;240;50-64;73;72;145;SEC_240
1997;622;16-17;21;12;33;SEC_622
1997;617;65-74;53;42;95;SEC_617
1997;538;12-15;18;19;37;SEC_538
1997;438;03-11;25;28;53;SEC_438
1997;213;12-15;12;24;36;SEC_213
1997;613;12-15;18;18;36;SEC_613
1997;613;65-74;57;46;103;SEC_613
1997;136;18-24;61;72;133;SEC_136
1997;220;75 i +;38;18;56;SEC_220
1997;303;65-74;91;102;193;SEC_303
1997;416;65-74;61;49;110;SEC_416
1997;245;03-11;31;29;60;SEC_245
1997;221;65-74;62;64;126;SEC_221
1997;427;16-17;8;5;13;SEC_427
1997;133;03-11;26;36;62;SEC_133
1997;106;65-74;50;32;82;SEC_106
1997;134;35-49;145;137;282;SEC_134
1997;414;75 i +;32;18;50;SEC_414
1997;408;16-17;9;7;16;SEC_408
1997;423;35-49;78;76;154;SEC_423
1997;125;03-11;36;37;73;SEC_125
1997;115;12-15;35;30;65;SEC_115
1997;138;35-49;117;120;237;SEC_138
1997;614;03-11;28;43;71;SEC_614
1997;416;50-64;89;80;169;SEC_416
1997;442;35-49;63;53;116;SEC_442
1997;235;16-17;9;12;21;SEC_235
1997;101;03-11;61;69;130;SEC_101
1997;236;25-34;78;84;162;SEC_236
1997;103;12-15;26;15;41;SEC_103
1997;407;12-15;12;21;33;SEC_407
1997;304;12-15;15;14;29;SEC_304
1997;520;35-49;93;76;169;SEC_520
1997;519;03-11;18;28;46;SEC_519
1997;419;35-49;49;71;120;SEC_419
1997;409;12-15;20;15;35;SEC_409
1997;619;65-74;69;56;125;SEC_619
1997;105;16-17;31;25;56;SEC_105
1997;316;16-17;49;58;107;SEC_316
1997;205;75 i +;29;16;45;SEC_205
1997;420;00-02;17;6;23;SEC_420
1997;301;00-02;21;26;47;SEC_301
1997;129;12-15;30;24;54;SEC_129
1997;419;18-24;44;54;98;SEC_419
1997;323;12-15;83;84;167;SEC_323
1997;418;00-02;12;14;26;SEC_418
1997;440;00-02;8;8;16;SEC_440
1997;312;00-02;9;15;24;SEC_312
1997;402;35-49;75;66;141;SEC_402
1997;123;03-11;39;46;85;SEC_123
1997;304;50-64;114;108;222;SEC_304
1997;102;50-64;195;210;405;SEC_102
1997;512;25-34;71;79;150;SEC_512
1997;530;16-17;8;19;27;SEC_530
1997;204;25-34;45;39;84;SEC_204
1997;309;65-74;27;27;54;SEC_309
1997;309;03-11;27;27;54;SEC_309
1997;438;00-02;9;5;14;SEC_438
1997;217;75 i +;46;16;62;SEC_217
1997;630;65-74;31;18;49;SEC_630
1997;239;18-24;47;55;102;SEC_239
1997;501;65-74;17;22;39;SEC_501
1997;221;35-49;105;91;196;SEC_221
1997;610;50-64;208;224;432;SEC_610
1997;503;18-24;68;73;141;SEC_503
1997;621;50-64;140;184;324;SEC_621
1997;112;25-34;118;110;228;SEC_112
1997;211;75 i +;72;37;109;SEC_211
1997;234;25-34;73;81;154;SEC_234
1997;239;12-15;15;18;33;SEC_239
1997;511;12-15;6;8;14;SEC_511
1997;302;65-74;48;43;91;SEC_302
1997;618;35-49;63;49;112;SEC_618
1997;206;65-74;58;52;110;SEC_206
1997;243;65-74;96;86;182;SEC_243
1997;433;50-64;86;86;172;SEC_433
1997;413;00-02;7;4;11;SEC_413
1997;420;50-64;128;121;249;SEC_420
1997;242;75 i +;49;38;87;SEC_242
1997;319;75 i +;31;15;46;SEC_319
1997;439;12-15;6;17;23;SEC_439
1997;529;75 i +;60;35;95;SEC_529
1997;323;50-64;159;184;343;SEC_323
1997;216;75 i +;47;30;77;SEC_216
1997;625;00-02;8;7;15;SEC_625
1997;201;12-15;14;8;22;SEC_201
1997;401;18-24;56;67;123;SEC_401
1997;417;18-24;38;44;82;SEC_417
1997;105;25-34;77;82;159;SEC_105
1997;126;00-02;5;6;11;SEC_126
1997;608;25-34;89;116;205;SEC_608
1997;125;18-24;102;112;214;SEC_125
1997;515;12-15;14;5;19;SEC_515
1997;412;35-49;192;193;385;SEC_412
1997;224;03-11;16;21;37;SEC_224
1997;534;16-17;12;11;23;SEC_534
1997;212;50-64;141;116;257;SEC_212
1997;228;35-49;40;54;94;SEC_228
1997;504;75 i +;50;34;84;SEC_504
1997;206;00-02;3;9;12;SEC_206
1997;306;75 i +;56;35;91;SEC_306
1997;426;03-11;26;31;57;SEC_426
1997;442;25-34;57;52;109;SEC_442
1997;112;50-64;128;119;247;SEC_112
1997;414;25-34;81;83;164;SEC_414
1997;502;00-02;11;8;19;SEC_502
1997;429;03-11;15;29;44;SEC_429
1997;409;75 i +;16;9;25;SEC_409
1997;502;50-64;152;165;317;SEC_502
1997;318;18-24;42;55;97;SEC_318
1997;408;18-24;44;53;97;SEC_408
1997;605;35-49;55;46;101;SEC_605
1997;505;18-24;140;133;273;SEC_505
1997;123;75 i +;55;36;91;SEC_123
1997;416;12-15;12;13;25;SEC_416
1997;432;75 i +;28;21;49;SEC_432
1997;609;16-17;12;9;21;SEC_609
1997;107;00-02;20;15;35;SEC_107
1997;526;35-49;55;60;115;SEC_526
1997;413;65-74;41;39;80;SEC_413
1997;421;18-24;66;71;137;SEC_421
1997;207;00-02;8;6;14;SEC_207
1997;537;65-74;76;59;135;SEC_537
1997;535;65-74;34;28;62;SEC_535
1997;401;00-02;8;11;19;SEC_401
1997;304;75 i +;72;40;112;SEC_304
1997;519;18-24;23;35;58;SEC_519
1997;135;16-17;19;32;51;SEC_135
1997;201;00-02;4;8;12;SEC_201
1997;106;03-11;78;70;148;SEC_106
1997;245;35-49;85;91;176;SEC_245
1997;538;25-34;102;94;196;SEC_538
1997;417;03-11;25;23;48;SEC_417
1997;127;50-64;54;48;102;SEC_127
1997;434;18-24;30;20;50;SEC_434
1997;430;00-02;9;12;21;SEC_430
1997;204;18-24;22;23;45;SEC_204
1997;629;25-34;49;57;106;SEC_629
1997;306;03-11;55;68;123;SEC_306
1997;202;50-64;77;77;154;SEC_202
1997;129;25-34;102;96;198;SEC_129
1997;527;18-24;50;41;91;SEC_527
1997;209;03-11;17;32;49;SEC_209
1997;224;25-34;39;50;89;SEC_224
1997;608;16-17;18;14;32;SEC_608
1997;242;50-64;118;102;220;SEC_242
1997;317;03-11;34;34;68;SEC_317
1997;111;35-49;111;98;209;SEC_111
1997;223;50-64;128;113;241;SEC_223
1997;619;18-24;100;102;202;SEC_619
1997;246;03-11;32;23;55;SEC_246
1997;130;00-02;7;12;19;SEC_130
1997;424;25-34;36;56;92;SEC_424
1997;131;18-24;111;135;246;SEC_131
1997;307;00-02;6;15;21;SEC_307
1997;116;65-74;62;59;121;SEC_116
1997;209;25-34;81;88;169;SEC_209
1997;245;18-24;30;63;93;SEC_245
1997;221;03-11;34;46;80;SEC_221
1997;625;12-15;55;50;105;SEC_625
1997;517;25-34;112;117;229;SEC_517
1997;225;65-74;56;34;90;SEC_225
1997;236;12-15;15;16;31;SEC_236
1997;611;65-74;76;64;140;SEC_611
1997;321;12-15;58;57;115;SEC_321
1997;139;16-17;19;9;28;SEC_139
1997;105;75 i +;38;29;67;SEC_105
1997;119;00-02;7;14;21;SEC_119
1997;628;65-74;46;37;83;SEC_628
1997;538;03-11;28;36;64;SEC_538
1997;312;16-17;15;11;26;SEC_312
1997;137;50-64;109;115;224;SEC_137
1997;418;75 i +;55;38;93;SEC_418
1997;138;12-15;20;35;55;SEC_138
1997;316;65-74;37;31;68;SEC_316
1997;624;03-11;34;43;77;SEC_624
1997;528;18-24;70;84;154;SEC_528
1997;138;65-74;30;31;61;SEC_138
1997;214;16-17;8;3;11;SEC_214
1997;131;35-49;193;172;365;SEC_131
1997;523;16-17;15;18;33;SEC_523
1997;313;12-15;58;50;108;SEC_313
1997;526;75 i +;29;17;46;SEC_526
1997;516;03-11;18;13;31;SEC_516
1997;204;50-64;53;49;102;SEC_204
1997;107;65-74;78;60;138;SEC_107
1997;117;75 i +;47;19;66;SEC_117
1997;441;50-64;168;177;345;SEC_441
1997;528;00-02;13;18;31;SEC_528
1997;228;16-17;7;2;9;SEC_228
1997;612;18-24;93;111;204;SEC_612
1997;110;50-64;143;139;282;SEC_110
1997;609;35-49;83;52;135;SEC_609
1997;323;03-11;120;112;232;SEC_323
1997;303;16-17;17;13;30;SEC_303
1997;136;12-15;27;30;57;SEC_136
1997;617;50-64;128;109;237;SEC_617
1997;504;16-17;9;16;25;SEC_504
1997;204;75 i +;24;18;42;SEC_204
1997;609;25-34;84;98;182;SEC_609
1997;534;18-24;59;70;129;SEC_534
1997;111;50-64;115;107;222;SEC_111
1997;319;50-64;67;67;134;SEC_319
1997;409;00-02;1;11;12;SEC_409
1997;535;50-64;135;161;296;SEC_535
1997;607;00-02;8;12;20;SEC_607
1997;239;75 i +;63;37;100;SEC_239
1997;106;50-64;126;155;281;SEC_106
1997;411;12-15;26;12;38;SEC_411
1997;615;35-49;75;48;123;SEC_615
1997;124;12-15;29;25;54;SEC_124
1997;221;25-34;90;90;180;SEC_221
1997;440;75 i +;53;34;87;SEC_440
1997;505;35-49;120;94;214;SEC_505
1997;524;35-49;95;105;200;SEC_524
1997;404;18-24;68;66;134;SEC_404
1997;308;18-24;102;93;195;SEC_308
1997;107;25-34;150;171;321;SEC_107
1997;519;35-49;38;41;79;SEC_519
1997;410;16-17;20;18;38;SEC_410
1997;224;50-64;55;40;95;SEC_224
1997;325;16-17;29;21;50;SEC_325
1997;122;35-49;56;50;106;SEC_122
1997;220;50-64;82;70;152;SEC_220
1997;414;65-74;68;63;131;SEC_414
1997;530;00-02;14;12;26;SEC_530
1997;605;16-17;9;11;20;SEC_605
1997;122;50-64;129;118;247;SEC_122
1997;140;00-02;5;6;11;SEC_140
1997;232;16-17;11;10;21;SEC_232
1997;213;00-02;10;7;17;SEC_213
1997;316;75 i +;27;16;43;SEC_316
1997;436;25-34;73;89;162;SEC_436
1997;418;18-24;65;63;128;SEC_418
1997;503;75 i +;15;10;25;SEC_503
1997;109;75 i +;49;23;72;SEC_109
1997;139;12-15;16;24;40;SEC_139
1997;207;25-34;55;45;100;SEC_207
1997;223;35-49;81;88;169;SEC_223
1997;249;00-02;10;13;23;SEC_249
1997;619;03-11;52;59;111;SEC_619
1997;426;35-49;79;85;164;SEC_426
1997;501;75 i +;25;10;35;SEC_501
1997;225;25-34;33;33;66;SEC_225
1997;232;18-24;48;50;98;SEC_232
1997;309;18-24;41;50;91;SEC_309
1997;115;35-49;167;153;320;SEC_115
1997;123;16-17;20;17;37;SEC_123
1997;105;12-15;19;32;51;SEC_105
1997;111;00-02;2;10;12;SEC_111
1997;535;75 i +;34;22;56;SEC_535
1997;215;00-02;13;7;20;SEC_215
1997;601;03-11;45;52;97;SEC_601
1997;510;00-02;8;5;13;SEC_510
1997;616;03-11;79;85;164;SEC_616
1997;315;16-17;14;25;39;SEC_315
1997;248;50-64;92;94;186;SEC_248
1997;213;65-74;61;49;110;SEC_213
1997;522;00-02;5;6;11;SEC_522
1997;426;12-15;9;18;27;SEC_426
1997;118;18-24;154;166;320;SEC_118
1997;440;65-74;50;47;97;SEC_440
1997;243;12-15;28;16;44;SEC_243
1997;440;25-34;71;96;167;SEC_440
1997;403;12-15;31;20;51;SEC_403
1997;306;12-15;39;30;69;SEC_306
1997;437;65-74;40;38;78;SEC_437
1997;422;25-34;75;78;153;SEC_422
1997;419;65-74;41;35;76;SEC_419
1997;428;18-24;18;22;40;SEC_428
1997;503;03-11;49;46;95;SEC_503
1997;123;12-15;27;25;52;SEC_123
1997;504;12-15;22;14;36;SEC_504
1997;605;18-24;51;66;117;SEC_605
1997;613;16-17;11;12;23;SEC_613
1997;210;35-49;81;88;169;SEC_210
1997;324;75 i +;46;17;63;SEC_324
1997;533;16-17;9;6;15;SEC_533
1997;423;16-17;14;13;27;SEC_423
1997;623;65-74;49;38;87;SEC_623
1997;404;12-15;26;20;46;SEC_404
1997;235;03-11;30;29;59;SEC_235
1997;537;12-15;26;23;49;SEC_537
1997;217;03-11;18;17;35;SEC_217
1997;411;03-11;34;22;56;SEC_411
1997;113;18-24;77;79;156;SEC_113
1997;102;25-34;140;157;297;SEC_102
1997;314;25-34;169;164;333;SEC_314
1997;522;75 i +;31;23;54;SEC_522
1997;315;65-74;53;41;94;SEC_315
1997;108;65-74;91;88;179;SEC_108
1997;535;03-11;41;42;83;SEC_535
1997;521;25-34;74;78;152;SEC_521
1997;106;35-49;289;255;544;SEC_106
1997;229;50-64;63;67;130;SEC_229
1997;515;00-02;7;5;12;SEC_515
1997;515;18-24;32;33;65;SEC_515
1997;110;16-17;14;17;31;SEC_110
1997;534;25-34;73;78;151;SEC_534
1997;524;65-74;71;52;123;SEC_524
1997;502;03-11;49;39;88;SEC_502
1997;415;35-49;62;70;132;SEC_415
1997;424;00-02;6;4;10;SEC_424
1997;401;50-64;121;109;230;SEC_401
1997;432;12-15;25;30;55;SEC_432
1997;319;12-15;22;31;53;SEC_319
1997;233;65-74;55;33;88;SEC_233
1997;623;00-02;16;18;34;SEC_623
1997;603;12-15;10;14;24;SEC_603
1997;423;65-74;61;44;105;SEC_423
1997;426;25-34;83;82;165;SEC_426
1997;118;03-11;88;73;161;SEC_118
1997;202;35-49;62;47;109;SEC_202
1997;521;18-24;115;135;250;SEC_521
1997;230;03-11;22;31;53;SEC_230
1997;442;03-11;21;21;42;SEC_442
1997;212;35-49;103;115;218;SEC_212
1997;127;16-17;8;18;26;SEC_127
1997;402;75 i +;38;25;63;SEC_402
1997;611;75 i +;45;28;73;SEC_611
1997;629;65-74;35;31;66;SEC_629
1997;108;25-34;98;96;194;SEC_108
1997;120;00-02;10;17;27;SEC_120
1997;223;18-24;49;47;96;SEC_223
1997;201;35-49;62;43;105;SEC_201
1997;624;12-15;32;30;62;SEC_624
1997;128;75 i +;30;20;50;SEC_128
1997;325;75 i +;128;65;193;SEC_325
1997;201;25-34;49;65;114;SEC_201
1997;517;18-24;57;72;129;SEC_517
1997;622;65-74;43;26;69;SEC_622
1997;137;75 i +;35;12;47;SEC_137
1997;215;50-64;90;70;160;SEC_215
1997;308;12-15;29;33;62;SEC_308
1997;630;16-17;21;26;47;SEC_630
1997;435;35-49;69;100;169;SEC_435
1997;431;25-34;103;109;212;SEC_431
1997;507;65-74;37;34;71;SEC_507
1997;212;03-11;37;50;87;SEC_212
1997;621;75 i +;24;13;37;SEC_621
1997;105;03-11;50;68;118;SEC_105
1997;507;03-11;34;34;68;SEC_507
1997;226;25-34;65;73;138;SEC_226
1997;627;18-24;105;106;211;SEC_627
1997;513;00-02;6;6;12;SEC_513
1997;101;18-24;68;62;130;SEC_101
1997;231;00-02;8;10;18;SEC_231
1997;214;25-34;61;69;130;SEC_214
1997;432;50-64;137;141;278;SEC_432
1997;220;03-11;20;27;47;SEC_220
1997;120;16-17;17;22;39;SEC_120
1997;417;50-64;72;56;128;SEC_417
1997;434;50-64;48;45;93;SEC_434
1997;246;65-74;79;61;140;SEC_246
1997;512;35-49;70;65;135;SEC_512
1997;631;75 i +;25;17;42;SEC_631
1997;320;00-02;3;5;8;SEC_320
1997;411;16-17;13;11;24;SEC_411
1997;618;18-24;57;54;111;SEC_618
1997;216;18-24;82;94;176;SEC_216
1997;311;35-49;127;102;229;SEC_311
1997;321;25-34;168;162;330;SEC_321
1997;612;03-11;35;30;65;SEC_612
1997;606;75 i +;31;13;44;SEC_606
1997;217;16-17;3;7;10;SEC_217
1997;404;16-17;12;13;25;SEC_404
1997;615;16-17;7;12;19;SEC_615
1997;135;03-11;71;51;122;SEC_135
1997;516;18-24;39;31;70;SEC_516
1997;427;18-24;40;46;86;SEC_427
1997;136;65-74;59;58;117;SEC_136
1997;121;65-74;97;79;176;SEC_121
1997;410;25-34;119;122;241;SEC_410
1997;426;75 i +;53;27;80;SEC_426
1997;533;12-15;12;15;27;SEC_533
1997;517;35-49;94;95;189;SEC_517
1997;434;75 i +;49;33;82;SEC_434
1997;313;35-49;247;226;473;SEC_313
1997;629;75 i +;23;11;34;SEC_629
1997;215;18-24;40;45;85;SEC_215
1997;502;35-49;153;135;288;SEC_502
1997;108;16-17;11;13;24;SEC_108
1997;405;16-17;6;7;13;SEC_405
1997;130;03-11;36;29;65;SEC_130
1997;424;35-49;54;51;105;SEC_424
1997;415;50-64;54;61;115;SEC_415
1997;626;12-15;17;15;32;SEC_626
1997;216;16-17;22;10;32;SEC_216
1997;515;75 i +;26;11;37;SEC_515
1997;433;75 i +;41;20;61;SEC_433
1997;247;12-15;9;20;29;SEC_247
1997;130;35-49;63;71;134;SEC_130
1997;308;16-17;19;19;38;SEC_308
1997;201;65-74;38;44;82;SEC_201
1997;422;50-64;90;88;178;SEC_422
1997;401;25-34;78;96;174;SEC_401
1997;519;25-34;64;57;121;SEC_519
1997;209;50-64;97;87;184;SEC_209
1997;624;50-64;152;181;333;SEC_624
1997;433;16-17;11;12;23;SEC_433
1997;522;25-34;47;55;102;SEC_522
1997;504;18-24;92;107;199;SEC_504
1997;606;00-02;10;15;25;SEC_606
1997;625;50-64;115;132;247;SEC_625
1997;425;03-11;26;26;52;SEC_425
1997;607;35-49;85;89;174;SEC_607
1997;514;03-11;36;19;55;SEC_514
1997;508;03-11;21;19;40;SEC_508
1997;306;18-24;78;80;158;SEC_306
1997;403;35-49;107;88;195;SEC_403
1997;608;03-11;41;51;92;SEC_608
1997;505;12-15;29;27;56;SEC_505
1997;104;75 i +;56;26;82;SEC_104
1997;413;03-11;23;24;47;SEC_413
1997;523;03-11;28;37;65;SEC_523
1997;403;65-74;59;53;112;SEC_403
1997;621;25-34;115;121;236;SEC_621
1997;617;16-17;13;16;29;SEC_617
1997;537;25-34;113;111;224;SEC_537
1997;225;00-02;3;5;8;SEC_225
1997;609;12-15;11;18;29;SEC_609
1997;216;65-74;79;67;146;SEC_216
1997;119;65-74;67;57;124;SEC_119
1997;126;25-34;91;109;200;SEC_126
1997;416;18-24;33;40;73;SEC_416
1997;519;00-02;4;9;13;SEC_519
1997;511;65-74;61;48;109;SEC_511
1997;616;18-24;176;193;369;SEC_616
1997;628;00-02;6;7;13;SEC_628
1997;122;16-17;9;8;17;SEC_122
1997;603;16-17;8;13;21;SEC_603
1997;249;16-17;8;7;15;SEC_249
1997;623;12-15;30;39;69;SEC_623
1997;424;75 i +;19;11;30;SEC_424
1997;124;65-74;40;33;73;SEC_124
1997;522;12-15;23;14;37;SEC_522
1997;137;00-02;14;13;27;SEC_137
1997;627;50-64;90;111;201;SEC_627
1997;631;25-34;92;98;190;SEC_631
1997;206;16-17;10;7;17;SEC_206
1997;514;16-17;11;11;22;SEC_514
1997;116;00-02;17;17;34;SEC_116
1997;528;50-64;136;135;271;SEC_528
1997;401;35-49;119;114;233;SEC_401
1997;135;50-64;139;144;283;SEC_135
1997;309;12-15;14;13;27;SEC_309
1997;622;12-15;26;31;57;SEC_622
1997;125;12-15;24;27;51;SEC_125
1997;405;18-24;41;51;92;SEC_405
1997;220;18-24;40;34;74;SEC_220
1997;134;25-34;110;104;214;SEC_134
1997;501;03-11;35;37;72;SEC_501
1997;324;50-64;73;77;150;SEC_324
1997;102;18-24;134;147;281;SEC_102
1997;405;00-02;7;10;17;SEC_405
1997;436;50-64;70;65;135;SEC_436
1997;325;50-64;194;183;377;SEC_325
1997;232;25-34;72;69;141;SEC_232
1997;230;50-64;80;70;150;SEC_230
1997;422;12-15;26;15;41;SEC_422
1997;538;00-02;12;10;22;SEC_538
1997;419;25-34;72;84;156;SEC_419
1997;131;12-15;36;26;62;SEC_131
1997;102;03-11;56;63;119;SEC_102
1997;136;16-17;19;22;41;SEC_136
1997;227;03-11;13;16;29;SEC_227
1997;308;75 i +;57;34;91;SEC_308
1997;130;50-64;120;102;222;SEC_130
1997;513;25-34;64;70;134;SEC_513
1997;213;16-17;15;16;31;SEC_213
1997;305;18-24;62;65;127;SEC_305
1997;210;03-11;27;29;56;SEC_210
1997;630;18-24;79;90;169;SEC_630
1997;209;75 i +;76;37;113;SEC_209
1997;523;18-24;77;65;142;SEC_523
1997;201;16-17;6;9;15;SEC_201
1997;601;35-49;142;133;275;SEC_601
1997;212;25-34;112;105;217;SEC_212
1997;426;16-17;10;11;21;SEC_426
1997;616;12-15;61;59;120;SEC_616
1997;227;18-24;38;39;77;SEC_227
1997;239;65-74;95;71;166;SEC_239
1997;203;25-34;59;57;116;SEC_203
1997;412;03-11;55;62;117;SEC_412
1997;435;00-02;4;13;17;SEC_435
1997;128;25-34;92;95;187;SEC_128
1997;311;00-02;8;13;21;SEC_311
1997;407;25-34;95;109;204;SEC_407
1997;507;25-34;73;89;162;SEC_507
1997;245;50-64;98;75;173;SEC_245
1997;610;35-49;118;79;197;SEC_610
1997;123;35-49;124;125;249;SEC_123
1997;533;25-34;85;96;181;SEC_533
1997;227;35-49;63;46;109;SEC_227
1997;236;03-11;32;29;61;SEC_236
1997;401;12-15;20;38;58;SEC_401
1997;315;50-64;103;125;228;SEC_315
1997;609;18-24;87;75;162;SEC_609
1997;409;35-49;63;66;129;SEC_409
1997;115;18-24;71;111;182;SEC_115
1997;502;25-34;113;114;227;SEC_502
1997;305;50-64;102;104;206;SEC_305
1997;603;35-49;53;47;100;SEC_603
1997;407;18-24;41;53;94;SEC_407
1997;508;75 i +;20;17;37;SEC_508
1997;433;03-11;50;30;80;SEC_433
1997;237;18-24;62;72;134;SEC_237
1997;412;75 i +;45;29;74;SEC_412
1997;222;75 i +;31;17;48;SEC_222
1997;509;12-15;18;10;28;SEC_509
1997;405;12-15;10;11;21;SEC_405
1997;625;03-11;58;73;131;SEC_625
1997;533;18-24;54;53;107;SEC_533
1997;139;35-49;96;102;198;SEC_139
1997;628;75 i +;27;12;39;SEC_628
1997;241;00-02;9;6;15;SEC_241
1997;429;18-24;42;43;85;SEC_429
1997;607;16-17;10;14;24;SEC_607
1997;118;75 i +;26;17;43;SEC_118
1997;433;00-02;14;20;34;SEC_433
1997;301;16-17;17;25;42;SEC_301
1997;322;12-15;36;18;54;SEC_322
1997;509;35-49;67;60;127;SEC_509
1997;217;25-34;51;55;106;SEC_217
1997;244;65-74;54;36;90;SEC_244
1997;237;35-49;104;109;213;SEC_237
1997;305;03-11;80;54;134;SEC_305
1997;511;03-11;9;17;26;SEC_511
1997;503;25-34;75;52;127;SEC_503
1997;602;16-17;8;4;12;SEC_602
1997;225;12-15;10;13;23;SEC_225
1997;618;50-64;75;84;159;SEC_618
1997;631;00-02;13;9;22;SEC_631
1997;207;35-49;69;61;130;SEC_207
1997;503;50-64;65;77;142;SEC_503
1997;607;65-74;56;46;102;SEC_607
1997;624;75 i +;26;12;38;SEC_624
1997;509;50-64;85;91;176;SEC_509
1997;411;65-74;83;79;162;SEC_411
1997;120;18-24;90;99;189;SEC_120
1997;440;12-15;18;8;26;SEC_440
1997;312;12-15;20;28;48;SEC_312
1997;131;75 i +;32;19;51;SEC_131
1997;537;16-17;15;16;31;SEC_537
1997;110;25-34;84;102;186;SEC_110
1997;605;12-15;7;10;17;SEC_605
1997;435;12-15;7;24;31;SEC_435
1997;501;16-17;23;26;49;SEC_501
1997;312;75 i +;39;29;68;SEC_312
1997;601;00-02;11;13;24;SEC_601
1997;211;35-49;91;98;189;SEC_211
1997;412;16-17;21;34;55;SEC_412
1997;424;18-24;35;49;84;SEC_424
1997;226;75 i +;72;35;107;SEC_226
1997;403;00-02;0;5;5;SEC_403
1997;125;35-49;151;124;275;SEC_125
1997;107;12-15;40;44;84;SEC_107
1997;412;50-64;183;178;361;SEC_412
1997;431;65-74;83;73;156;SEC_431
1997;302;03-11;56;47;103;SEC_302
1997;606;50-64;129;108;237;SEC_606
1997;304;03-11;35;51;86;SEC_304
1997;510;25-34;99;109;208;SEC_510
1997;619;25-34;116;130;246;SEC_619
1997;538;18-24;70;68;138;SEC_538
1997;319;25-34;60;64;124;SEC_319
1997;521;00-02;7;11;18;SEC_521
1997;434;65-74;70;42;112;SEC_434
1997;136;35-49;143;137;280;SEC_136
1997;137;18-24;100;92;192;SEC_137
1997;408;35-49;88;90;178;SEC_408
1997;225;18-24;22;26;48;SEC_225
1997;228;00-02;3;8;11;SEC_228
1997;310;50-64;68;72;140;SEC_310
1997;516;35-49;46;60;106;SEC_516
1997;105;18-24;82;71;153;SEC_105
1997;311;75 i +;74;36;110;SEC_311
1997;529;03-11;24;33;57;SEC_529
1997;613;35-49;95;75;170;SEC_613
1997;320;65-74;29;12;41;SEC_320
1997;415;18-24;27;35;62;SEC_415
1997;211;12-15;14;17;31;SEC_211
1997;249;50-64;110;92;202;SEC_249
1997;627;03-11;32;62;94;SEC_627
1997;127;75 i +;28;12;40;SEC_127
1997;306;25-34;113;119;232;SEC_306
1997;621;12-15;36;62;98;SEC_621
1997;305;00-02;15;18;33;SEC_305
1997;310;25-34;64;61;125;SEC_310
1997;526;12-15;11;13;24;SEC_526
1997;212;18-24;72;76;148;SEC_212
1997;439;00-02;10;13;23;SEC_439
1997;236;18-24;52;46;98;SEC_236
1997;533;65-74;47;56;103;SEC_533
1997;211;50-64;99;81;180;SEC_211
1997;435;25-34;67;81;148;SEC_435
1997;124;18-24;64;47;111;SEC_124
1997;419;75 i +;37;19;56;SEC_419
1997;533;35-49;64;73;137;SEC_533
1997;207;12-15;11;14;25;SEC_207
1997;511;18-24;51;43;94;SEC_511
1997;427;50-64;90;56;146;SEC_427
1997;127;18-24;27;36;63;SEC_127
1997;139;75 i +;28;7;35;SEC_139
1997;232;35-49;80;69;149;SEC_232
1997;241;16-17;11;7;18;SEC_241
1997;614;12-15;15;22;37;SEC_614
1997;140;18-24;67;68;135;SEC_140
1997;618;03-11;15;21;36;SEC_618
1997;128;16-17;18;12;30;SEC_128
1997;620;12-15;18;9;27;SEC_620
1997;246;00-02;13;12;25;SEC_246
1997;121;75 i +;40;22;62;SEC_121
1997;234;35-49;75;64;139;SEC_234
1997;318;00-02;13;16;29;SEC_318
1997;238;25-34;58;56;114;SEC_238
1997;133;65-74;56;45;101;SEC_133
1997;608;50-64;116;81;197;SEC_608
1997;136;75 i +;43;25;68;SEC_136
1997;606;16-17;16;10;26;SEC_606
1997;324;25-34;74;76;150;SEC_324
1997;602;03-11;20;13;33;SEC_602
1997;418;35-49;102;102;204;SEC_418
1997;325;03-11;47;54;101;SEC_325
1997;435;16-17;10;8;18;SEC_435
1997;245;00-02;6;9;15;SEC_245
1997;405;25-34;82;87;169;SEC_405
1997;109;35-49;135;144;279;SEC_109
1997;529;00-02;7;10;17;SEC_529
1997;527;65-74;67;46;113;SEC_527
1997;239;00-02;4;8;12;SEC_239
1997;413;25-34;41;46;87;SEC_413
1997;128;18-24;67;77;144;SEC_128
1997;113;25-34;89;77;166;SEC_113
1997;322;75 i +;37;17;54;SEC_322
1997;218;25-34;53;53;106;SEC_218
1997;516;65-74;35;25;60;SEC_516
1997;243;50-64;148;124;272;SEC_243
1997;214;50-64;71;68;139;SEC_214
1997;534;03-11;22;29;51;SEC_534
1997;310;18-24;41;59;100;SEC_310
1997;309;00-02;4;12;16;SEC_309
1997;223;03-11;36;41;77;SEC_223
1997;413;35-49;48;46;94;SEC_413
1997;119;03-11;44;52;96;SEC_119
1997;410;18-24;115;119;234;SEC_410
1997;424;12-15;9;14;23;SEC_424
1997;202;18-24;41;36;77;SEC_202
1997;408;65-74;50;44;94;SEC_408
1997;520;50-64;83;95;178;SEC_520
1997;207;65-74;64;35;99;SEC_207
1997;523;12-15;30;27;57;SEC_523
1997;404;03-11;49;42;91;SEC_404
1997;221;50-64;115;122;237;SEC_221
1997;118;65-74;47;30;77;SEC_118
1997;138;50-64;82;67;149;SEC_138
1997;301;75 i +;80;32;112;SEC_301
1997;522;18-24;35;45;80;SEC_522
1997;121;35-49;49;70;119;SEC_121
1997;514;35-49;60;69;129;SEC_514
1997;244;18-24;36;21;57;SEC_244
1997;430;65-74;58;47;105;SEC_430
1997;316;50-64;128;160;288;SEC_316
1997;632;35-49;102;104;206;SEC_632
1997;203;35-49;55;60;115;SEC_203
1997;235;25-34;120;113;233;SEC_235
1997;512;75 i +;40;18;58;SEC_512
1997;228;12-15;6;10;16;SEC_228
1997;208;18-24;85;89;174;SEC_208
1997;119;35-49;176;153;329;SEC_119
1997;205;16-17;10;15;25;SEC_205
1997;205;00-02;10;9;19;SEC_205
1997;524;50-64;130;114;244;SEC_524
1997;249;65-74;75;63;138;SEC_249
1997;523;00-02;8;12;20;SEC_523
1997;625;16-17;42;42;84;SEC_625
1997;322;18-24;83;79;162;SEC_322
1997;221;18-24;70;66;136;SEC_221
1997;421;03-11;28;36;64;SEC_421
1997;406;16-17;17;15;32;SEC_406
1997;306;65-74;103;76;179;SEC_306
1997;414;12-15;13;24;37;SEC_414
1997;408;75 i +;28;19;47;SEC_408
1997;410;00-02;16;16;32;SEC_410
1997;521;12-15;21;21;42;SEC_521
1997;514;00-02;8;10;18;SEC_514
1997;622;18-24;76;76;152;SEC_622
1997;125;50-64;112;136;248;SEC_125
1997;207;03-11;21;21;42;SEC_207
1997;322;16-17;14;22;36;SEC_322
1997;211;18-24;33;51;84;SEC_211
1997;409;50-64;88;81;169;SEC_409
1997;122;65-74;47;33;80;SEC_122
1997;434;16-17;6;5;11;SEC_434
1997;305;75 i +;70;39;109;SEC_305
1997;411;25-34;67;67;134;SEC_411
1997;536;03-11;30;25;55;SEC_536
1997;238;00-02;3;4;7;SEC_238
1997;425;50-64;101;89;190;SEC_425
1997;319;35-49;109;93;202;SEC_319
1997;103;50-64;71;65;136;SEC_103
1997;229;65-74;56;40;96;SEC_229
1997;422;75 i +;58;38;96;SEC_422
1997;218;75 i +;38;17;55;SEC_218
1997;307;50-64;157;145;302;SEC_307
1997;311;18-24;79;86;165;SEC_311
1997;304;35-49;97;99;196;SEC_304
1997;318;03-11;48;57;105;SEC_318
1997;510;03-11;31;37;68;SEC_510
1997;502;12-15;36;32;68;SEC_502
1997;249;35-49;92;91;183;SEC_249
1997;433;65-74;53;42;95;SEC_433
1997;604;00-02;13;11;24;SEC_604
1997;135;18-24;82;102;184;SEC_135
1997;622;00-02;8;23;31;SEC_622
1997;126;75 i +;40;17;57;SEC_126
1997;211;65-74;101;79;180;SEC_211
1997;406;35-49;133;135;268;SEC_406
1997;317;25-34;67;87;154;SEC_317
1997;118;12-15;63;67;130;SEC_118
1997;309;50-64;59;60;119;SEC_309
1997;428;00-02;3;4;7;SEC_428
1997;108;35-49;147;137;284;SEC_108
1997;321;65-74;88;74;162;SEC_321
1997;616;00-02;19;19;38;SEC_616
1997;514;75 i +;32;13;45;SEC_514
1997;227;75 i +;43;19;62;SEC_227
1997;421;50-64;152;122;274;SEC_421
1997;410;65-74;110;108;218;SEC_410
1997;607;50-64;162;150;312;SEC_607
1997;410;03-11;41;39;80;SEC_410
1997;530;50-64;146;131;277;SEC_530
1997;613;25-34;151;162;313;SEC_613
1997;128;00-02;8;13;21;SEC_128
1997;223;75 i +;53;26;79;SEC_223
1997;601;18-24;107;130;237;SEC_601
1997;204;03-11;10;23;33;SEC_204
1997;103;16-17;8;14;22;SEC_103
1997;315;75 i +;50;20;70;SEC_315
1997;216;25-34;87;95;182;SEC_216
1997;313;18-24;122;123;245;SEC_313
1997;432;25-34;84;86;170;SEC_432
1997;218;50-64;74;72;146;SEC_218
1997;513;50-64;102;91;193;SEC_513
1997;306;35-49;184;172;356;SEC_306
1997;442;00-02;9;6;15;SEC_442
1997;226;50-64;94;88;182;SEC_226
1997;527;25-34;78;88;166;SEC_527
1997;620;35-49;72;66;138;SEC_620
1997;604;35-49;65;68;133;SEC_604
1997;308;35-49;156;141;297;SEC_308
1997;441;18-24;122;129;251;SEC_441
1997;109;00-02;7;16;23;SEC_109
1997;507;18-24;63;64;127;SEC_507
1997;128;03-11;29;40;69;SEC_128
1997;436;35-49;66;76;142;SEC_436
1997;201;75 i +;38;10;48;SEC_201
1997;427;65-74;62;57;119;SEC_427
1997;420;25-34;99;101;200;SEC_420
1997;302;16-17;25;21;46;SEC_302
1997;517;75 i +;54;29;83;SEC_517
1997;604;65-74;30;26;56;SEC_604
1997;225;16-17;4;10;14;SEC_225
1997;537;00-02;14;9;23;SEC_537
1997;506;12-15;43;51;94;SEC_506
1997;511;75 i +;29;11;40;SEC_511
1997;624;25-34;78;114;192;SEC_624
1997;319;16-17;15;13;28;SEC_319
1997;208;35-49;178;165;343;SEC_208
1997;120;50-64;102;113;215;SEC_120
1997;212;00-02;7;11;18;SEC_212
1997;620;75 i +;11;1;12;SEC_620
1997;316;12-15;116;128;244;SEC_316
1997;515;65-74;32;25;57;SEC_515
1997;628;12-15;30;32;62;SEC_628
1997;612;50-64;190;177;367;SEC_612
1997;508;00-02;6;8;14;SEC_508
1997;417;00-02;5;4;9;SEC_417
1997;240;16-17;5;5;10;SEC_240
1997;531;00-02;7;5;12;SEC_531
1997;612;25-34;97;124;221;SEC_612
1997;248;16-17;8;18;26;SEC_248
1997;213;75 i +;22;14;36;SEC_213
1997;313;03-11;83;69;152;SEC_313
1997;311;65-74;90;71;161;SEC_311
1997;516;50-64;72;63;135;SEC_516
1997;243;16-17;11;10;21;SEC_243
1997;133;18-24;55;65;120;SEC_133
1997;436;03-11;24;27;51;SEC_436
1997;223;12-15;9;19;28;SEC_223
1997;512;65-74;47;35;82;SEC_512
1997;435;75 i +;91;43;134;SEC_435
1997;615;25-34;89;99;188;SEC_615
1997;320;12-15;8;8;16;SEC_320
1997;239;03-11;22;34;56;SEC_239
1997;601;12-15;32;33;65;SEC_601
1997;412;65-74;75;76;151;SEC_412
1997;409;65-74;33;31;64;SEC_409
1997;629;35-49;64;57;121;SEC_629
1997;429;12-15;11;17;28;SEC_429
1997;630;25-34;63;75;138;SEC_630
1997;126;16-17;16;13;29;SEC_126
1997;314;18-24;139;148;287;SEC_314
1997;530;25-34;116;122;238;SEC_530
1997;517;16-17;12;14;26;SEC_517
1997;623;35-49;184;150;334;SEC_623
1997;631;12-15;24;19;43;SEC_631
1997;304;65-74;96;64;160;SEC_304
1997;230;16-17;6;7;13;SEC_230
1997;429;75 i +;31;20;51;SEC_429
1997;135;12-15;35;39;74;SEC_135
1997;310;12-15;29;21;50;SEC_310
1997;140;12-15;11;13;24;SEC_140
1997;208;75 i +;115;65;180;SEC_208
1997;313;75 i +;56;31;87;SEC_313
1997;126;65-74;63;44;107;SEC_126
1997;103;35-49;82;65;147;SEC_103
1997;423;50-64;126;124;250;SEC_423
1997;628;35-49;125;89;214;SEC_628
1997;323;35-49;405;384;789;SEC_323
1997;241;65-74;74;46;120;SEC_241
1997;627;25-34;68;81;149;SEC_627
1997;501;35-49;157;131;288;SEC_501
1997;217;12-15;12;12;24;SEC_217
1997;428;35-49;45;40;85;SEC_428
1997;425;00-02;5;10;15;SEC_425
1997;533;50-64;95;86;181;SEC_533
1997;615;00-02;3;4;7;SEC_615
1997;132;16-17;30;44;74;SEC_132
1997;233;03-11;23;19;42;SEC_233
1997;220;12-15;11;15;26;SEC_220
1997;421;35-49;83;76;159;SEC_421
1997;229;03-11;15;21;36;SEC_229
1997;627;00-02;8;15;23;SEC_627
1997;233;50-64;81;76;157;SEC_233
1997;427;00-02;5;9;14;SEC_427
1997;135;35-49;174;163;337;SEC_135
1997;404;50-64;145;124;269;SEC_404
1997;312;18-24;87;105;192;SEC_312
1997;415;25-34;69;56;125;SEC_415
1997;318;25-34;77;62;139;SEC_318
1997;221;75 i +;40;29;69;SEC_221
1997;509;75 i +;38;16;54;SEC_509
1997;439;50-64;107;103;210;SEC_439
1997;517;50-64;114;106;220;SEC_517
1997;622;75 i +;35;11;46;SEC_622
1997;430;18-24;48;42;90;SEC_430
1997;140;25-34;82;92;174;SEC_140
1997;532;50-64;157;156;313;SEC_532
1997;238;65-74;63;47;110;SEC_238
1997;236;65-74;91;69;160;SEC_236
1997;205;50-64;86;77;163;SEC_205
1997;218;00-02;10;1;11;SEC_218
1997;613;18-24;125;109;234;SEC_613
1997;102;00-02;12;19;31;SEC_102
1997;301;18-24;134;134;268;SEC_301
1997;408;50-64;91;78;169;SEC_408
1997;531;75 i +;39;24;63;SEC_531
1997;233;35-49;52;53;105;SEC_233
1997;430;25-34;71;73;144;SEC_430
1997;324;35-49;79;76;155;SEC_324
1997;240;18-24;37;31;68;SEC_240
1997;305;65-74;85;66;151;SEC_305
1997;233;18-24;28;38;66;SEC_233
1997;506;50-64;196;218;414;SEC_506
1997;203;03-11;14;18;32;SEC_203
1997;411;18-24;71;76;147;SEC_411
1997;439;16-17;7;8;15;SEC_439
1997;206;12-15;13;11;24;SEC_206
1997;504;65-74;58;62;120;SEC_504
1997;415;16-17;12;6;18;SEC_415
1997;623;75 i +;45;27;72;SEC_623
1997;102;65-74;86;62;148;SEC_102
1997;125;75 i +;27;23;50;SEC_125
1997;245;12-15;14;15;29;SEC_245
1997;407;65-74;85;71;156;SEC_407
1997;506;00-02;22;23;45;SEC_506
1997;430;03-11;21;32;53;SEC_430
1997;432;18-24;80;89;169;SEC_432
1997;315;18-24;105;79;184;SEC_315
1997;620;50-64;91;89;180;SEC_620
1997;301;65-74;94;79;173;SEC_301
1997;110;12-15;28;27;55;SEC_110
1997;434;25-34;34;38;72;SEC_434
1997;433;12-15;17;23;40;SEC_433
1997;247;65-74;88;67;155;SEC_247
1997;140;16-17;11;11;22;SEC_140
1997;431;50-64;121;110;231;SEC_431
1997;508;12-15;17;11;28;SEC_508
1997;215;12-15;14;13;27;SEC_215
1997;514;65-74;31;33;64;SEC_514
1997;605;25-34;65;70;135;SEC_605
1997;204;16-17;4;5;9;SEC_204
1997;111;18-24;56;93;149;SEC_111
1997;509;03-11;23;29;52;SEC_509
1997;210;25-34;59;67;126;SEC_210
1997;205;03-11;31;31;62;SEC_205
1997;626;65-74;46;63;109;SEC_626
1997;103;25-34;58;64;122;SEC_103
1997;535;18-24;98;104;202;SEC_535
1997;222;65-74;47;44;91;SEC_222
1997;218;35-49;78;65;143;SEC_218
1997;232;12-15;11;13;24;SEC_232
1997;527;12-15;19;14;33;SEC_527
1997;436;12-15;9;13;22;SEC_436
1997;240;65-74;64;46;110;SEC_240
1997;108;75 i +;78;34;112;SEC_108
1997;125;16-17;14;21;35;SEC_125
1997;137;03-11;56;56;112;SEC_137
1997;414;50-64;97;99;196;SEC_414
1997;423;00-02;4;7;11;SEC_423
1997;520;12-15;15;21;36;SEC_520
1997;118;16-17;31;41;72;SEC_118
1997;611;35-49;117;120;237;SEC_611
1997;105;50-64;73;91;164;SEC_105
1997;118;35-49;271;237;508;SEC_118
1997;243;25-34;135;140;275;SEC_243
1997;220;00-02;4;3;7;SEC_220
1997;431;16-17;22;18;40;SEC_431
1997;313;00-02;16;21;37;SEC_313
1997;303;03-11;36;40;76;SEC_303
1997;502;16-17;31;14;45;SEC_502
1997;204;12-15;6;11;17;SEC_204
1997;230;65-74;65;49;114;SEC_230
1997;202;65-74;40;38;78;SEC_202
1997;611;12-15;25;22;47;SEC_611
1997;202;16-17;9;12;21;SEC_202
1997;405;65-74;73;67;140;SEC_405
1997;140;03-11;19;16;35;SEC_140
1997;248;35-49;94;98;192;SEC_248
1997;632;65-74;40;35;75;SEC_632
1997;428;25-34;50;51;101;SEC_428
1997;203;65-74;69;48;117;SEC_203
1997;615;18-24;87;103;190;SEC_615
1997;428;12-15;6;7;13;SEC_428
1997;507;12-15;16;12;28;SEC_507
1997;607;12-15;13;18;31;SEC_607
1997;227;16-17;9;4;13;SEC_227
1997;430;16-17;10;9;19;SEC_430
1997;409;16-17;13;12;25;SEC_409
1997;132;50-64;168;204;372;SEC_132
1997;505;00-02;10;7;17;SEC_505
1997;204;00-02;5;5;10;SEC_204
1997;418;16-17;9;17;26;SEC_418
1997;623;18-24;132;146;278;SEC_623
1997;410;50-64;206;188;394;SEC_410
1997;235;00-02;17;10;27;SEC_235
1997;240;12-15;11;12;23;SEC_240
1997;108;18-24;63;66;129;SEC_108
1997;437;03-11;24;40;64;SEC_437
1997;205;35-49;101;100;201;SEC_205
1997;133;75 i +;39;29;68;SEC_133
1997;435;03-11;43;43;86;SEC_435
1997;322;03-11;39;53;92;SEC_322
1997;435;18-24;55;53;108;SEC_435
1997;512;18-24;45;55;100;SEC_512
1997;620;25-34;56;49;105;SEC_620
1997;128;35-49;102;93;195;SEC_128
1997;512;00-02;9;8;17;SEC_512
1997;502;75 i +;57;31;88;SEC_502
1997;121;50-64;85;53;138;SEC_121
1997;111;65-74;43;40;83;SEC_111
1997;130;65-74;75;64;139;SEC_130
1997;234;50-64;91;72;163;SEC_234
1997;433;35-49;82;77;159;SEC_433
1997;205;18-24;45;47;92;SEC_205
1997;627;16-17;28;27;55;SEC_627
1997;106;12-15;54;63;117;SEC_106
1997;208;12-15;22;42;64;SEC_208
1997;307;12-15;33;37;70;SEC_307
1997;205;65-74;53;41;94;SEC_205
1997;203;00-02;3;2;5;SEC_203
1997;307;03-11;59;68;127;SEC_307
1997;301;50-64;215;221;436;SEC_301
1997;424;16-17;4;11;15;SEC_424
1997;511;16-17;4;8;12;SEC_511
1997;210;65-74;85;63;148;SEC_210
1997;228;75 i +;33;18;51;SEC_228
1997;408;00-02;5;9;14;SEC_408
1997;324;12-15;24;14;38;SEC_324
1997;247;18-24;76;57;133;SEC_247
1997;627;65-74;30;21;51;SEC_627
1997;513;12-15;9;6;15;SEC_513
1997;501;25-34;75;77;152;SEC_501
1997;431;12-15;25;34;59;SEC_431
1997;120;65-74;59;46;105;SEC_120
1997;423;25-34;74;84;158;SEC_423
1997;319;65-74;31;29;60;SEC_319
1997;133;00-02;3;8;11;SEC_133
1997;614;35-49;98;81;179;SEC_614
1997;439;65-74;51;52;103;SEC_439
1997;232;00-02;9;4;13;SEC_232
1997;403;75 i +;45;20;65;SEC_403
1997;441;03-11;113;87;200;SEC_441
1997;617;25-34;109;128;237;SEC_617
1997;307;75 i +;37;20;57;SEC_307
1997;627;35-49;178;154;332;SEC_627
1997;315;25-34;128;125;253;SEC_315
1997;239;25-34;88;95;183;SEC_239
1997;136;25-34;94;96;190;SEC_136
1997;614;25-34;85;85;170;SEC_614
1997;319;00-02;7;6;13;SEC_319
1997;248;12-15;20;22;42;SEC_248
1997;532;25-34;108;106;214;SEC_532
1997;513;18-24;38;47;85;SEC_513
1997;402;18-24;52;51;103;SEC_402
1997;619;35-49;168;149;317;SEC_619
1997;432;65-74;66;60;126;SEC_432
1997;403;18-24;61;78;139;SEC_403
1997;428;03-11;20;14;34;SEC_428
1997;529;65-74;78;62;140;SEC_529
1997;532;16-17;12;12;24;SEC_532
1997;317;35-49;69;84;153;SEC_317
1997;510;12-15;15;20;35;SEC_510
1997;422;00-02;6;8;14;SEC_422
1997;304;18-24;54;70;124;SEC_304
1997;131;03-11;62;59;121;SEC_131
1997;104;00-02;12;6;18;SEC_104
1997;110;18-24;113;105;218;SEC_110
1997;511;50-64;71;66;137;SEC_511
1997;507;35-49;90;74;164;SEC_507
1997;112;03-11;66;64;130;SEC_112
1997;325;12-15;35;28;63;SEC_325
1997;249;25-34;86;89;175;SEC_249
1997;505;16-17;24;14;38;SEC_505
1997;538;65-74;77;76;153;SEC_538
1997;408;25-34;76;93;169;SEC_408
1997;246;50-64;91;85;176;SEC_246
1997;532;03-11;39;34;73;SEC_532
1997;203;16-17;7;7;14;SEC_203
1997;535;16-17;13;23;36;SEC_535
1997;227;00-02;5;7;12;SEC_227
1997;104;03-11;26;22;48;SEC_104
1997;525;00-02;10;6;16;SEC_525
1997;240;00-02;3;7;10;SEC_240
1997;303;25-34;179;202;381;SEC_303
1997;623;25-34;121;127;248;SEC_623
1997;214;18-24;33;39;72;SEC_214
1997;109;03-11;45;46;91;SEC_109
1997;224;12-15;10;15;25;SEC_224
1997;506;75 i +;51;24;75;SEC_506
1997;109;65-74;48;41;89;SEC_109
1997;626;50-64;127;106;233;SEC_626
1997;317;00-02;10;13;23;SEC_317
1997;536;25-34;92;78;170;SEC_536
1997;402;12-15;14;13;27;SEC_402
1997;207;75 i +;47;29;76;SEC_207
1997;606;12-15;23;23;46;SEC_606
1997;324;65-74;58;33;91;SEC_324
1997;618;75 i +;19;11;30;SEC_618
1997;629;18-24;43;47;90;SEC_629
1997;619;75 i +;37;19;56;SEC_619
1997;603;50-64;84;79;163;SEC_603
1997;131;25-34;114;118;232;SEC_131
1997;531;50-64;89;90;179;SEC_531
1997;525;03-11;30;34;64;SEC_525
1997;504;50-64;164;154;318;SEC_504
1997;506;16-17;39;35;74;SEC_506
1997;234;75 i +;78;31;109;SEC_234
1997;103;18-24;45;38;83;SEC_103
1997;115;65-74;68;49;117;SEC_115
1997;116;18-24;135;137;272;SEC_116
1997;618;16-17;7;7;14;SEC_618
1997;129;50-64;117;128;245;SEC_129
1997;626;35-49;112;107;219;SEC_626
1997;120;25-34;109;106;215;SEC_120
1997;429;65-74;41;34;75;SEC_429
1997;442;18-24;37;39;76;SEC_442
1997;208;65-74;137;109;246;SEC_208
1997;212;16-17;13;13;26;SEC_212
1997;120;12-15;38;46;84;SEC_120
1997;620;00-02;3;6;9;SEC_620
1997;320;35-49;56;41;97;SEC_320
1997;632;03-11;46;45;91;SEC_632
1997;620;65-74;14;21;35;SEC_620
1997;405;35-49;50;62;112;SEC_405
1997;127;25-34;69;66;135;SEC_127
1997;243;18-24;65;57;122;SEC_243
1997;209;12-15;8;14;22;SEC_209
1997;534;00-02;9;9;18;SEC_534
1997;134;00-02;8;12;20;SEC_134
1997;121;18-24;30;33;63;SEC_121
1997;123;00-02;7;13;20;SEC_123
1997;228;25-34;64;59;123;SEC_228
1997;406;03-11;49;49;98;SEC_406
1997;602;18-24;40;37;77;SEC_602
1997;604;18-24;53;61;114;SEC_604
1997;123;18-24;66;62;128;SEC_123
1997;601;16-17;27;27;54;SEC_601
1997;322;00-02;15;12;27;SEC_322
1997;620;16-17;15;13;28;SEC_620
1997;521;03-11;34;30;64;SEC_521
1997;247;50-64;101;103;204;SEC_247
1997;606;18-24;43;58;101;SEC_606
1997;243;75 i +;87;42;129;SEC_243
1997;417;12-15;12;20;32;SEC_417
1997;222;16-17;17;11;28;SEC_222
1997;235;50-64;155;133;288;SEC_235
1997;305;35-49;199;185;384;SEC_305
1997;313;65-74;71;74;145;SEC_313
1997;436;00-02;8;10;18;SEC_436
1997;619;00-02;6;18;24;SEC_619
1997;420;35-49;91;107;198;SEC_420
1997;132;18-24;138;166;304;SEC_132
1997;230;35-49;50;51;101;SEC_230
1997;138;00-02;7;6;13;SEC_138
1997;205;25-34;62;65;127;SEC_205
1997;626;03-11;35;36;71;SEC_626
1997;211;00-02;15;13;28;SEC_211
1997;133;12-15;16;22;38;SEC_133
1997;316;25-34;93;82;175;SEC_316
1997;438;25-34;79;84;163;SEC_438
1997;528;12-15;13;13;26;SEC_528
1997;238;75 i +;52;29;81;SEC_238
1997;131;00-02;20;14;34;SEC_131
1997;137;65-74;45;37;82;SEC_137
1997;310;65-74;33;30;63;SEC_310
1997;308;25-34;99;106;205;SEC_308
1997;222;03-11;39;32;71;SEC_222
1997;427;03-11;18;27;45;SEC_427
1997;406;50-64;145;133;278;SEC_406
1997;119;12-15;32;33;65;SEC_119
1997;235;35-49;91;97;188;SEC_235
1997;215;35-49;70;62;132;SEC_215
1997;405;03-11;25;18;43;SEC_405
1997;216;50-64;152;121;273;SEC_216
1997;302;00-02;12;21;33;SEC_302
1997;610;75 i +;33;24;57;SEC_610
1997;438;35-49;68;63;131;SEC_438
1997;516;00-02;5;10;15;SEC_516
1997;226;03-11;33;30;63;SEC_226
1997;419;50-64;80;69;149;SEC_419
1997;237;75 i +;67;34;101;SEC_237
1997;217;00-02;6;6;12;SEC_217
1997;307;65-74;74;67;141;SEC_307
1997;442;75 i +;30;22;52;SEC_442
1997;220;35-49;66;62;128;SEC_220
1997;319;03-11;28;33;61;SEC_319
1997;211;16-17;8;10;18;SEC_211
1997;611;03-11;61;60;121;SEC_611
1997;517;65-74;58;49;107;SEC_517
1997;232;65-74;76;64;140;SEC_232
1997;415;00-02;7;10;17;SEC_415
1997;411;75 i +;45;21;66;SEC_411
1997;233;00-02;4;5;9;SEC_233
1997;134;16-17;15;15;30;SEC_134
1997;431;35-49;123;121;244;SEC_431
1997;107;03-11;57;70;127;SEC_107
1997;429;50-64;62;51;113;SEC_429
1997;605;75 i +;20;14;34;SEC_605
1997;301;25-34;158;159;317;SEC_301
1997;417;25-34;53;48;101;SEC_417
1997;223;65-74;73;61;134;SEC_223
1997;206;25-34;63;70;133;SEC_206
1997;610;18-24;104;118;222;SEC_610
1997;604;16-17;5;17;22;SEC_604
1997;231;12-15;10;9;19;SEC_231
1997;536;35-49;65;69;134;SEC_536
1997;616;50-64;133;135;268;SEC_616
1997;428;65-74;37;36;73;SEC_428
1997;139;65-74;30;26;56;SEC_139
1997;505;03-11;44;34;78;SEC_505
1997;438;12-15;20;12;32;SEC_438
1997;242;18-24;38;47;85;SEC_242
1997;427;35-49;59;63;122;SEC_427
1997;510;65-74;63;42;105;SEC_510
1997;322;65-74;65;53;118;SEC_322
1997;537;35-49;113;103;216;SEC_537
1997;520;00-02;10;7;17;SEC_520
1997;437;00-02;10;5;15;SEC_437
1997;401;65-74;102;83;185;SEC_401
1997;202;12-15;10;13;23;SEC_202
1997;607;18-24;65;66;131;SEC_607
1997;620;18-24;70;49;119;SEC_620
1997;138;25-34;64;64;128;SEC_138
1997;231;18-24;59;55;114;SEC_231
1997;617;75 i +;18;19;37;SEC_617
1997;617;18-24;82;112;194;SEC_617
1997;422;16-17;6;9;15;SEC_422
1997;133;16-17;15;11;26;SEC_133
1997;244;00-02;8;3;11;SEC_244
1997;432;03-11;39;52;91;SEC_432
1997;417;75 i +;18;11;29;SEC_417
1997;323;65-74;58;37;95;SEC_323
1997;307;18-24;111;109;220;SEC_307
1997;403;25-34;90;101;191;SEC_403
1997;126;50-64;150;163;313;SEC_126
1997;128;50-64;98;101;199;SEC_128
1997;526;16-17;8;6;14;SEC_526
1997;525;18-24;52;52;104;SEC_525
1997;110;03-11;45;50;95;SEC_110
1997;126;18-24;103;92;195;SEC_126
1997;513;16-17;11;9;20;SEC_513
1997;116;35-49;186;160;346;SEC_116
1997;518;50-64;136;119;255;SEC_518
1997;519;75 i +;15;11;26;SEC_519
1997;114;18-24;118;113;231;SEC_114
1997;121;16-17;4;6;10;SEC_121
1997;305;25-34;85;98;183;SEC_305
1997;234;12-15;10;11;21;SEC_234
1997;227;65-74;53;43;96;SEC_227
1997;134;75 i +;68;29;97;SEC_134
1997;514;12-15;10;17;27;SEC_514
1997;245;25-34;69;69;138;SEC_245
1997;441;12-15;72;58;130;SEC_441
1997;246;25-34;90;97;187;SEC_246
1997;120;35-49;231;224;455;SEC_120
1997;241;50-64;67;67;134;SEC_241
1997;503;16-17;13;17;30;SEC_503
1997;435;50-64;86;76;162;SEC_435
1997;213;18-24;66;63;129;SEC_213
1997;125;65-74;53;36;89;SEC_125
1997;629;12-15;9;14;23;SEC_629
1997;612;16-17;11;11;22;SEC_612
1997;240;25-34;49;64;113;SEC_240
1997;613;03-11;40;37;77;SEC_613
1997;609;00-02;10;10;20;SEC_609
1997;608;35-49;85;85;170;SEC_608
1997;127;03-11;56;39;95;SEC_127
1997;247;03-11;36;45;81;SEC_247
1997;429;35-49;74;77;151;SEC_429
1997;513;35-49;52;56;108;SEC_513
1997;124;50-64;77;78;155;SEC_124
1997;425;75 i +;46;23;69;SEC_425
1997;246;18-24;47;41;88;SEC_246
1997;436;16-17;9;14;23;SEC_436
1997;534;50-64;96;101;197;SEC_534
1997;134;50-64;116;107;223;SEC_134
1997;531;35-49;77;76;153;SEC_531
1997;518;35-49;75;88;163;SEC_518
1997;503;35-49;137;116;253;SEC_503
1997;520;25-34;71;65;136;SEC_520
1997;411;50-64;116;114;230;SEC_411
1997;222;12-15;14;21;35;SEC_222
1997;631;16-17;19;16;35;SEC_631
1997;407;00-02;9;9;18;SEC_407
1997;102;12-15;30;20;50;SEC_102
1997;113;16-17;32;22;54;SEC_113
1997;406;75 i +;49;32;81;SEC_406
1997;437;50-64;89;86;175;SEC_437
1997;422;18-24;38;49;87;SEC_422
1997;626;75 i +;22;19;41;SEC_626
1997;517;03-11;38;43;81;SEC_517
1997;438;75 i +;33;11;44;SEC_438
1997;213;50-64;77;84;161;SEC_213
1997;130;25-34;80;97;177;SEC_130
1997;311;50-64;141;132;273;SEC_311
1997;228;65-74;44;34;78;SEC_228
1997;226;12-15;21;23;44;SEC_226
1997;228;03-11;19;13;32;SEC_228
1997;112;16-17;26;22;48;SEC_112
1997;220;25-34;72;67;139;SEC_220
1997;320;25-34;43;54;97;SEC_320
1997;304;25-34;91;102;193;SEC_304
1997;132;03-11;88;72;160;SEC_132
1997;121;25-34;93;91;184;SEC_121
1997;518;75 i +;47;23;70;SEC_518
1997;314;12-15;84;83;167;SEC_314
1997;214;03-11;19;18;37;SEC_214
1997;314;50-64;128;154;282;SEC_314
1997;119;25-34;100;98;198;SEC_119
1997;119;16-17;20;29;49;SEC_119
1997;124;35-49;123;100;223;SEC_124
1997;404;75 i +;58;29;87;SEC_404
1997;245;75 i +;70;33;103;SEC_245
1997;224;65-74;45;34;79;SEC_224
1997;402;00-02;3;3;6;SEC_402
1997;428;16-17;3;4;7;SEC_428
1997;114;12-15;45;36;81;SEC_114
1997;129;00-02;13;8;21;SEC_129
1997;205;12-15;22;18;40;SEC_205
1997;408;12-15;17;22;39;SEC_408
1997;110;00-02;11;9;20;SEC_110
1997;140;35-49;78;70;148;SEC_140
1997;114;75 i +;58;19;77;SEC_114
1997;622;25-34;83;96;179;SEC_622
1997;218;65-74;43;31;74;SEC_218
1997;512;12-15;12;13;25;SEC_512
1997;139;00-02;10;15;25;SEC_139
1997;525;65-74;49;38;87;SEC_525
1997;627;12-15;35;35;70;SEC_627
1997;608;12-15;22;23;45;SEC_608
1997;520;75 i +;35;25;60;SEC_520
1997;514;50-64;90;71;161;SEC_514
1997;226;00-02;6;7;13;SEC_226
1997;307;16-17;38;27;65;SEC_307
1997;102;35-49;162;142;304;SEC_102
1997;301;35-49;136;150;286;SEC_301
1997;215;65-74;67;55;122;SEC_215
1997;311;12-15;17;19;36;SEC_311
1997;109;25-34;103;89;192;SEC_109
1997;441;65-74;118;85;203;SEC_441
1997;527;00-02;9;9;18;SEC_527
1997;603;00-02;7;3;10;SEC_603
1997;526;50-64;62;71;133;SEC_526
1997;132;25-34;168;168;336;SEC_132
1997;211;03-11;37;45;82;SEC_211
1997;120;75 i +;39;23;62;SEC_120
1997;303;50-64;223;213;436;SEC_303
1997;213;35-49;97;97;194;SEC_213
1997;214;00-02;2;8;10;SEC_214
1997;208;00-02;6;5;11;SEC_208
1997;518;16-17;10;10;20;SEC_518
1997;246;75 i +;70;36;106;SEC_246
1997;535;00-02;5;4;9;SEC_535
1997;115;03-11;38;69;107;SEC_115
1997;429;00-02;2;6;8;SEC_429
1997;418;65-74;73;51;124;SEC_418
1997;109;12-15;28;34;62;SEC_109
1997;213;03-11;32;32;64;SEC_213
1997;115;25-34;102;115;217;SEC_115
1997;134;65-74;51;37;88;SEC_134
1997;433;18-24;50;74;124;SEC_433
1997;241;03-11;32;27;59;SEC_241
1997;526;25-34;57;50;107;SEC_526
1997;219;16-17;9;15;24;SEC_219
1997;624;16-17;12;17;29;SEC_624
1997;625;75 i +;15;7;22;SEC_625
1997;113;65-74;42;35;77;SEC_113
1997;414;18-24;49;49;98;SEC_414
1997;137;12-15;36;27;63;SEC_137
1997;236;50-64;108;110;218;SEC_236
1997;508;50-64;65;54;119;SEC_508
1997;524;16-17;17;13;30;SEC_524
1997;632;50-64;107;104;211;SEC_632
1997;219;00-02;11;6;17;SEC_219
1997;104;35-49;74;60;134;SEC_104
1997;432;00-02;5;13;18;SEC_432
1997;440;18-24;108;94;202;SEC_440
1997;138;75 i +;19;8;27;SEC_138
1997;531;12-15;10;20;30;SEC_531
1997;535;35-49;141;120;261;SEC_535
1997;116;50-64;160;169;329;SEC_116
1997;202;03-11;16;21;37;SEC_202
1997;233;12-15;5;9;14;SEC_233
1997;308;03-11;36;48;84;SEC_308
1997;114;16-17;30;35;65;SEC_114
1997;222;00-02;8;7;15;SEC_222
1997;415;75 i +;45;26;71;SEC_415
1997;314;16-17;34;35;69;SEC_314
1997;307;25-34;98;83;181;SEC_307
1997;427;12-15;12;11;23;SEC_427
1997;320;03-11;16;20;36;SEC_320
1997;630;00-02;3;13;16;SEC_630
1997;534;35-49;80;81;161;SEC_534
1997;424;50-64;70;66;136;SEC_424
1997;127;65-74;41;36;77;SEC_127
1997;604;03-11;26;37;63;SEC_604
1997;625;65-74;23;27;50;SEC_625
1997;318;16-17;13;12;25;SEC_318
1997;407;03-11;23;39;62;SEC_407
1997;245;16-17;17;11;28;SEC_245
1997;131;16-17;30;24;54;SEC_131
1997;505;50-64;217;231;448;SEC_505
1997;234;18-24;31;40;71;SEC_234
1997;308;00-02;9;15;24;SEC_308
1997;113;03-11;72;78;150;SEC_113
1997;249;03-11;22;21;43;SEC_249
1997;306;50-64;132;115;247;SEC_306
1997;325;65-74;124;98;222;SEC_325
1997;613;75 i +;37;22;59;SEC_613
1997;402;16-17;3;7;10;SEC_402
1997;107;16-17;34;28;62;SEC_107
1997;321;00-02;23;22;45;SEC_321
1997;242;03-11;32;27;59;SEC_242
1997;611;18-24;113;106;219;SEC_611
1997;532;75 i +;64;41;105;SEC_532
1997;222;25-34;72;73;145;SEC_222
1997;243;03-11;42;53;95;SEC_243
1997;611;16-17;14;20;34;SEC_611
1997;629;03-11;26;22;48;SEC_629
1997;532;00-02;16;12;28;SEC_532
1997;312;35-49;136;134;270;SEC_312
1997;130;12-15;8;14;22;SEC_130
1997;136;50-64;93;88;181;SEC_136
1997;632;00-02;19;17;36;SEC_632
1997;511;25-34;56;74;130;SEC_511
1997;237;65-74;83;57;140;SEC_237
1997;514;25-34;67;62;129;SEC_514
1997;132;35-49;259;238;497;SEC_132
1997;242;65-74;90;88;178;SEC_242
1997;136;03-11;51;45;96;SEC_136
1997;628;18-24;104;124;228;SEC_628
1997;618;25-34;45;65;110;SEC_618
1997;231;65-74;84;68;152;SEC_231
1997;119;18-24;129;131;260;SEC_119
1997;233;75 i +;69;33;102;SEC_233
1997;531;65-74;56;49;105;SEC_531
1997;423;18-24;50;57;107;SEC_423
1997;219;50-64;108;99;207;SEC_219
1997;134;12-15;31;25;56;SEC_134
1997;509;00-02;5;10;15;SEC_509
1997;605;65-74;34;34;68;SEC_605
1997;515;25-34;56;45;101;SEC_515
1997;426;50-64;81;74;155;SEC_426
1997;140;75 i +;41;16;57;SEC_140
1997;117;18-24;124;156;280;SEC_117
1997;101;16-17;20;19;39;SEC_101
1997;422;03-11;31;44;75;SEC_422
1997;538;35-49;89;92;181;SEC_538
1997;111;12-15;19;13;32;SEC_111
1997;439;03-11;37;33;70;SEC_439
1997;304;16-17;9;6;15;SEC_304
1997;519;16-17;3;12;15;SEC_519
1997;504;03-11;23;32;55;SEC_504
1997;615;50-64;155;166;321;SEC_615
1997;225;03-11;11;15;26;SEC_225
1997;441;25-34;126;126;252;SEC_441
1997;533;03-11;27;22;49;SEC_533
1997;248;65-74;81;56;137;SEC_248
1997;215;16-17;4;10;14;SEC_215
1997;226;35-49;105;91;196;SEC_226
1997;232;03-11;30;24;54;SEC_232
1997;405;50-64;128;94;222;SEC_405
1997;504;25-34;93;118;211;SEC_504
1997;224;18-24;33;29;62;SEC_224
1997;419;03-11;24;29;53;SEC_419
1997;424;65-74;27;31;58;SEC_424
1997;412;12-15;54;37;91;SEC_412
1997;104;12-15;6;8;14;SEC_104
1997;303;12-15;26;31;57;SEC_303
1997;211;25-34;117;113;230;SEC_211
1997;310;75 i +;23;12;35;SEC_310
1997;506;18-24;191;179;370;SEC_506
1997;508;35-49;51;55;106;SEC_508
1997;410;35-49;158;153;311;SEC_410
1997;509;25-34;67;77;144;SEC_509
1997;223;25-34;102;98;200;SEC_223
1997;234;00-02;4;9;13;SEC_234
1997;431;03-11;40;40;80;SEC_431
1997;411;35-49;98;89;187;SEC_411
1997;224;75 i +;36;17;53;SEC_224
1997;318;75 i +;7;7;14;SEC_318
1997;212;12-15;21;17;38;SEC_212
1997;212;65-74;77;67;144;SEC_212
1997;216;35-49;124;109;233;SEC_216
1997;621;35-49;233;187;420;SEC_621
1997;229;00-02;8;8;16;SEC_229
1997;441;75 i +;46;41;87;SEC_441
1997;242;25-34;85;81;166;SEC_242
1997;518;18-24;59;59;118;SEC_518
1997;538;75 i +;53;25;78;SEC_538
1997;241;35-49;56;58;114;SEC_241
1997;244;12-15;6;9;15;SEC_244
1997;116;25-34;140;135;275;SEC_116
1997;303;35-49;120;104;224;SEC_303
1997;509;65-74;29;31;60;SEC_509
1997;130;18-24;38;48;86;SEC_130
1997;115;16-17;22;19;41;SEC_115
1997;537;50-64;150;141;291;SEC_537
1997;122;12-15;10;13;23;SEC_122
1997;325;25-34;153;149;302;SEC_325
1997;235;75 i +;62;40;102;SEC_235
1997;207;18-24;29;27;56;SEC_207
1997;132;65-74;70;66;136;SEC_132
1997;604;25-34;77;93;170;SEC_604
1997;316;00-02;14;22;36;SEC_316
1997;117;50-64;143;166;309;SEC_117
1997;606;25-34;123;116;239;SEC_606
1997;230;12-15;8;9;17;SEC_230
1997;441;35-49;273;268;541;SEC_441
1997;616;35-49;207;221;428;SEC_616
1997;439;18-24;57;41;98;SEC_439
1997;241;75 i +;44;30;74;SEC_241
1997;248;25-34;99;103;202;SEC_248
1997;127;12-15;19;14;33;SEC_127
1997;607;25-34;97;124;221;SEC_607
1997;203;75 i +;50;27;77;SEC_203
1997;513;75 i +;43;14;57;SEC_513
1997;603;03-11;26;28;54;SEC_603
1997;425;65-74;68;65;133;SEC_425
1997;525;50-64;99;91;190;SEC_525
1997;103;65-74;39;34;73;SEC_103
1997;401;16-17;15;9;24;SEC_401
1997;529;35-49;84;77;161;SEC_529
1997;111;16-17;10;12;22;SEC_111
1997;320;50-64;68;73;141;SEC_320
1997;325;00-02;21;11;32;SEC_325
1997;613;50-64;202;220;422;SEC_613
1997;413;12-15;8;8;16;SEC_413
1997;206;35-49;75;67;142;SEC_206
1997;504;35-49;102;96;198;SEC_504
1997;225;50-64;57;44;101;SEC_225
1997;309;16-17;13;12;25;SEC_309
1997;501;00-02;8;12;20;SEC_501
1997;201;50-64;87;79;166;SEC_201
1997;437;18-24;48;43;91;SEC_437
1997;303;75 i +;64;36;100;SEC_303
1997;608;18-24;67;95;162;SEC_608
1997;323;00-02;29;38;67;SEC_323
1997;308;65-74;61;59;120;SEC_308
1997;416;25-34;64;78;142;SEC_416
1997;129;16-17;10;15;25;SEC_129
1997;512;03-11;27;30;57;SEC_512
1997;631;50-64;143;170;313;SEC_631
1997;612;75 i +;35;17;52;SEC_612
1997;236;00-02;9;4;13;SEC_236
1997;230;75 i +;40;16;56;SEC_230
1997;416;00-02;10;11;21;SEC_416
1997;421;65-74;62;68;130;SEC_421
1997;138;03-11;29;56;85;SEC_138
1997;322;25-34;94;104;198;SEC_322
1997;402;65-74;51;57;108;SEC_402
1997;406;65-74;63;67;130;SEC_406
1997;114;65-74;59;56;115;SEC_114
1997;630;35-49;131;110;241;SEC_630
1997;610;65-74;62;48;110;SEC_610
1997;626;16-17;13;16;29;SEC_626
1997;611;00-02;14;12;26;SEC_611
1997;214;65-74;42;35;77;SEC_214
1997;217;50-64;44;43;87;SEC_217
1997;612;00-02;4;15;19;SEC_612
1997;440;35-49;93;80;173;SEC_440
1997;525;12-15;15;18;33;SEC_525
1997;504;00-02;5;10;15;SEC_504
1997;121;12-15;12;7;19;SEC_121
1997;316;03-11;129;136;265;SEC_316
1997;119;50-64;142;157;299;SEC_119
1997;207;16-17;11;7;18;SEC_207
1997;623;16-17;28;39;67;SEC_623
1997;617;03-11;43;49;92;SEC_617
1997;242;35-49;81;89;170;SEC_242
1997;618;65-74;27;23;50;SEC_618
1997;524;03-11;39;49;88;SEC_524
1997;111;75 i +;34;23;57;SEC_111
1997;515;03-11;24;27;51;SEC_515
1997;524;00-02;16;14;30;SEC_524
1997;140;50-64;125;116;241;SEC_140
1997;602;35-49;35;34;69;SEC_602
1997;139;25-34;86;69;155;SEC_139
1997;403;03-11;35;35;70;SEC_403
1997;216;03-11;26;38;64;SEC_216
1997;608;75 i +;27;11;38;SEC_608
1997;114;25-34;149;156;305;SEC_114
1997;104;50-64;82;75;157;SEC_104
1997;111;25-34;67;85;152;SEC_111
1997;223;16-17;9;10;19;SEC_223
1997;126;35-49;97;76;173;SEC_126
1997;528;25-34;108;116;224;SEC_528
1997;518;25-34;92;113;205;SEC_518
1997;321;50-64;174;214;388;SEC_321
1997;246;16-17;13;4;17;SEC_246
1997;237;25-34;111;128;239;SEC_237
1997;532;65-74;81;76;157;SEC_532
1997;518;12-15;13;25;38;SEC_518
1997;610;25-34;113;137;250;SEC_610
1997;617;12-15;32;25;57;SEC_617
1997;318;12-15;22;21;43;SEC_318
1997;625;18-24;110;120;230;SEC_625
1997;238;12-15;13;12;25;SEC_238
1997;105;35-49;189;164;353;SEC_105
1997;606;65-74;68;56;124;SEC_606
1997;626;25-34;88;119;207;SEC_626
1997;611;25-34;172;203;375;SEC_611
1997;315;00-02;17;15;32;SEC_315
1997;525;35-49;69;70;139;SEC_525
1997;219;12-15;10;24;34;SEC_219
1997;239;16-17;13;8;21;SEC_239
1997;621;65-74;41;31;72;SEC_621
1997;244;35-49;53;58;111;SEC_244
1997;123;65-74;87;70;157;SEC_123
1997;232;50-64;103;86;189;SEC_232
1997;244;50-64;54;50;104;SEC_244
1997;532;12-15;18;14;32;SEC_532
1997;438;50-64;108;114;222;SEC_438
1997;227;12-15;10;9;19;SEC_227
1997;407;16-17;8;8;16;SEC_407
1997;127;00-02;7;8;15;SEC_127
1997;113;35-49;205;196;401;SEC_113
1997;221;16-17;12;12;24;SEC_221
1997;316;18-24;153;160;313;SEC_316
1997;632;75 i +;26;8;34;SEC_632
1997;222;50-64;79;82;161;SEC_222
1997;201;03-11;19;22;41;SEC_201
1997;210;75 i +;55;40;95;SEC_210
1997;204;65-74;56;41;97;SEC_204
1997;436;75 i +;28;17;45;SEC_436
1997;508;18-24;45;27;72;SEC_508
1997;525;16-17;4;15;19;SEC_525
1997;124;25-34;49;62;111;SEC_124
1997;534;12-15;12;14;26;SEC_534
1997;139;03-11;24;41;65;SEC_139
1997;406;12-15;31;32;63;SEC_406
1997;238;50-64;70;62;132;SEC_238
1997;438;65-74;30;31;61;SEC_438
1997;216;00-02;8;11;19;SEC_216
1997;537;03-11;44;42;86;SEC_537
1997;317;18-24;47;51;98;SEC_317
1997;407;75 i +;33;25;58;SEC_407
1997;413;75 i +;36;13;49;SEC_413
1997;523;25-34;105;110;215;SEC_523
1997;138;16-17;11;11;22;SEC_138
1997;518;65-74;59;61;120;SEC_518
1997;237;50-64;141;131;272;SEC_237
1997;606;03-11;46;51;97;SEC_606
1997;224;35-49;57;59;116;SEC_224
1997;608;00-02;6;10;16;SEC_608
1997;312;50-64;198;188;386;SEC_312
1997;519;65-74;40;43;83;SEC_519
1997;442;16-17;4;6;10;SEC_442
1997;519;50-64;63;49;112;SEC_519
1997;402;50-64;91;86;177;SEC_402
1997;402;25-34;48;71;119;SEC_402
1997;121;00-02;11;9;20;SEC_121
1997;435;65-74;116;73;189;SEC_435
1997;323;25-34;191;195;386;SEC_323
1997;122;25-34;78;95;173;SEC_122
1997;133;50-64;85;84;169;SEC_133
1997;507;50-64;81;106;187;SEC_507
1997;242;00-02;6;11;17;SEC_242
1997;413;16-17;2;7;9;SEC_413
1997;216;12-15;20;24;44;SEC_216
1997;114;35-49;186;183;369;SEC_114
1997;531;25-34;86;78;164;SEC_531
1997;442;50-64;66;61;127;SEC_442
1997;219;65-74;79;68;147;SEC_219
1997;601;25-34;85;140;225;SEC_601
1997;602;75 i +;21;13;34;SEC_602
1997;603;75 i +;11;12;23;SEC_603
1997;628;50-64;131;152;283;SEC_628
1997;310;00-02;7;8;15;SEC_310
1997;537;75 i +;47;26;73;SEC_537
1997;204;35-49;43;46;89;SEC_204
1997;117;65-74;66;49;115;SEC_117
1997;610;16-17;28;14;42;SEC_610
1997;202;00-02;3;8;11;SEC_202
1997;631;35-49;134;85;219;SEC_631
1997;314;03-11;96;128;224;SEC_314
1997;304;00-02;9;14;23;SEC_304
1997;403;50-64;162;154;316;SEC_403
1997;401;03-11;56;42;98;SEC_401
1997;137;25-34;102;93;195;SEC_137
1997;527;35-49;76;96;172;SEC_527
1997;418;50-64;132;116;248;SEC_418
1997;437;16-17;7;10;17;SEC_437
1997;628;16-17;16;20;36;SEC_628
1997;506;35-49;256;217;473;SEC_506
1997;516;25-34;57;63;120;SEC_516
1997;523;75 i +;83;36;119;SEC_523
1997;116;12-15;45;33;78;SEC_116
1997;426;00-02;7;6;13;SEC_426
1997;324;18-24;36;60;96;SEC_324
1997;607;03-11;32;38;70;SEC_607
1997;613;00-02;13;8;21;SEC_613
1997;528;03-11;45;35;80;SEC_528
1997;508;16-17;5;7;12;SEC_508
1997;614;65-74;47;39;86;SEC_614
1997;439;75 i +;42;23;65;SEC_439
1997;234;65-74;81;58;139;SEC_234
1997;214;35-49;49;49;98;SEC_214
1997;135;25-34;108;121;229;SEC_135
1997;528;75 i +;36;21;57;SEC_528
1997;502;65-74;75;68;143;SEC_502
1997;240;75 i +;37;17;54;SEC_240
1997;521;35-49;147;104;251;SEC_521
1997;306;16-17;23;18;41;SEC_306
1997;616;75 i +;24;14;38;SEC_616
1997;439;35-49;54;66;120;SEC_439
1997;420;03-11;34;46;80;SEC_420
1997;117;12-15;67;78;145;SEC_117
1997;533;75 i +;40;22;62;SEC_533
1997;132;00-02;23;24;47;SEC_132
1997;229;35-49;47;49;96;SEC_229
1997;614;00-02;11;14;25;SEC_614
1997;219;75 i +;76;32;108;SEC_219
1997;136;00-02;14;11;25;SEC_136
1997;403;16-17;16;16;32;SEC_403
1997;606;35-49;79;85;164;SEC_606
1997;236;75 i +;49;41;90;SEC_236
1997;222;35-49;74;68;142;SEC_222
1997;429;25-34;40;43;83;SEC_429
1997;112;35-49;180;180;360;SEC_112
1997;525;25-34;76;80;156;SEC_525
1997;603;65-74;23;22;45;SEC_603
1997;219;35-49;95;96;191;SEC_219
1997;244;03-11;14;15;29;SEC_244
1997;506;03-11;79;99;178;SEC_506
1997;529;16-17;8;14;22;SEC_529
1997;508;25-34;41;57;98;SEC_508
1997;241;18-24;33;29;62;SEC_241
1997;226;65-74;85;64;149;SEC_226
1997;610;12-15;20;27;47;SEC_610
1997;302;35-49;187;157;344;SEC_302
1997;414;03-11;26;40;66;SEC_414
1997;207;50-64;72;53;125;SEC_207
1997;630;75 i +;23;12;35;SEC_630
1997;423;12-15;14;14;28;SEC_423
1997;521;16-17;19;24;43;SEC_521
1997;425;12-15;15;11;26;SEC_425
1997;234;16-17;7;11;18;SEC_234
1997;118;25-34;133;129;262;SEC_118
1997;605;00-02;1;6;7;SEC_605
1997;515;35-49;54;43;97;SEC_515
1997;420;12-15;17;23;40;SEC_420
1997;614;18-24;79;85;164;SEC_614
1997;506;25-34;141;157;298;SEC_506
1997;101;00-02;14;21;35;SEC_101
1997;430;75 i +;43;24;67;SEC_430
1997;313;16-17;39;30;69;SEC_313
1997;229;25-34;54;53;107;SEC_229
1997;126;12-15;14;13;27;SEC_126
1997;209;00-02;7;7;14;SEC_209
1997;616;65-74;46;38;84;SEC_616
1997;311;16-17;17;14;31;SEC_311
1997;220;16-17;10;4;14;SEC_220
1997;230;00-02;10;8;18;SEC_230
1997;430;35-49;69;80;149;SEC_430
1997;535;12-15;35;34;69;SEC_535
1997;219;18-24;51;45;96;SEC_219
1997;422;35-49;86;106;192;SEC_422
1997;241;25-34;65;57;122;SEC_241
1997;315;35-49;172;183;355;SEC_315
1997;437;25-34;64;78;142;SEC_437
1997;135;00-02;11;14;25;SEC_135
1997;440;16-17;15;12;27;SEC_440
1997;122;18-24;48;56;104;SEC_122
1997;222;18-24;41;61;102;SEC_222
1997;420;16-17;12;14;26;SEC_420
1997;321;75 i +;71;40;111;SEC_321
1997;404;00-02;11;19;30;SEC_404
1997;137;16-17;19;19;38;SEC_137
1997;218;12-15;9;11;20;SEC_218
1997;244;16-17;6;6;12;SEC_244
1997;630;12-15;30;29;59;SEC_630
1997;318;65-74;24;17;41;SEC_318
1997;117;25-34;154;151;305;SEC_117
1997;420;65-74;82;56;138;SEC_420
1997;321;35-49;338;320;658;SEC_321
1997;203;18-24;30;36;66;SEC_203
1997;312;25-34;154;185;339;SEC_312
1997;609;75 i +;28;12;40;SEC_609
1997;122;03-11;27;10;37;SEC_122
1997;221;00-02;11;6;17;SEC_221
1997;418;03-11;36;37;73;SEC_418
1997;102;16-17;19;28;47;SEC_102
1997;321;18-24;168;163;331;SEC_321
1997;309;35-49;90;73;163;SEC_309
1997;405;75 i +;31;20;51;SEC_405
1997;624;35-49;136;94;230;SEC_624
1997;612;65-74;54;39;93;SEC_612
1997;123;25-34;95;98;193;SEC_123
1997;325;35-49;189;159;348;SEC_325
1997;238;18-24;23;38;61;SEC_238
1997;615;03-11;14;22;36;SEC_615
1997;116;03-11;64;50;114;SEC_116
1997;437;12-15;19;15;34;SEC_437
1997;317;65-74;56;40;96;SEC_317
1997;521;75 i +;31;17;48;SEC_521
1997;210;00-02;7;2;9;SEC_210
1997;243;00-02;12;12;24;SEC_243
1997;131;65-74;60;48;108;SEC_131
1997;110;75 i +;45;24;69;SEC_110
1997;247;25-34;99;101;200;SEC_247
1997;529;12-15;16;19;35;SEC_529
1997;631;18-24;119;137;256;SEC_631
1997;130;16-17;9;9;18;SEC_130
1997;431;18-24;81;76;157;SEC_431
1997;442;12-15;12;13;25;SEC_442
1997;228;50-64;78;64;142;SEC_228
1997;237;03-11;34;32;66;SEC_237
1997;305;16-17;26;20;46;SEC_305
1997;249;18-24;50;61;111;SEC_249
1997;139;50-64;77;74;151;SEC_139
1997;240;03-11;17;27;44;SEC_240
1997;533;00-02;12;6;18;SEC_533
1997;134;03-11;44;60;104;SEC_134
1997;414;16-17;8;10;18;SEC_414
1997;248;75 i +;56;42;98;SEC_248
1997;302;18-24;120;132;252;SEC_302
1997;135;75 i +;44;17;61;SEC_135
1997;526;00-02;9;8;17;SEC_526
1997;525;75 i +;31;24;55;SEC_525
1997;215;25-34;72;65;137;SEC_215
1997;117;35-49;279;249;528;SEC_117
1997;217;65-74;45;36;81;SEC_217
1997;219;03-11;41;34;75;SEC_219
1997;236;16-17;10;7;17;SEC_236
1997;526;65-74;37;30;67;SEC_526
1997;419;12-15;15;12;27;SEC_419
1997;516;16-17;6;10;16;SEC_516
1997;501;12-15;26;29;55;SEC_501
1997;430;50-64;99;96;195;SEC_430
1997;628;25-34;82;86;168;SEC_628
1997;109;18-24;58;50;108;SEC_109
1997;210;12-15;5;11;16;SEC_210
1997;604;75 i +;18;12;30;SEC_604
1997;214;12-15;7;15;22;SEC_214
1997;101;25-34;109;120;229;SEC_101
1997;130;75 i +;66;29;95;SEC_130
1997;619;12-15;38;36;74;SEC_619
1997;510;16-17;10;11;21;SEC_510
1997;224;00-02;4;7;11;SEC_224
1997;302;25-34;134;130;264;SEC_302
1997;602;00-02;7;7;14;SEC_602
1997;632;16-17;19;17;36;SEC_632
1997;412;00-02;18;12;30;SEC_412
1997;231;16-17;8;9;17;SEC_231
1997;523;35-49;110;107;217;SEC_523
1997;427;75 i +;43;34;77;SEC_427
1997;609;50-64;130;146;276;SEC_609
1997;106;75 i +;39;27;66;SEC_106
1997;436;65-74;40;26;66;SEC_436
1997;322;35-49;130;116;246;SEC_322
1997;230;18-24;47;35;82;SEC_230
1997;416;75 i +;21;12;33;SEC_416
1997;228;18-24;33;38;71;SEC_228
1997;248;18-24;40;55;95;SEC_248
1997;129;03-11;45;32;77;SEC_129
1997;620;03-11;20;27;47;SEC_620
1997;614;16-17;12;11;23;SEC_614
1997;510;75 i +;39;27;66;SEC_510
1997;406;18-24;88;99;187;SEC_406
1997;217;35-49;55;58;113;SEC_217
1997;124;75 i +;32;18;50;SEC_124
1997;223;00-02;10;10;20;SEC_223
1997;108;00-02;16;10;26;SEC_108
1997;522;03-11;17;17;34;SEC_522
1997;410;75 i +;58;42;100;SEC_410
1997;538;50-64;157;117;274;SEC_538
1997;431;75 i +;63;39;102;SEC_431
1997;108;50-64;111;98;209;SEC_108
1997;245;65-74;65;53;118;SEC_245
1997;244;25-34;49;60;109;SEC_244
1997;417;35-49;55;60;115;SEC_417
1997;603;18-24;45;59;104;SEC_603
1997;530;75 i +;62;30;92;SEC_530
1997;232;75 i +;63;27;90;SEC_232
1997;602;25-34;71;94;165;SEC_602
1997;126;03-11;30;27;57;SEC_126
1997;231;50-64;101;98;199;SEC_231
1997;129;18-24;100;72;172;SEC_129
1997;322;50-64;99;107;206;SEC_322
1997;529;50-64;138;142;280;SEC_529
1997;324;03-11;35;34;69;SEC_324
1997;528;65-74;66;54;120;SEC_528
1997;242;12-15;11;14;25;SEC_242
1997;115;00-02;16;13;29;SEC_115
1997;101;12-15;35;33;68;SEC_101
1997;603;25-34;67;68;135;SEC_603
1997;106;25-34;145;133;278;SEC_106
1997;135;65-74;60;54;114;SEC_135
1997;513;03-11;17;22;39;SEC_513
1997;505;75 i +;43;29;72;SEC_505
1997;401;75 i +;34;13;47;SEC_401
1997;302;12-15;26;32;58;SEC_302
1997;524;18-24;79;69;148;SEC_524
1997;112;65-74;55;47;102;SEC_112
1997;530;65-74;104;69;173;SEC_530
1997;247;16-17;12;9;21;SEC_247
1997;425;16-17;11;5;16;SEC_425
1997;511;00-02;6;9;15;SEC_511
1997;323;16-17;52;56;108;SEC_323
1997;415;03-11;19;21;40;SEC_415
1997;303;00-02;12;21;33;SEC_303
1997;417;65-74;42;36;78;SEC_417
1997;426;65-74;55;48;103;SEC_426
1997;242;16-17;11;4;15;SEC_242
1997;310;03-11;40;44;84;SEC_310
1997;132;75 i +;52;25;77;SEC_132
1997;112;75 i +;59;21;80;SEC_112
1997;420;75 i +;62;36;98;SEC_420
1997;527;16-17;6;11;17;SEC_527
1997;310;35-49;112;115;227;SEC_310
1997;201;18-24;35;42;77;SEC_201
1997;626;18-24;91;111;202;SEC_626
1997;235;12-15;15;15;30;SEC_235
1997;412;25-34;108;121;229;SEC_412
1997;309;75 i +;24;9;33;SEC_309
1997;406;00-02;8;15;23;SEC_406
1997;248;03-11;34;35;69;SEC_248
1997;134;18-24;68;79;147;SEC_134
1997;425;25-34;85;74;159;SEC_425
1997;630;50-64;83;102;185;SEC_630
1997;524;25-34;110;107;217;SEC_524
1997;536;75 i +;27;26;53;SEC_536
1997;214;75 i +;39;17;56;SEC_214
1997;510;50-64;115;117;232;SEC_510
1997;623;50-64;178;201;379;SEC_623
1997;101;50-64;82;80;162;SEC_101
1997;320;16-17;5;4;9;SEC_320
1997;246;12-15;20;14;34;SEC_246
1997;113;12-15;44;46;90;SEC_113
1997;107;35-49;185;181;366;SEC_107
1997;210;50-64;104;82;186;SEC_210
1997;508;65-74;39;34;73;SEC_508
1997;303;18-24;112;125;237;SEC_303
1997;514;18-24;35;36;71;SEC_514
1997;113;75 i +;34;17;51;SEC_113
1997;414;00-02;6;8;14;SEC_414
1997;623;03-11;48;58;106;SEC_623
1997;118;50-64;115;153;268;SEC_118
1997;313;25-34;150;149;299;SEC_313
1997;426;18-24;50;64;114;SEC_426
1997;535;25-34;43;81;124;SEC_535
1997;210;18-24;48;50;98;SEC_210
1997;614;75 i +;37;15;52;SEC_614
1997;140;65-74;59;59;118;SEC_140
1997;618;12-15;9;14;23;SEC_618
1997;534;65-74;54;47;101;SEC_534
1997;103;00-02;9;9;18;SEC_103
1997;240;35-49;53;52;105;SEC_240
1997;522;65-74;39;38;77;SEC_522
1997;622;03-11;42;41;83;SEC_622
1997;314;75 i +;61;26;87;SEC_314
1997;128;12-15;20;22;42;SEC_128
1997;229;18-24;32;37;69;SEC_229
1997;509;16-17;12;6;18;SEC_509
1997;247;35-49;100;112;212;SEC_247
1997;421;00-02;7;14;21;SEC_421
1997;432;16-17;24;21;45;SEC_432
1997;217;18-24;21;25;46;SEC_217
1997;430;12-15;14;17;31;SEC_430
1997;621;00-02;24;14;38;SEC_621
1997;404;65-74;68;61;129;SEC_404
1997;115;75 i +;42;22;64;SEC_115
1997;528;16-17;11;19;30;SEC_528
1997;501;50-64;103;139;242;SEC_501
1997;312;03-11;61;40;101;SEC_312
1997;531;16-17;5;10;15;SEC_531
1997;202;75 i +;33;17;50;SEC_202
1997;114;00-02;21;16;37;SEC_114
1997;215;03-11;23;17;40;SEC_215
1997;320;75 i +;15;8;23;SEC_320
1997;124;03-11;33;31;64;SEC_124
1997;225;75 i +;33;33;66;SEC_225
1997;419;00-02;10;8;18;SEC_419
1997;534;75 i +;43;21;64;SEC_534
1997;244;75 i +;38;30;68;SEC_244
1997;209;16-17;5;4;9;SEC_209
1997;630;03-11;38;31;69;SEC_630
1997;133;35-49;93;83;176;SEC_133
1997;518;03-11;28;35;63;SEC_518
1997;436;18-24;46;42;88;SEC_436
1997;431;00-02;8;16;24;SEC_431
1997;243;35-49;121;121;242;SEC_243
1997;323;75 i +;37;14;51;SEC_323
1997;421;75 i +;47;28;75;SEC_421
1997;114;50-64;203;188;391;SEC_114
1997;422;65-74;91;62;153;SEC_422
1997;414;35-49;79;69;148;SEC_414
1997;235;18-24;72;60;132;SEC_235
1997;218;16-17;10;12;22;SEC_218
1997;438;18-24;53;48;101;SEC_438
1997;108;12-15;26;24;50;SEC_108
1997;109;16-17;11;19;30;SEC_109
1997;225;35-49;50;36;86;SEC_225
1997;618;00-02;6;5;11;SEC_618
1997;411;00-02;10;6;16;SEC_411
1997;101;35-49;145;142;287;SEC_101
1997;536;65-74;76;66;142;SEC_536
1997;524;12-15;19;25;44;SEC_524
1997;112;12-15;41;28;69;SEC_112
1997;206;18-24;33;50;83;SEC_206
1997;413;50-64;58;53;111;SEC_413
1997;313;50-64;154;146;300;SEC_313
1997;434;00-02;3;6;9;SEC_434
1997;321;03-11;92;109;201;SEC_321
1997;310;16-17;16;18;34;SEC_310
1997;507;75 i +;37;25;62;SEC_507
1997;409;25-34;57;61;118;SEC_409
1997;115;50-64;106;118;224;SEC_115
1997;520;16-17;7;11;18;SEC_520
1997;506;65-74;62;67;129;SEC_506
1997;530;18-24;68;80;148;SEC_530
1997;531;03-11;32;30;62;SEC_531
1997;418;12-15;25;23;48;SEC_418
1997;413;18-24;26;34;60;SEC_413
1997;237;16-17;16;9;25;SEC_237
1997;128;65-74;50;42;92;SEC_128
1997;104;16-17;11;8;19;SEC_104
1997;209;18-24;31;35;66;SEC_209
1997;415;65-74;46;32;78;SEC_415
1997;527;75 i +;45;21;66;SEC_527
1997;301;12-15;35;56;91;SEC_301
1997;120;03-11;85;80;165;SEC_120
1997;209;65-74;84;66;150;SEC_209
1997;108;03-11;50;44;94;SEC_108
1997;617;00-02;10;14;24;SEC_617
1997;632;12-15;21;36;57;SEC_632
1997;117;16-17;30;36;66;SEC_117
1997;407;35-49;78;80;158;SEC_407
1997;227;25-34;50;51;101;SEC_227
1997;432;35-49;154;134;288;SEC_432
1997;522;16-17;10;11;21;SEC_522
1997;622;50-64;63;74;137;SEC_622
1997;129;65-74;44;34;78;SEC_129
1997;109;50-64;96;98;194;SEC_109
1997;515;50-64;53;62;115;SEC_515
1997;410;12-15;35;37;72;SEC_410
1997;631;65-74;44;41;85;SEC_631
1997;116;75 i +;54;17;71;SEC_116
1997;611;50-64;228;219;447;SEC_611
1997;125;25-34;88;92;180;SEC_125
1997;629;16-17;12;9;21;SEC_629
1997;221;12-15;22;18;40;SEC_221
1997;317;12-15;13;16;29;SEC_317
1997;624;18-24;129;147;276;SEC_624
1997;107;18-24;129;141;270;SEC_107
1997;437;35-49;75;72;147;SEC_437
1997;129;75 i +;38;18;56;SEC_129
1997;619;16-17;26;24;50;SEC_619
1997;503;12-15;24;28;52;SEC_503
1997;536;00-02;10;11;21;SEC_536
1997;101;75 i +;25;8;33;SEC_101
1997;619;50-64;156;163;319;SEC_619
1997;601;50-64;185;182;367;SEC_601
1997;127;35-49;94;95;189;SEC_127
1997;441;00-02;16;12;28;SEC_441
1997;429;16-17;9;14;23;SEC_429
1997;423;03-11;33;34;67;SEC_423
1997;511;35-49;45;53;98;SEC_511
1997;425;35-49;76;75;151;SEC_425
1997;612;12-15;23;24;47;SEC_612
1997;233;16-17;7;5;12;SEC_233
1997;102;75 i +;75;34;109;SEC_102
1997;122;00-02;14;4;18;SEC_122
1997;528;35-49;78;82;160;SEC_528
1997;117;00-02;29;22;51;SEC_117
1997;604;12-15;18;16;34;SEC_604
1997;112;00-02;20;16;36;SEC_112
1997;624;00-02;8;8;16;SEC_624
1997;301;03-11;55;66;121;SEC_301
1997;517;00-02;8;7;15;SEC_517
1997;628;03-11;39;32;71;SEC_628
1997;412;18-24;88;108;196;SEC_412
1997;624;65-74;31;36;67;SEC_624
1997;139;18-24;61;72;133;SEC_139
1997;218;18-24;35;42;77;SEC_218
1997;520;03-11;38;28;66;SEC_520
1997;208;50-64;216;179;395;SEC_208
1997;311;25-34;123;134;257;SEC_311
1997;536;18-24;48;47;95;SEC_536
1997;234;03-11;30;30;60;SEC_234
1997;122;75 i +;40;28;68;SEC_122
1997;314;65-74;66;57;123;SEC_314
1997;111;03-11;47;32;79;SEC_111
1997;315;12-15;41;35;76;SEC_315
1997;520;65-74;48;52;100;SEC_520
1997;602;12-15;11;11;22;SEC_602
1997;428;50-64;48;42;90;SEC_428
1997;132;12-15;52;67;119;SEC_132
1997;103;03-11;23;21;44;SEC_103
1997;235;65-74;109;85;194;SEC_235
1997;614;50-64;126;130;256;SEC_614
1997;438;16-17;7;9;16;SEC_438
1997;320;18-24;37;56;93;SEC_320
1997;231;35-49;83;76;159;SEC_231
1997;416;35-49;54;57;111;SEC_416
1997;220;65-74;66;53;119;SEC_220
1997;632;25-34;90;102;192;SEC_632
1997;527;50-64;97;86;183;SEC_527
1997;609;65-74;27;27;54;SEC_609
1997;441;16-17;30;36;66;SEC_441
1997;118;00-02;16;20;36;SEC_118
1997;519;12-15;11;9;20;SEC_519
1997;532;35-49;116;94;210;SEC_532
1997;515;16-17;9;2;11;SEC_515
1997;621;03-11;61;63;124;SEC_621
1997;202;25-34;56;78;134;SEC_202
1997;215;75 i +;65;40;105;SEC_215
1997;106;16-17;42;34;76;SEC_106
1997;314;35-49;338;333;671;SEC_314
1997;428;75 i +;31;17;48;SEC_428
1997;123;50-64;100;107;207;SEC_123
1997;503;65-74;31;18;49;SEC_503
1997;226;16-17;13;13;26;SEC_226
1997;510;18-24;72;64;136;SEC_510
1997;104;18-24;35;44;79;SEC_104
1997;231;03-11;31;29;60;SEC_231
1997;112;18-24;98;90;188;SEC_112
1997;218;03-11;16;30;46;SEC_218
1997;621;16-17;31;33;64;SEC_621
1997;507;00-02;7;11;18;SEC_507
1997;442;65-74;37;27;64;SEC_442
1997;107;75 i +;50;26;76;SEC_107
1997;231;75 i +;78;35;113;SEC_231
1997;237;00-02;11;14;25;SEC_237
1997;249;75 i +;50;27;77;SEC_249
1997;536;12-15;11;8;19;SEC_536
1997;520;18-24;59;62;121;SEC_520
1997;113;50-64;98;102;200;SEC_113
1997;440;50-64;154;163;317;SEC_440
1997;512;16-17;8;13;21;SEC_512
1997;208;16-17;19;20;39;SEC_208
1997;124;00-02;10;6;16;SEC_124
1997;241;12-15;10;8;18;SEC_241
1997;321;16-17;48;37;85;SEC_321
1997;312;65-74;50;43;93;SEC_312
1997;203;50-64;67;67;134;SEC_203
1997;421;25-34;119;127;246;SEC_421
1997;602;65-74;24;24;48;SEC_602
1997;307;35-49;223;188;411;SEC_307
1997;601;65-74;53;54;107;SEC_601
1997;505;65-74;54;42;96;SEC_505
1997;408;03-11;34;19;53;SEC_408
1997;516;75 i +;29;9;38;SEC_516
1997;318;50-64;53;63;116;SEC_318
1997;625;25-34;84;91;175;SEC_625
1997;631;03-11;40;27;67;SEC_631
1997;518;00-02;8;12;20;SEC_518
1997;531;18-24;41;52;93;SEC_531
1997;423;75 i +;43;20;63;SEC_423
1997;608;65-74;41;39;80;SEC_608
1997;629;50-64;71;59;130;SEC_629
1997;314;00-02;22;28;50;SEC_314
1997;208;25-34;107;135;242;SEC_208
1997;529;18-24;63;49;112;SEC_529
1997;105;65-74;53;37;90;SEC_105
1997;434;35-49;53;63;116;SEC_434
1997;230;25-34;69;83;152;SEC_230
1997;437;75 i +;18;12;30;SEC_437
1997;131;50-64;120;147;267;SEC_131
1997;317;16-17;5;6;11;SEC_317
1997;227;50-64;66;66;132;SEC_227
1997;248;00-02;8;11;19;SEC_248
1997;247;00-02;8;9;17;SEC_247
1997;434;03-11;28;21;49;SEC_434
1997;538;16-17;5;10;15;SEC_538
1997;440;03-11;18;24;42;SEC_440
1997;521;50-64;133;183;316;SEC_521
1997;632;18-24;101;110;211;SEC_632
1997;522;35-49;68;53;121;SEC_522
1997;308;50-64;143;143;286;SEC_308
1997;117;03-11;76;74;150;SEC_117
1997;517;12-15;19;25;44;SEC_517
1997;119;75 i +;38;28;66;SEC_119
1997;433;25-34;111;110;221;SEC_433
1997;536;50-64;107;101;208;SEC_536
1997;509;18-24;44;52;96;SEC_509
1997;626;00-02;13;12;25;SEC_626
1997;526;03-11;20;26;46;SEC_526
1997;137;35-49;181;155;336;SEC_137
1997;203;12-15;7;18;25;SEC_203
1997;302;50-64;133;158;291;SEC_302
1997;229;75 i +;42;17;59;SEC_229
1997;513;65-74;41;37;78;SEC_513
1997;617;35-49;102;111;213;SEC_617
1997;409;03-11;18;23;41;SEC_409
1997;434;12-15;10;13;23;SEC_434
1997;309;25-34;61;54;115;SEC_309
1997;501;18-24;121;143;264;SEC_501
1997;612;35-49;76;77;153;SEC_612
1997;610;03-11;32;42;74;SEC_610
1997;239;50-64;133;97;230;SEC_239
1997;319;18-24;45;55;100;SEC_319
1997;417;16-17;8;2;10;SEC_417
1997;507;16-17;17;12;29;SEC_507
1997;605;50-64;125;105;230;SEC_605
1997;247;75 i +;58;30;88;SEC_247
1997;229;12-15;6;11;17;SEC_229
1997;523;65-74;96;78;174;SEC_523
1997;523;50-64;150;143;293;SEC_523
1997;210;16-17;10;6;16;SEC_210
1997;212;75 i +;60;34;94;SEC_212
1997;503;00-02;4;12;16;SEC_503
1997;233;25-34;75;68;143;SEC_233
1997;610;00-02;7;12;19;SEC_610
1997;607;75 i +;33;13;46;SEC_607
1997;208;03-11;45;45;90;SEC_208
1997;110;35-49;172;138;310;SEC_110
1997;121;03-11;32;25;57;SEC_121
1997;406;25-34;103;104;207;SEC_406
1997;219;25-34;88;91;179;SEC_219
1997;615;12-15;16;6;22;SEC_615
1997;317;50-64;61;74;135;SEC_317
1997;512;50-64;105;108;213;SEC_512
1997;625;35-49;222;195;417;SEC_625
1997;521;65-74;44;39;83;SEC_521
1997;226;18-24;64;55;119;SEC_226
1997;530;12-15;22;26;48;SEC_530
1997;621;18-24;161;198;359;SEC_621
1997;104;65-74;73;54;127;SEC_104
1997;302;75 i +;45;21;66;SEC_302
1997;425;18-24;55;48;103;SEC_425
1997;604;50-64;93;76;169;SEC_604
1997;529;25-34;88;104;192;SEC_529
1997;138;18-24;53;55;108;SEC_138
1997;404;35-49;112;121;233;SEC_404
1997;237;12-15;23;14;37;SEC_237
1997;239;35-49;93;80;173;SEC_239
1997;213;25-34;58;73;131;SEC_213
1997;238;03-11;17;23;40;SEC_238
1997;530;03-11;40;46;86;SEC_530
1997;316;35-49;469;402;871;SEC_316
1997;404;25-34;104;117;221;SEC_404
1997;505;25-34;130;129;259;SEC_505
1997;315;03-11;51;67;118;SEC_315
1997;524;75 i +;48;28;76;SEC_524
1997;206;50-64;103;86;189;SEC_206
1997;502;18-24;94;126;220;SEC_502
1997;124;16-17;11;14;25;SEC_124
1997;116;16-17;24;22;46;SEC_116
1997;421;16-17;15;12;27;SEC_421
1997;323;18-24;198;190;388;SEC_323
1997;616;25-34;135;146;281;SEC_616
1997;209;35-49;79;86;165;SEC_209
1997;522;50-64;68;66;134;SEC_522
1997;516;12-15;14;3;17;SEC_516
1997;510;35-49;83;91;174;SEC_510
1997;324;16-17;5;4;9;SEC_324
1997;110;65-74;54;49;103;SEC_110
1997;402;03-11;19;20;39;SEC_402
1997;416;03-11;19;23;42;SEC_416
1997;615;65-74;33;25;58;SEC_615
1997;236;35-49;86;80;166;SEC_236
1997;537;18-24;76;76;152;SEC_537
1997;101;65-74;33;37;70;SEC_101
1997;419;16-17;4;14;18;SEC_419
1997;615;75 i +;22;11;33;SEC_615
1997;602;50-64;94;86;180;SEC_602
1997;305;12-15;32;42;74;SEC_305
1997;532;18-24;83;98;181;SEC_532
1997;229;16-17;2;7;9;SEC_229
1997;420;18-24;65;71;136;SEC_420
1997;107;50-64;188;194;382;SEC_107
1997;427;25-34;72;73;145;SEC_427
1997;627;75 i +;17;10;27;SEC_627
1997;629;00-02;4;12;16;SEC_629
1997;104;25-34;64;87;151;SEC_104
1997;616;16-17;49;47;96;SEC_616
1997;601;75 i +;66;23;89;SEC_601
1997;238;35-49;65;72;137;SEC_238
1997;125;00-02;9;9;18;SEC_125
1997;526;18-24;33;48;81;SEC_526
1997;129;35-49;96;104;200;SEC_129
1997;605;03-11;13;13;26;SEC_605
1997;622;35-49;120;114;234;SEC_622
1997;421;12-15;17;18;35;SEC_421
1997;325;18-24;117;132;249;SEC_325
1997;609;03-11;29;32;61;SEC_609
1997;311;03-11;42;38;80;SEC_311
