AnyPadro;Seccio;GrupEdat;Dones;Homes;Total;IdSeccio
2007;108;25-34;115;117;232;SEC_108
2007;309;18-24;27;29;56;SEC_309
2007;409;12-15;10;11;21;SEC_409
2007;217;35-49;81;106;187;SEC_217
2007;111;03-11;22;38;60;SEC_111
2007;508;50-64;35;41;76;SEC_508
2007;534;12-15;14;15;29;SEC_534
2007;307;12-15;13;17;30;SEC_307
2007;241;00-02;7;12;19;SEC_241
2007;607;16-17;8;4;12;SEC_607
2007;506;35-49;178;179;357;SEC_506
2007;419;18-24;55;48;103;SEC_419
2007;105;65-74;36;38;74;SEC_105
2007;133;03-11;30;37;67;SEC_133
2007;613;18-24;38;37;75;SEC_613
2007;511;75 i +;55;34;89;SEC_511
2007;301;25-34;262;260;522;SEC_301
2007;408;65-74;57;36;93;SEC_408
2007;213;03-11;24;49;73;SEC_213
2007;129;50-64;111;94;205;SEC_129
2007;230;75 i +;59;26;85;SEC_230
2007;206;25-34;84;113;197;SEC_206
2007;307;16-17;11;16;27;SEC_307
2007;304;18-24;57;63;120;SEC_304
2007;616;03-11;126;161;287;SEC_616
2007;304;35-49;171;181;352;SEC_304
2007;244;25-34;82;70;152;SEC_244
2007;614;18-24;23;34;57;SEC_614
2007;523;65-74;89;81;170;SEC_523
2007;519;65-74;38;25;63;SEC_519
2007;423;03-11;40;26;66;SEC_423
2007;604;12-15;11;12;23;SEC_604
2007;509;03-11;39;35;74;SEC_509
2007;430;18-24;42;46;88;SEC_430
2007;411;12-15;15;12;27;SEC_411
2007;521;35-49;83;96;179;SEC_521
2007;521;16-17;6;5;11;SEC_521
2007;240;65-74;45;42;87;SEC_240
2007;318;25-34;67;60;127;SEC_318
2007;433;50-64;73;70;143;SEC_433
2007;207;12-15;4;10;14;SEC_207
2007;103;75 i +;40;23;63;SEC_103
2007;521;25-34;61;96;157;SEC_521
2007;119;35-49;122;122;244;SEC_119
2007;534;18-24;33;40;73;SEC_534
2007;527;75 i +;58;30;88;SEC_527
2007;236;50-64;101;79;180;SEC_236
2007;244;16-17;7;3;10;SEC_244
2007;533;65-74;65;42;107;SEC_533
2007;413;35-49;68;94;162;SEC_413
2007;124;75 i +;35;23;58;SEC_124
2007;526;03-11;22;28;50;SEC_526
2007;601;25-34;118;127;245;SEC_601
2007;130;50-64;62;71;133;SEC_130
2007;245;18-24;31;44;75;SEC_245
2007;202;18-24;22;41;63;SEC_202
2007;425;16-17;8;13;21;SEC_425
2007;238;50-64;70;69;139;SEC_238
2007;412;35-49;171;174;345;SEC_412
2007;632;25-34;80;93;173;SEC_632
2007;439;50-64;60;58;118;SEC_439
2007;523;16-17;14;13;27;SEC_523
2007;626;75 i +;44;39;83;SEC_626
2007;323;16-17;31;24;55;SEC_323
2007;405;18-24;33;28;61;SEC_405
2007;114;75 i +;74;45;119;SEC_114
2007;249;50-64;90;82;172;SEC_249
2007;247;50-64;103;100;203;SEC_247
2007;309;75 i +;33;18;51;SEC_309
2007;321;75 i +;110;57;167;SEC_321
2007;249;00-02;25;18;43;SEC_249
2007;238;12-15;16;14;30;SEC_238
2007;426;00-02;17;23;40;SEC_426
2007;108;35-49;161;149;310;SEC_108
2007;324;16-17;5;6;11;SEC_324
2007;131;16-17;10;6;16;SEC_131
2007;537;16-17;21;9;30;SEC_537
2007;623;16-17;3;16;19;SEC_623
2007;132;00-02;33;21;54;SEC_132
2007;406;35-49;155;169;324;SEC_406
2007;223;75 i +;62;40;102;SEC_223
2007;605;35-49;68;66;134;SEC_605
2007;537;12-15;28;24;52;SEC_537
2007;435;50-64;84;65;149;SEC_435
2007;431;00-02;16;25;41;SEC_431
2007;133;75 i +;52;39;91;SEC_133
2007;314;25-34;197;230;427;SEC_314
2007;102;16-17;7;12;19;SEC_102
2007;614;75 i +;46;31;77;SEC_614
2007;516;12-15;11;19;30;SEC_516
2007;104;50-64;75;54;129;SEC_104
2007;237;75 i +;79;39;118;SEC_237
2007;431;65-74;75;56;131;SEC_431
2007;139;25-34;97;123;220;SEC_139
2007;538;16-17;7;7;14;SEC_538
2007;516;03-11;26;37;63;SEC_516
2007;103;12-15;9;7;16;SEC_103
2007;208;50-64;189;145;334;SEC_208
2007;135;35-49;190;173;363;SEC_135
2007;242;03-11;36;31;67;SEC_242
2007;215;65-74;50;25;75;SEC_215
2007;412;65-74;103;98;201;SEC_412
2007;433;03-11;49;67;116;SEC_433
2007;626;50-64;102;85;187;SEC_626
2007;310;03-11;29;38;67;SEC_310
2007;425;18-24;40;44;84;SEC_425
2007;115;50-64;126;136;262;SEC_115
2007;117;75 i +;69;41;110;SEC_117
2007;438;18-24;46;32;78;SEC_438
2007;226;18-24;65;46;111;SEC_226
2007;624;12-15;12;19;31;SEC_624
2007;409;25-34;66;88;154;SEC_409
2007;517;12-15;23;20;43;SEC_517
2007;515;50-64;46;34;80;SEC_515
2007;518;03-11;50;45;95;SEC_518
2007;306;00-02;20;22;42;SEC_306
2007;422;12-15;15;25;40;SEC_422
2007;532;00-02;19;21;40;SEC_532
2007;317;03-11;61;39;100;SEC_317
2007;113;25-34;159;168;327;SEC_113
2007;414;50-64;68;60;128;SEC_414
2007;313;65-74;84;73;157;SEC_313
2007;417;18-24;38;32;70;SEC_417
2007;403;00-02;14;17;31;SEC_403
2007;422;03-11;42;46;88;SEC_422
2007;531;18-24;32;49;81;SEC_531
2007;404;12-15;21;30;51;SEC_404
2007;624;03-11;34;39;73;SEC_624
2007;138;75 i +;33;21;54;SEC_138
2007;528;12-15;18;22;40;SEC_528
2007;314;03-11;69;88;157;SEC_314
2007;433;16-17;13;11;24;SEC_433
2007;613;16-17;7;7;14;SEC_613
2007;439;16-17;11;11;22;SEC_439
2007;609;16-17;12;2;14;SEC_609
2007;122;12-15;12;8;20;SEC_122
2007;421;50-64;101;85;186;SEC_421
2007;601;75 i +;61;44;105;SEC_601
2007;233;65-74;59;48;107;SEC_233
2007;201;35-49;75;110;185;SEC_201
2007;133;12-15;9;9;18;SEC_133
2007;430;50-64;62;61;123;SEC_430
2007;209;18-24;35;47;82;SEC_209
2007;621;12-15;33;17;50;SEC_621
2007;617;18-24;39;32;71;SEC_617
2007;215;25-34;97;110;207;SEC_215
2007;139;00-02;17;16;33;SEC_139
2007;629;25-34;38;50;88;SEC_629
2007;318;16-17;8;8;16;SEC_318
2007;612;50-64;113;88;201;SEC_612
2007;307;35-49;137;120;257;SEC_307
2007;503;18-24;41;35;76;SEC_503
2007;124;18-24;36;35;71;SEC_124
2007;228;25-34;83;96;179;SEC_228
2007;536;03-11;39;30;69;SEC_536
2007;207;50-64;70;60;130;SEC_207
2007;126;75 i +;58;28;86;SEC_126
2007;320;12-15;14;10;24;SEC_320
2007;306;65-74;77;59;136;SEC_306
2007;401;12-15;24;16;40;SEC_401
2007;622;03-11;19;32;51;SEC_622
2007;602;65-74;52;71;123;SEC_602
2007;439;35-49;145;154;299;SEC_439
2007;530;35-49;169;161;330;SEC_530
2007;538;12-15;13;18;31;SEC_538
2007;515;03-11;19;28;47;SEC_515
2007;115;00-02;10;15;25;SEC_115
2007;211;00-02;20;23;43;SEC_211
2007;249;03-11;34;41;75;SEC_249
2007;120;00-02;15;39;54;SEC_120
2007;410;00-02;23;24;47;SEC_410
2007;509;50-64;64;52;116;SEC_509
2007;440;35-49;84;99;183;SEC_440
2007;618;50-64;64;46;110;SEC_618
2007;101;35-49;239;241;480;SEC_101
2007;311;65-74;79;71;150;SEC_311
2007;503;12-15;12;17;29;SEC_503
2007;317;35-49;110;133;243;SEC_317
2007;115;35-49;149;146;295;SEC_115
2007;508;18-24;28;25;53;SEC_508
2007;216;65-74;75;52;127;SEC_216
2007;212;03-11;60;62;122;SEC_212
2007;524;25-34;163;168;331;SEC_524
2007;135;50-64;145;149;294;SEC_135
2007;415;00-02;14;12;26;SEC_415
2007;203;65-74;36;30;66;SEC_203
2007;507;03-11;29;42;71;SEC_507
2007;205;75 i +;64;41;105;SEC_205
2007;513;35-49;90;80;170;SEC_513
2007;417;35-49;75;83;158;SEC_417
2007;419;00-02;16;21;37;SEC_419
2007;323;12-15;54;56;110;SEC_323
2007;404;25-34;118;149;267;SEC_404
2007;245;75 i +;67;34;101;SEC_245
2007;238;03-11;36;36;72;SEC_238
2007;413;03-11;16;19;35;SEC_413
2007;630;50-64;130;95;225;SEC_630
2007;221;65-74;67;58;125;SEC_221
2007;218;16-17;6;10;16;SEC_218
2007;504;50-64;130;93;223;SEC_504
2007;114;16-17;10;14;24;SEC_114
2007;227;18-24;18;13;31;SEC_227
2007;510;50-64;83;91;174;SEC_510
2007;422;16-17;11;9;20;SEC_422
2007;244;35-49;90;99;189;SEC_244
2007;123;50-64;111;106;217;SEC_123
2007;442;50-64;47;42;89;SEC_442
2007;410;75 i +;113;99;212;SEC_410
2007;412;03-11;65;41;106;SEC_412
2007;601;16-17;16;14;30;SEC_601
2007;248;12-15;32;21;53;SEC_248
2007;512;65-74;64;57;121;SEC_512
2007;303;75 i +;94;75;169;SEC_303
2007;532;18-24;69;57;126;SEC_532
2007;631;00-02;14;11;25;SEC_631
2007;437;00-02;19;11;30;SEC_437
2007;418;65-74;75;61;136;SEC_418
2007;509;25-34;85;102;187;SEC_509
2007;319;03-11;83;81;164;SEC_319
2007;119;12-15;12;14;26;SEC_119
2007;534;50-64;83;75;158;SEC_534
2007;131;75 i +;63;41;104;SEC_131
2007;119;00-02;14;13;27;SEC_119
2007;317;50-64;61;74;135;SEC_317
2007;627;16-17;4;8;12;SEC_627
2007;225;03-11;12;14;26;SEC_225
2007;309;16-17;10;10;20;SEC_309
2007;110;00-02;12;6;18;SEC_110
2007;407;75 i +;76;56;132;SEC_407
2007;408;12-15;15;11;26;SEC_408
2007;610;50-64;165;105;270;SEC_610
2007;629;18-24;25;19;44;SEC_629
2007;603;18-24;15;22;37;SEC_603
2007;132;25-34;174;220;394;SEC_132
2007;414;75 i +;64;44;108;SEC_414
2007;514;50-64;56;54;110;SEC_514
2007;224;75 i +;34;22;56;SEC_224
2007;206;03-11;25;39;64;SEC_206
2007;622;35-49;77;87;164;SEC_622
2007;506;65-74;99;102;201;SEC_506
2007;232;35-49;116;115;231;SEC_232
2007;241;12-15;13;10;23;SEC_241
2007;217;12-15;9;11;20;SEC_217
2007;229;03-11;41;27;68;SEC_229
2007;411;50-64;98;76;174;SEC_411
2007;625;00-02;8;10;18;SEC_625
2007;405;12-15;6;9;15;SEC_405
2007;607;03-11;43;36;79;SEC_607
2007;119;50-64;189;160;349;SEC_119
2007;101;65-74;52;52;104;SEC_101
2007;523;12-15;18;27;45;SEC_523
2007;440;65-74;74;80;154;SEC_440
2007;418;12-15;27;17;44;SEC_418
2007;602;18-24;21;23;44;SEC_602
2007;223;35-49;143;169;312;SEC_223
2007;319;12-15;21;23;44;SEC_319
2007;605;00-02;9;7;16;SEC_605
2007;608;18-24;26;32;58;SEC_608
2007;108;03-11;56;46;102;SEC_108
2007;139;18-24;28;42;70;SEC_139
2007;318;03-11;29;39;68;SEC_318
2007;432;16-17;13;15;28;SEC_432
2007;427;75 i +;54;41;95;SEC_427
2007;246;03-11;51;44;95;SEC_246
2007;430;35-49;109;148;257;SEC_430
2007;106;12-15;26;28;54;SEC_106
2007;420;50-64;105;87;192;SEC_420
2007;626;16-17;14;3;17;SEC_626
2007;626;35-49;89;108;197;SEC_626
2007;220;00-02;12;10;22;SEC_220
2007;632;75 i +;39;26;65;SEC_632
2007;420;16-17;16;14;30;SEC_420
2007;414;03-11;35;39;74;SEC_414
2007;518;16-17;13;14;27;SEC_518
2007;121;65-74;48;31;79;SEC_121
2007;529;00-02;32;24;56;SEC_529
2007;507;35-49;91;109;200;SEC_507
2007;621;00-02;15;20;35;SEC_621
2007;430;75 i +;53;37;90;SEC_430
2007;423;50-64;77;64;141;SEC_423
2007;434;12-15;14;13;27;SEC_434
2007;513;18-24;33;19;52;SEC_513
2007;614;03-11;33;28;61;SEC_614
2007;322;50-64;104;101;205;SEC_322
2007;617;16-17;11;8;19;SEC_617
2007;249;25-34;115;105;220;SEC_249
2007;130;35-49;123;131;254;SEC_130
2007;219;25-34;110;128;238;SEC_219
2007;535;16-17;9;12;21;SEC_535
2007;139;12-15;15;14;29;SEC_139
2007;127;75 i +;40;31;71;SEC_127
2007;241;65-74;39;40;79;SEC_241
2007;425;75 i +;59;47;106;SEC_425
2007;242;00-02;16;15;31;SEC_242
2007;513;03-11;37;30;67;SEC_513
2007;243;25-34;136;138;274;SEC_243
2007;220;50-64;62;51;113;SEC_220
2007;412;12-15;32;34;66;SEC_412
2007;315;18-24;66;67;133;SEC_315
2007;124;12-15;6;13;19;SEC_124
2007;509;16-17;8;3;11;SEC_509
2007;241;35-49;113;96;209;SEC_241
2007;419;16-17;9;7;16;SEC_419
2007;530;18-24;59;54;113;SEC_530
2007;502;25-34;147;160;307;SEC_502
2007;432;00-02;20;11;31;SEC_432
2007;438;25-34;91;93;184;SEC_438
2007;607;35-49;126;131;257;SEC_607
2007;207;00-02;19;7;26;SEC_207
2007;248;65-74;51;48;99;SEC_248
2007;611;75 i +;72;47;119;SEC_611
2007;437;25-34;80;108;188;SEC_437
2007;529;75 i +;76;42;118;SEC_529
2007;410;50-64;164;155;319;SEC_410
2007;619;18-24;46;58;104;SEC_619
2007;631;18-24;30;22;52;SEC_631
2007;219;16-17;10;10;20;SEC_219
2007;630;75 i +;35;19;54;SEC_630
2007;228;00-02;7;15;22;SEC_228
2007;434;65-74;33;14;47;SEC_434
2007;130;00-02;14;11;25;SEC_130
2007;308;75 i +;82;50;132;SEC_308
2007;606;35-49;123;139;262;SEC_606
2007;531;16-17;10;10;20;SEC_531
2007;610;00-02;11;14;25;SEC_610
2007;118;12-15;29;35;64;SEC_118
2007;324;12-15;18;22;40;SEC_324
2007;627;18-24;46;59;105;SEC_627
2007;415;12-15;14;14;28;SEC_415
2007;501;00-02;4;13;17;SEC_501
2007;401;50-64;93;94;187;SEC_401
2007;112;50-64;169;169;338;SEC_112
2007;301;03-11;102;99;201;SEC_301
2007;230;25-34;104;107;211;SEC_230
2007;323;65-74;82;70;152;SEC_323
2007;616;75 i +;49;33;82;SEC_616
2007;402;25-34;82;81;163;SEC_402
2007;112;16-17;13;20;33;SEC_112
2007;603;25-34;50;60;110;SEC_603
2007;228;16-17;12;8;20;SEC_228
2007;441;12-15;32;32;64;SEC_441
2007;322;18-24;38;52;90;SEC_322
2007;609;03-11;34;28;62;SEC_609
2007;510;00-02;10;18;28;SEC_510
2007;441;65-74;76;80;156;SEC_441
2007;324;35-49;119;129;248;SEC_324
2007;104;65-74;54;36;90;SEC_104
2007;302;00-02;14;18;32;SEC_302
2007;130;75 i +;74;49;123;SEC_130
2007;524;75 i +;64;34;98;SEC_524
2007;221;75 i +;55;41;96;SEC_221
2007;128;12-15;18;14;32;SEC_128
2007;116;50-64;177;147;324;SEC_116
2007;422;00-02;20;17;37;SEC_422
2007;420;75 i +;69;35;104;SEC_420
2007;509;65-74;42;36;78;SEC_509
2007;118;03-11;71;55;126;SEC_118
2007;114;25-34;148;142;290;SEC_114
2007;510;75 i +;67;36;103;SEC_510
2007;615;00-02;8;12;20;SEC_615
2007;124;00-02;13;14;27;SEC_124
2007;622;00-02;9;13;22;SEC_622
2007;617;00-02;11;10;21;SEC_617
2007;216;35-49;146;147;293;SEC_216
2007;125;50-64;178;158;336;SEC_125
2007;608;03-11;24;28;52;SEC_608
2007;623;75 i +;56;31;87;SEC_623
2007;214;75 i +;29;18;47;SEC_214
2007;236;12-15;21;15;36;SEC_236
2007;325;35-49;196;172;368;SEC_325
2007;305;75 i +;101;56;157;SEC_305
2007;501;16-17;9;11;20;SEC_501
2007;245;03-11;46;39;85;SEC_245
2007;508;35-49;55;78;133;SEC_508
2007;441;35-49;212;199;411;SEC_441
2007;409;35-49;88;82;170;SEC_409
2007;428;75 i +;36;24;60;SEC_428
2007;624;75 i +;36;23;59;SEC_624
2007;113;65-74;49;45;94;SEC_113
2007;133;65-74;47;34;81;SEC_133
2007;109;25-34;82;78;160;SEC_109
2007;107;16-17;11;21;32;SEC_107
2007;407;25-34;103;118;221;SEC_407
2007;522;00-02;20;26;46;SEC_522
2007;319;25-34;188;209;397;SEC_319
2007;322;65-74;58;47;105;SEC_322
2007;433;25-34;143;187;330;SEC_433
2007;524;12-15;22;23;45;SEC_524
2007;510;25-34;82;103;185;SEC_510
2007;121;50-64;41;42;83;SEC_121
2007;305;50-64;163;160;323;SEC_305
2007;115;75 i +;75;37;112;SEC_115
2007;609;18-24;31;31;62;SEC_609
2007;247;00-02;22;29;51;SEC_247
2007;231;03-11;51;45;96;SEC_231
2007;420;00-02;28;34;62;SEC_420
2007;629;12-15;8;9;17;SEC_629
2007;622;18-24;28;30;58;SEC_622
2007;620;65-74;43;46;89;SEC_620
2007;105;35-49;151;135;286;SEC_105
2007;136;35-49;131;148;279;SEC_136
2007;417;16-17;7;3;10;SEC_417
2007;404;35-49;143;164;307;SEC_404
2007;420;12-15;25;30;55;SEC_420
2007;116;16-17;12;12;24;SEC_116
2007;102;18-24;51;50;101;SEC_102
2007;213;75 i +;56;28;84;SEC_213
2007;320;65-74;37;35;72;SEC_320
2007;618;00-02;9;10;19;SEC_618
2007;435;00-02;17;29;46;SEC_435
2007;234;16-17;6;13;19;SEC_234
2007;529;16-17;10;18;28;SEC_529
2007;109;00-02;14;14;28;SEC_109
2007;324;18-24;41;48;89;SEC_324
2007;223;00-02;17;21;38;SEC_223
2007;437;65-74;50;36;86;SEC_437
2007;204;75 i +;45;19;64;SEC_204
2007;216;12-15;32;16;48;SEC_216
2007;131;18-24;52;63;115;SEC_131
2007;309;35-49;103;107;210;SEC_309
2007;526;75 i +;35;21;56;SEC_526
2007;206;50-64;69;67;136;SEC_206
2007;435;65-74;51;34;85;SEC_435
2007;303;35-49;145;163;308;SEC_303
2007;127;35-49;103;110;213;SEC_127
2007;246;35-49;114;165;279;SEC_246
2007;106;18-24;105;81;186;SEC_106
2007;319;65-74;47;41;88;SEC_319
2007;301;18-24;72;76;148;SEC_301
2007;429;16-17;4;8;12;SEC_429
2007;248;25-34;112;134;246;SEC_248
2007;427;18-24;39;37;76;SEC_427
2007;531;00-02;14;17;31;SEC_531
2007;314;16-17;15;36;51;SEC_314
2007;206;65-74;58;36;94;SEC_206
2007;232;12-15;16;12;28;SEC_232
2007;441;18-24;117;98;215;SEC_441
2007;212;50-64;103;106;209;SEC_212
2007;424;65-74;38;24;62;SEC_424
2007;522;50-64;62;56;118;SEC_522
2007;205;50-64;96;76;172;SEC_205
2007;325;16-17;10;15;25;SEC_325
2007;437;75 i +;36;23;59;SEC_437
2007;129;35-49;129;144;273;SEC_129
2007;512;12-15;19;12;31;SEC_512
2007;618;65-74;27;34;61;SEC_618
2007;305;35-49;209;183;392;SEC_305
2007;434;25-34;52;65;117;SEC_434
2007;439;00-02;16;28;44;SEC_439
2007;501;25-34;89;119;208;SEC_501
2007;422;75 i +;74;46;120;SEC_422
2007;116;12-15;30;21;51;SEC_116
2007;422;25-34;124;145;269;SEC_422
2007;611;12-15;33;29;62;SEC_611
2007;203;75 i +;54;31;85;SEC_203
2007;119;16-17;8;16;24;SEC_119
2007;534;65-74;57;54;111;SEC_534
2007;219;75 i +;88;55;143;SEC_219
2007;214;25-34;93;112;205;SEC_214
2007;248;03-11;53;51;104;SEC_248
2007;313;12-15;35;22;57;SEC_313
2007;209;35-49;125;124;249;SEC_209
2007;124;25-34;65;70;135;SEC_124
2007;131;50-64;179;175;354;SEC_131
2007;209;65-74;57;49;106;SEC_209
2007;426;50-64;71;62;133;SEC_426
2007;111;50-64;104;73;177;SEC_111
2007;323;18-24;135;132;267;SEC_323
2007;319;00-02;34;51;85;SEC_319
2007;418;35-49;158;179;337;SEC_418
2007;239;18-24;39;54;93;SEC_239
2007;521;03-11;29;37;66;SEC_521
2007;618;35-49;73;71;144;SEC_618
2007;518;18-24;59;50;109;SEC_518
2007;201;00-02;8;9;17;SEC_201
2007;503;35-49;83;69;152;SEC_503
2007;225;18-24;29;33;62;SEC_225
2007;520;00-02;12;10;22;SEC_520
2007;621;18-24;51;59;110;SEC_621
2007;241;25-34;75;73;148;SEC_241
2007;434;18-24;31;40;71;SEC_434
2007;531;35-49;107;132;239;SEC_531
2007;121;12-15;15;15;30;SEC_121
2007;204;12-15;10;9;19;SEC_204
2007;511;16-17;10;7;17;SEC_511
2007;509;00-02;15;19;34;SEC_509
2007;239;16-17;10;7;17;SEC_239
2007;629;35-49;61;70;131;SEC_629
2007;604;65-74;41;40;81;SEC_604
2007;104;03-11;41;36;77;SEC_104
2007;309;50-64;80;71;151;SEC_309
2007;319;18-24;61;73;134;SEC_319
2007;129;75 i +;45;28;73;SEC_129
2007;621;25-34;129;161;290;SEC_621
2007;321;25-34;193;167;360;SEC_321
2007;312;03-11;47;60;107;SEC_312
2007;105;03-11;35;49;84;SEC_105
2007;510;12-15;14;18;32;SEC_510
2007;417;00-02;11;11;22;SEC_417
2007;135;18-24;72;70;142;SEC_135
2007;227;65-74;39;25;64;SEC_227
2007;220;16-17;7;9;16;SEC_220
2007;437;35-49;102;117;219;SEC_437
2007;508;75 i +;36;22;58;SEC_508
2007;404;00-02;23;25;48;SEC_404
2007;629;00-02;11;5;16;SEC_629
2007;132;03-11;78;78;156;SEC_132
2007;111;16-17;11;10;21;SEC_111
2007;134;00-02;20;14;34;SEC_134
2007;324;75 i +;47;21;68;SEC_324
2007;507;18-24;35;33;68;SEC_507
2007;536;65-74;55;47;102;SEC_536
2007;519;16-17;5;9;14;SEC_519
2007;225;25-34;38;69;107;SEC_225
2007;221;50-64;84;88;172;SEC_221
2007;105;00-02;21;18;39;SEC_105
2007;603;03-11;26;25;51;SEC_603
2007;438;16-17;8;8;16;SEC_438
2007;110;65-74;62;52;114;SEC_110
2007;234;00-02;11;15;26;SEC_234
2007;532;16-17;9;13;22;SEC_532
2007;129;12-15;25;12;37;SEC_129
2007;204;35-49;71;82;153;SEC_204
2007;312;12-15;23;23;46;SEC_312
2007;503;03-11;26;30;56;SEC_503
2007;608;00-02;6;7;13;SEC_608
2007;101;75 i +;42;38;80;SEC_101
2007;108;75 i +;105;69;174;SEC_108
2007;222;25-34;108;122;230;SEC_222
2007;101;50-64;133;117;250;SEC_101
2007;243;75 i +;95;62;157;SEC_243
2007;513;16-17;4;5;9;SEC_513
2007;314;65-74;68;66;134;SEC_314
2007;438;00-02;15;12;27;SEC_438
2007;425;50-64;66;67;133;SEC_425
2007;315;50-64;144;160;304;SEC_315
2007;436;25-34;118;139;257;SEC_436
2007;238;18-24;29;41;70;SEC_238
2007;621;50-64;213;185;398;SEC_621
2007;408;00-02;16;15;31;SEC_408
2007;320;35-49;125;144;269;SEC_320
2007;421;12-15;13;19;32;SEC_421
2007;610;75 i +;51;33;84;SEC_610
2007;604;35-49;91;102;193;SEC_604
2007;140;35-49;108;137;245;SEC_140
2007;207;16-17;8;3;11;SEC_207
2007;442;18-24;28;26;54;SEC_442
2007;427;65-74;50;24;74;SEC_427
2007;631;50-64;145;111;256;SEC_631
2007;320;25-34;87;93;180;SEC_320
2007;211;16-17;14;12;26;SEC_211
2007;411;16-17;10;8;18;SEC_411
2007;236;25-34;90;107;197;SEC_236
2007;528;00-02;16;15;31;SEC_528
2007;307;25-34;117;121;238;SEC_307
2007;409;65-74;45;36;81;SEC_409
2007;115;25-34;120;127;247;SEC_115
2007;242;12-15;12;9;21;SEC_242
2007;516;50-64;38;37;75;SEC_516
2007;523;18-24;60;72;132;SEC_523
2007;538;50-64;107;78;185;SEC_538
2007;421;25-34;79;108;187;SEC_421
2007;115;65-74;62;47;109;SEC_115
2007;205;03-11;32;25;57;SEC_205
2007;402;35-49;93;112;205;SEC_402
2007;105;18-24;42;49;91;SEC_105
2007;247;25-34;126;125;251;SEC_247
2007;136;65-74;61;39;100;SEC_136
2007;315;00-02;26;30;56;SEC_315
2007;113;03-11;47;73;120;SEC_113
2007;227;03-11;35;22;57;SEC_227
2007;527;12-15;22;15;37;SEC_527
2007;604;16-17;8;8;16;SEC_604
2007;237;25-34;146;160;306;SEC_237
2007;434;03-11;21;24;45;SEC_434
2007;401;35-49;143;116;259;SEC_401
2007;211;50-64;87;85;172;SEC_211
2007;518;25-34;99;112;211;SEC_518
2007;120;16-17;20;23;43;SEC_120
2007;314;75 i +;97;49;146;SEC_314
2007;411;65-74;63;57;120;SEC_411
2007;136;18-24;39;32;71;SEC_136
2007;139;65-74;37;30;67;SEC_139
2007;110;25-34;117;125;242;SEC_110
2007;104;25-34;74;70;144;SEC_104
2007;220;03-11;38;29;67;SEC_220
2007;407;03-11;46;38;84;SEC_407
2007;102;12-15;30;29;59;SEC_102
2007;608;35-49;93;98;191;SEC_608
2007;303;50-64;145;118;263;SEC_303
2007;245;35-49;142;134;276;SEC_245
2007;247;12-15;22;18;40;SEC_247
2007;611;35-49;199;257;456;SEC_611
2007;610;18-24;43;45;88;SEC_610
2007;506;16-17;19;21;40;SEC_506
2007;442;75 i +;33;20;53;SEC_442
2007;612;35-49;97;122;219;SEC_612
2007;612;18-24;30;33;63;SEC_612
2007;241;50-64;47;52;99;SEC_241
2007;435;03-11;47;48;95;SEC_435
2007;518;35-49;134;137;271;SEC_518
2007;247;18-24;59;62;121;SEC_247
2007;238;35-49;113;126;239;SEC_238
2007;409;50-64;54;61;115;SEC_409
2007;209;03-11;31;33;64;SEC_209
2007;416;25-34;69;86;155;SEC_416
2007;537;35-49;123;140;263;SEC_537
2007;309;00-02;8;19;27;SEC_309
2007;302;65-74;65;51;116;SEC_302
2007;506;50-64;243;210;453;SEC_506
2007;249;18-24;54;46;100;SEC_249
2007;411;18-24;38;34;72;SEC_411
2007;322;16-17;7;14;21;SEC_322
2007;421;00-02;15;8;23;SEC_421
2007;422;50-64;85;71;156;SEC_422
2007;526;65-74;30;33;63;SEC_526
2007;304;00-02;33;28;61;SEC_304
2007;136;50-64;116;111;227;SEC_136
2007;423;25-34;124;133;257;SEC_423
2007;501;35-49;101;102;203;SEC_501
2007;515;12-15;19;11;30;SEC_515
2007;442;35-49;80;71;151;SEC_442
2007;120;35-49;232;225;457;SEC_120
2007;101;03-11;97;70;167;SEC_101
2007;137;50-64;172;152;324;SEC_137
2007;229;50-64;64;46;110;SEC_229
2007;625;25-34;107;125;232;SEC_625
2007;606;12-15;20;18;38;SEC_606
2007;231;18-24;33;42;75;SEC_231
2007;510;03-11;29;31;60;SEC_510
2007;615;65-74;56;77;133;SEC_615
2007;533;75 i +;39;38;77;SEC_533
2007;415;18-24;39;44;83;SEC_415
2007;137;12-15;24;21;45;SEC_137
2007;424;16-17;6;7;13;SEC_424
2007;246;50-64;82;69;151;SEC_246
2007;512;00-02;21;21;42;SEC_512
2007;131;65-74;57;57;114;SEC_131
2007;224;65-74;33;16;49;SEC_224
2007;102;65-74;95;97;192;SEC_102
2007;322;12-15;23;15;38;SEC_322
2007;201;12-15;11;16;27;SEC_201
2007;440;25-34;82;93;175;SEC_440
2007;319;16-17;12;5;17;SEC_319
2007;211;75 i +;89;40;129;SEC_211
2007;134;16-17;9;14;23;SEC_134
2007;428;25-34;65;98;163;SEC_428
2007;530;00-02;23;18;41;SEC_530
2007;117;50-64;227;233;460;SEC_117
2007;629;16-17;5;4;9;SEC_629
2007;305;65-74;54;54;108;SEC_305
2007;316;25-34;157;170;327;SEC_316
2007;233;35-49;106;119;225;SEC_233
2007;304;16-17;23;13;36;SEC_304
2007;432;75 i +;60;43;103;SEC_432
2007;442;25-34;39;61;100;SEC_442
2007;615;25-34;71;74;145;SEC_615
2007;538;03-11;50;57;107;SEC_538
2007;237;18-24;71;53;124;SEC_237
2007;317;12-15;14;24;38;SEC_317
2007;421;18-24;33;38;71;SEC_421
2007;214;03-11;33;26;59;SEC_214
2007;319;75 i +;42;26;68;SEC_319
2007;410;12-15;23;29;52;SEC_410
2007;514;25-34;61;96;157;SEC_514
2007;108;50-64;134;117;251;SEC_108
2007;324;00-02;21;14;35;SEC_324
2007;525;16-17;4;9;13;SEC_525
2007;222;35-49;97;125;222;SEC_222
2007;513;50-64;50;52;102;SEC_513
2007;248;75 i +;71;38;109;SEC_248
2007;419;25-34;79;108;187;SEC_419
2007;134;25-34;109;122;231;SEC_134
2007;516;16-17;6;9;15;SEC_516
2007;419;03-11;36;50;86;SEC_419
2007;505;65-74;81;105;186;SEC_505
2007;201;03-11;32;33;65;SEC_201
2007;217;00-02;10;13;23;SEC_217
2007;408;75 i +;44;29;73;SEC_408
2007;509;75 i +;32;17;49;SEC_509
2007;241;03-11;34;28;62;SEC_241
2007;615;16-17;4;6;10;SEC_615
2007;405;75 i +;64;44;108;SEC_405
2007;430;03-11;43;51;94;SEC_430
2007;436;75 i +;34;21;55;SEC_436
2007;236;00-02;12;15;27;SEC_236
2007;538;35-49;147;139;286;SEC_538
2007;403;03-11;27;22;49;SEC_403
2007;128;00-02;8;15;23;SEC_128
2007;214;16-17;5;6;11;SEC_214
2007;534;00-02;14;13;27;SEC_534
2007;136;00-02;23;17;40;SEC_136
2007;530;03-11;43;54;97;SEC_530
2007;433;75 i +;42;23;65;SEC_433
2007;201;65-74;53;42;95;SEC_201
2007;512;18-24;46;51;97;SEC_512
2007;306;16-17;18;20;38;SEC_306
2007;220;75 i +;60;35;95;SEC_220
2007;301;50-64;188;191;379;SEC_301
2007;433;18-24;82;61;143;SEC_433
2007;132;65-74;94;84;178;SEC_132
2007;320;75 i +;38;14;52;SEC_320
2007;305;18-24;81;78;159;SEC_305
2007;231;50-64;79;61;140;SEC_231
2007;211;65-74;61;41;102;SEC_211
2007;128;75 i +;54;34;88;SEC_128
2007;114;65-74;85;88;173;SEC_114
2007;132;16-17;16;19;35;SEC_132
2007;502;18-24;71;76;147;SEC_502
2007;136;12-15;20;19;39;SEC_136
2007;109;03-11;41;34;75;SEC_109
2007;228;18-24;37;38;75;SEC_228
2007;129;18-24;41;47;88;SEC_129
2007;324;03-11;52;54;106;SEC_324
2007;429;50-64;54;57;111;SEC_429
2007;240;50-64;52;35;87;SEC_240
2007;237;16-17;6;13;19;SEC_237
2007;415;50-64;54;47;101;SEC_415
2007;217;75 i +;45;27;72;SEC_217
2007;124;50-64;82;71;153;SEC_124
2007;630;65-74;36;43;79;SEC_630
2007;318;12-15;14;22;36;SEC_318
2007;245;00-02;9;17;26;SEC_245
2007;226;16-17;9;8;17;SEC_226
2007;305;16-17;17;12;29;SEC_305
2007;320;03-11;54;49;103;SEC_320
2007;128;65-74;45;49;94;SEC_128
2007;526;35-49;79;100;179;SEC_526
2007;517;16-17;11;18;29;SEC_517
2007;202;00-02;11;19;30;SEC_202
2007;106;50-64;257;244;501;SEC_106
2007;441;75 i +;89;65;154;SEC_441
2007;221;16-17;12;13;25;SEC_221
2007;618;12-15;9;11;20;SEC_618
2007;137;03-11;67;58;125;SEC_137
2007;228;35-49;76;108;184;SEC_228
2007;138;16-17;7;10;17;SEC_138
2007;624;18-24;36;30;66;SEC_624
2007;113;35-49;176;167;343;SEC_113
2007;205;00-02;6;10;16;SEC_205
2007;247;65-74;60;59;119;SEC_247
2007;630;16-17;8;7;15;SEC_630
2007;225;65-74;31;19;50;SEC_225
2007;525;35-49;98;126;224;SEC_525
2007;321;03-11;92;86;178;SEC_321
2007;610;35-49;132;131;263;SEC_610
2007;209;75 i +;86;54;140;SEC_209
2007;403;75 i +;69;39;108;SEC_403
2007;325;75 i +;176;89;265;SEC_325
2007;529;50-64;83;84;167;SEC_529
2007;516;75 i +;32;17;49;SEC_516
2007;614;50-64;110;97;207;SEC_614
2007;315;12-15;21;18;39;SEC_315
2007;125;00-02;31;30;61;SEC_125
2007;313;75 i +;74;53;127;SEC_313
2007;524;00-02;26;21;47;SEC_524
2007;232;18-24;41;41;82;SEC_232
2007;309;65-74;36;25;61;SEC_309
2007;138;03-11;34;18;52;SEC_138
2007;128;18-24;35;41;76;SEC_128
2007;219;00-02;20;18;38;SEC_219
2007;121;00-02;11;10;21;SEC_121
2007;107;65-74;99;85;184;SEC_107
2007;614;25-34;61;95;156;SEC_614
2007;437;50-64;67;53;120;SEC_437
2007;314;00-02;28;30;58;SEC_314
2007;205;65-74;57;50;107;SEC_205
2007;211;18-24;69;79;148;SEC_211
2007;121;03-11;28;38;66;SEC_121
2007;217;03-11;26;30;56;SEC_217
2007;525;18-24;44;47;91;SEC_525
2007;404;16-17;21;20;41;SEC_404
2007;616;65-74;70;66;136;SEC_616
2007;626;18-24;34;29;63;SEC_626
2007;207;03-11;23;28;51;SEC_207
2007;222;75 i +;40;20;60;SEC_222
2007;605;50-64;62;40;102;SEC_605
2007;138;25-34;76;59;135;SEC_138
2007;517;18-24;57;59;116;SEC_517
2007;311;12-15;14;25;39;SEC_311
2007;140;03-11;33;38;71;SEC_140
2007;430;25-34;116;144;260;SEC_430
2007;201;16-17;4;4;8;SEC_201
2007;230;18-24;48;43;91;SEC_230
2007;131;25-34;135;142;277;SEC_131
2007;228;75 i +;41;27;68;SEC_228
2007;222;03-11;44;31;75;SEC_222
2007;247;75 i +;77;42;119;SEC_247
2007;204;03-11;17;15;32;SEC_204
2007;507;65-74;44;38;82;SEC_507
2007;318;75 i +;29;14;43;SEC_318
2007;202;35-49;93;101;194;SEC_202
2007;307;50-64;217;186;403;SEC_307
2007;533;50-64;57;54;111;SEC_533
2007;233;25-34;91;101;192;SEC_233
2007;442;03-11;35;22;57;SEC_442
2007;424;03-11;21;31;52;SEC_424
2007;232;00-02;14;10;24;SEC_232
2007;414;65-74;48;48;96;SEC_414
2007;208;75 i +;141;88;229;SEC_208
2007;516;00-02;13;10;23;SEC_516
2007;212;18-24;60;76;136;SEC_212
2007;426;75 i +;55;33;88;SEC_426
2007;526;18-24;22;31;53;SEC_526
2007;602;00-02;7;6;13;SEC_602
2007;612;75 i +;46;25;71;SEC_612
2007;104;00-02;11;13;24;SEC_104
2007;230;35-49;112;153;265;SEC_230
2007;231;12-15;15;16;31;SEC_231
2007;107;75 i +;77;41;118;SEC_107
2007;240;03-11;28;34;62;SEC_240
2007;235;35-49;179;188;367;SEC_235
2007;533;00-02;20;18;38;SEC_533
2007;525;12-15;17;12;29;SEC_525
2007;618;03-11;29;37;66;SEC_618
2007;606;00-02;17;17;34;SEC_606
2007;611;65-74;112;115;227;SEC_611
2007;428;12-15;7;15;22;SEC_428
2007;533;03-11;37;41;78;SEC_533
2007;226;50-64;98;81;179;SEC_226
2007;412;25-34;139;193;332;SEC_412
2007;249;16-17;11;11;22;SEC_249
2007;301;16-17;16;29;45;SEC_301
2007;431;03-11;75;72;147;SEC_431
2007;140;00-02;7;17;24;SEC_140
2007;511;50-64;42;49;91;SEC_511
2007;511;35-49;84;81;165;SEC_511
2007;133;25-34;84;94;178;SEC_133
2007;425;03-11;30;43;73;SEC_425
2007;620;35-49;61;55;116;SEC_620
2007;616;25-34;212;201;413;SEC_616
2007;133;16-17;4;9;13;SEC_133
2007;123;75 i +;92;62;154;SEC_123
2007;613;12-15;14;18;32;SEC_613
2007;623;00-02;19;28;47;SEC_623
2007;240;16-17;9;7;16;SEC_240
2007;208;65-74;125;108;233;SEC_208
2007;536;00-02;11;11;22;SEC_536
2007;412;16-17;11;12;23;SEC_412
2007;135;03-11;57;53;110;SEC_135
2007;632;16-17;9;10;19;SEC_632
2007;420;25-34;155;170;325;SEC_420
2007;439;18-24;52;61;113;SEC_439
2007;209;16-17;9;14;23;SEC_209
2007;309;25-34;108;121;229;SEC_309
2007;128;16-17;10;14;24;SEC_128
2007;215;18-24;43;28;71;SEC_215
2007;221;35-49;123;133;256;SEC_221
2007;419;12-15;19;20;39;SEC_419
2007;432;65-74;80;62;142;SEC_432
2007;122;75 i +;47;33;80;SEC_122
2007;505;00-02;9;17;26;SEC_505
2007;613;35-49;120;134;254;SEC_613
2007;416;00-02;9;13;22;SEC_416
2007;428;00-02;19;8;27;SEC_428
2007;421;03-11;40;32;72;SEC_421
2007;438;35-49;98;111;209;SEC_438
2007;628;00-02;14;10;24;SEC_628
2007;625;75 i +;38;18;56;SEC_625
2007;219;65-74;62;48;110;SEC_219
2007;229;00-02;9;7;16;SEC_229
2007;213;12-15;13;18;31;SEC_213
2007;123;18-24;42;40;82;SEC_123
2007;126;25-34;89;86;175;SEC_126
2007;138;50-64;99;92;191;SEC_138
2007;121;75 i +;79;45;124;SEC_121
2007;535;50-64;135;122;257;SEC_535
2007;609;50-64;115;86;201;SEC_609
2007;414;16-17;7;2;9;SEC_414
2007;507;50-64;85;74;159;SEC_507
2007;407;50-64;81;67;148;SEC_407
2007;116;65-74;76;80;156;SEC_116
2007;513;12-15;8;8;16;SEC_513
2007;505;25-34;109;108;217;SEC_505
2007;229;35-49;97;113;210;SEC_229
2007;137;35-49;176;148;324;SEC_137
2007;622;75 i +;45;9;54;SEC_622
2007;439;25-34;120;146;266;SEC_439
2007;205;12-15;14;14;28;SEC_205
2007;137;00-02;27;18;45;SEC_137
2007;210;03-11;27;28;55;SEC_210
2007;514;16-17;9;4;13;SEC_514
2007;619;50-64;153;130;283;SEC_619
2007;108;12-15;17;25;42;SEC_108
2007;217;65-74;23;18;41;SEC_217
2007;521;12-15;9;9;18;SEC_521
2007;526;12-15;18;18;36;SEC_526
2007;248;18-24;52;44;96;SEC_248
2007;413;00-02;6;9;15;SEC_413
2007;411;35-49;103;119;222;SEC_411
2007;431;35-49;166;206;372;SEC_431
2007;414;25-34;94;90;184;SEC_414
2007;229;25-34;78;77;155;SEC_229
2007;109;16-17;9;7;16;SEC_109
2007;435;75 i +;104;45;149;SEC_435
2007;535;25-34;73;65;138;SEC_535
2007;235;25-34;157;195;352;SEC_235
2007;610;25-34;82;94;176;SEC_610
2007;208;25-34;143;131;274;SEC_208
2007;514;12-15;18;12;30;SEC_514
2007;107;12-15;12;21;33;SEC_107
2007;413;75 i +;46;30;76;SEC_413
2007;610;65-74;80;103;183;SEC_610
2007;416;35-49;91;97;188;SEC_416
2007;624;50-64;158;122;280;SEC_624
2007;315;75 i +;67;27;94;SEC_315
2007;627;50-64;169;162;331;SEC_627
2007;401;65-74;68;50;118;SEC_401
2007;224;50-64;39;47;86;SEC_224
2007;216;16-17;5;10;15;SEC_216
2007;508;16-17;4;5;9;SEC_508
2007;605;75 i +;37;29;66;SEC_605
2007;615;75 i +;34;19;53;SEC_615
2007;304;12-15;35;22;57;SEC_304
2007;310;65-74;45;27;72;SEC_310
2007;408;18-24;39;46;85;SEC_408
2007;108;00-02;11;19;30;SEC_108
2007;437;18-24;47;44;91;SEC_437
2007;206;16-17;9;5;14;SEC_206
2007;138;65-74;36;38;74;SEC_138
2007;126;03-11;40;36;76;SEC_126
2007;419;35-49;112;142;254;SEC_419
2007;610;03-11;44;49;93;SEC_610
2007;405;50-64;64;58;122;SEC_405
2007;525;00-02;22;14;36;SEC_525
2007;135;00-02;21;23;44;SEC_135
2007;617;03-11;31;49;80;SEC_617
2007;607;50-64;96;58;154;SEC_607
2007;413;25-34;52;60;112;SEC_413
2007;223;18-24;46;43;89;SEC_223
2007;435;18-24;61;76;137;SEC_435
2007;613;03-11;45;37;82;SEC_613
2007;523;25-34;126;164;290;SEC_523
2007;405;00-02;10;14;24;SEC_405
2007;202;12-15;12;16;28;SEC_202
2007;129;03-11;46;55;101;SEC_129
2007;406;16-17;18;13;31;SEC_406
2007;231;65-74;59;45;104;SEC_231
2007;203;03-11;30;41;71;SEC_203
2007;235;65-74;76;63;139;SEC_235
2007;502;00-02;16;18;34;SEC_502
2007;322;75 i +;50;38;88;SEC_322
2007;243;12-15;25;25;50;SEC_243
2007;135;25-34;126;143;269;SEC_135
2007;243;65-74;87;69;156;SEC_243
2007;111;75 i +;45;40;85;SEC_111
2007;139;50-64;86;87;173;SEC_139
2007;516;25-34;65;94;159;SEC_516
2007;617;75 i +;40;27;67;SEC_617
2007;236;03-11;35;30;65;SEC_236
2007;628;35-49;109;95;204;SEC_628
2007;426;12-15;20;24;44;SEC_426
2007;212;35-49;182;184;366;SEC_212
2007;101;12-15;29;34;63;SEC_101
2007;529;65-74;74;69;143;SEC_529
2007;114;18-24;47;42;89;SEC_114
2007;507;75 i +;36;18;54;SEC_507
2007;109;75 i +;69;34;103;SEC_109
2007;604;25-34;38;72;110;SEC_604
2007;103;03-11;24;32;56;SEC_103
2007;235;18-24;52;70;122;SEC_235
2007;427;03-11;36;53;89;SEC_427
2007;440;75 i +;56;43;99;SEC_440
2007;442;65-74;28;22;50;SEC_442
2007;437;03-11;36;29;65;SEC_437
2007;532;65-74;73;70;143;SEC_532
2007;402;65-74;50;46;96;SEC_402
2007;416;75 i +;54;36;90;SEC_416
2007;434;00-02;11;10;21;SEC_434
2007;521;18-24;41;25;66;SEC_521
2007;129;25-34;119;109;228;SEC_129
2007;107;18-24;76;71;147;SEC_107
2007;624;16-17;7;5;12;SEC_624
2007;114;03-11;58;59;117;SEC_114
2007;246;12-15;22;9;31;SEC_246
2007;632;03-11;49;43;92;SEC_632
2007;131;03-11;38;46;84;SEC_131
2007;527;25-34;131;130;261;SEC_527
2007;205;18-24;52;49;101;SEC_205
2007;221;00-02;13;9;22;SEC_221
2007;233;16-17;8;7;15;SEC_233
2007;133;35-49;92;103;195;SEC_133
2007;322;35-49;136;146;282;SEC_322
2007;401;25-34;95;75;170;SEC_401
2007;440;18-24;33;26;59;SEC_440
2007;111;12-15;12;11;23;SEC_111
2007;229;65-74;43;32;75;SEC_229
2007;223;65-74;62;48;110;SEC_223
2007;412;00-02;20;12;32;SEC_412
2007;440;50-64;109;91;200;SEC_440
2007;517;00-02;22;19;41;SEC_517
2007;311;50-64;123;91;214;SEC_311
2007;424;35-49;62;76;138;SEC_424
2007;535;18-24;47;51;98;SEC_535
2007;432;25-34;110;129;239;SEC_432
2007;508;65-74;42;26;68;SEC_508
2007;626;25-34;73;69;142;SEC_626
2007;532;12-15;23;17;40;SEC_532
2007;303;25-34;154;162;316;SEC_303
2007;622;12-15;11;18;29;SEC_622
2007;524;65-74;74;52;126;SEC_524
2007;503;00-02;7;5;12;SEC_503
2007;220;65-74;50;32;82;SEC_220
2007;440;12-15;18;11;29;SEC_440
2007;536;12-15;17;15;32;SEC_536
2007;417;25-34;73;66;139;SEC_417
2007;432;50-64;155;151;306;SEC_432
2007;323;00-02;44;47;91;SEC_323
2007;132;12-15;35;47;82;SEC_132
2007;214;35-49;95;123;218;SEC_214
2007;126;12-15;11;6;17;SEC_126
2007;520;12-15;16;16;32;SEC_520
2007;528;35-49;153;151;304;SEC_528
2007;533;35-49;121;157;278;SEC_533
2007;428;35-49;87;104;191;SEC_428
2007;130;03-11;47;40;87;SEC_130
2007;436;65-74;32;23;55;SEC_436
2007;115;18-24;39;51;90;SEC_115
2007;502;16-17;14;8;22;SEC_502
2007;234;12-15;19;17;36;SEC_234
2007;304;03-11;67;71;138;SEC_304
2007;603;75 i +;21;17;38;SEC_603
2007;402;12-15;15;8;23;SEC_402
2007;224;03-11;19;20;39;SEC_224
2007;533;18-24;62;54;116;SEC_533
2007;242;75 i +;82;49;131;SEC_242
2007;313;16-17;13;18;31;SEC_313
2007;526;16-17;3;10;13;SEC_526
2007;110;03-11;27;33;60;SEC_110
2007;533;25-34;120;157;277;SEC_533
2007;314;50-64;233;247;480;SEC_314
2007;229;12-15;17;15;32;SEC_229
2007;132;18-24;90;92;182;SEC_132
2007;229;16-17;9;8;17;SEC_229
2007;440;16-17;5;7;12;SEC_440
2007;402;50-64;67;64;131;SEC_402
2007;128;25-34;93;100;193;SEC_128
2007;237;00-02;24;22;46;SEC_237
2007;117;16-17;22;15;37;SEC_117
2007;123;16-17;17;13;30;SEC_123
2007;236;16-17;11;11;22;SEC_236
2007;514;03-11;44;41;85;SEC_514
2007;227;75 i +;55;36;91;SEC_227
2007;530;75 i +;99;54;153;SEC_530
2007;614;12-15;11;19;30;SEC_614
2007;207;65-74;42;32;74;SEC_207
2007;442;00-02;6;9;15;SEC_442
2007;127;50-64;69;67;136;SEC_127
2007;627;00-02;8;8;16;SEC_627
2007;312;18-24;75;61;136;SEC_312
2007;406;65-74;77;62;139;SEC_406
2007;607;65-74;104;103;207;SEC_607
2007;135;65-74;72;64;136;SEC_135
2007;106;65-74;59;46;105;SEC_106
2007;134;18-24;57;57;114;SEC_134
2007;503;25-34;78;85;163;SEC_503
2007;240;75 i +;58;30;88;SEC_240
2007;205;35-49;97;99;196;SEC_205
2007;223;12-15;32;26;58;SEC_223
2007;626;00-02;9;14;23;SEC_626
2007;433;12-15;26;19;45;SEC_433
2007;214;65-74;40;33;73;SEC_214
2007;217;18-24;27;35;62;SEC_217
2007;134;35-49;152;152;304;SEC_134
2007;404;75 i +;73;39;112;SEC_404
2007;421;16-17;12;11;23;SEC_421
2007;204;25-34;58;73;131;SEC_204
2007;320;18-24;31;29;60;SEC_320
2007;218;12-15;16;10;26;SEC_218
2007;317;75 i +;67;24;91;SEC_317
2007;322;03-11;46;55;101;SEC_322
2007;126;65-74;67;79;146;SEC_126
2007;409;00-02;12;14;26;SEC_409
2007;405;35-49;76;101;177;SEC_405
2007;537;75 i +;74;42;116;SEC_537
2007;623;65-74;74;80;154;SEC_623
2007;102;50-64;186;160;346;SEC_102
2007;222;12-15;15;18;33;SEC_222
2007;245;50-64;82;70;152;SEC_245
2007;632;50-64;89;73;162;SEC_632
2007;311;35-49;148;175;323;SEC_311
2007;625;12-15;14;23;37;SEC_625
2007;310;00-02;18;15;33;SEC_310
2007;621;03-11;48;66;114;SEC_621
2007;502;12-15;21;22;43;SEC_502
2007;248;50-64;87;86;173;SEC_248
2007;323;03-11;145;125;270;SEC_323
2007;413;12-15;19;13;32;SEC_413
2007;313;03-11;80;88;168;SEC_313
2007;215;35-49;129;129;258;SEC_215
2007;325;12-15;34;27;61;SEC_325
2007;107;50-64;172;148;320;SEC_107
2007;216;00-02;21;11;32;SEC_216
2007;202;75 i +;36;31;67;SEC_202
2007;435;25-34;115;147;262;SEC_435
2007;630;12-15;6;9;15;SEC_630
2007;107;03-11;64;72;136;SEC_107
2007;512;16-17;9;8;17;SEC_512
2007;606;18-24;41;51;92;SEC_606
2007;306;18-24;62;64;126;SEC_306
2007;117;00-02;23;23;46;SEC_117
2007;406;25-34;117;144;261;SEC_406
2007;517;35-49;151;181;332;SEC_517
2007;215;12-15;19;12;31;SEC_215
2007;505;50-64;186;132;318;SEC_505
2007;135;75 i +;64;38;102;SEC_135
2007;628;65-74;53;65;118;SEC_628
2007;508;25-34;84;69;153;SEC_508
2007;407;18-24;35;42;77;SEC_407
2007;136;03-11;40;46;86;SEC_136
2007;207;75 i +;61;26;87;SEC_207
2007;319;50-64;148;129;277;SEC_319
2007;103;35-49;82;81;163;SEC_103
2007;235;00-02;32;25;57;SEC_235
2007;133;50-64;99;83;182;SEC_133
2007;309;03-11;33;56;89;SEC_309
2007;214;50-64;51;39;90;SEC_214
2007;127;12-15;10;12;22;SEC_127
2007;214;18-24;40;43;83;SEC_214
2007;214;12-15;16;11;27;SEC_214
2007;616;50-64;241;234;475;SEC_616
2007;442;12-15;11;12;23;SEC_442
2007;612;00-02;18;16;34;SEC_612
2007;119;25-34;97;116;213;SEC_119
2007;112;00-02;23;27;50;SEC_112
2007;406;50-64;135;115;250;SEC_406
2007;621;75 i +;44;23;67;SEC_621
2007;524;50-64;97;85;182;SEC_524
2007;111;18-24;40;35;75;SEC_111
2007;219;35-49;161;165;326;SEC_219
2007;110;18-24;62;45;107;SEC_110
2007;428;16-17;5;5;10;SEC_428
2007;218;75 i +;39;19;58;SEC_218
2007;106;75 i +;64;33;97;SEC_106
2007;519;25-34;87;97;184;SEC_519
2007;206;18-24;42;37;79;SEC_206
2007;221;12-15;28;20;48;SEC_221
2007;218;50-64;79;61;140;SEC_218
2007;245;65-74;53;44;97;SEC_245
2007;207;18-24;30;30;60;SEC_207
2007;417;03-11;14;27;41;SEC_417
2007;617;25-34;82;90;172;SEC_617
2007;405;03-11;33;37;70;SEC_405
2007;132;35-49;222;242;464;SEC_132
2007;314;12-15;38;56;94;SEC_314
2007;140;18-24;33;48;81;SEC_140
2007;601;12-15;26;20;46;SEC_601
2007;301;12-15;45;41;86;SEC_301
2007;427;00-02;24;20;44;SEC_427
2007;434;50-64;46;52;98;SEC_434
2007;233;18-24;44;44;88;SEC_233
2007;515;35-49;78;99;177;SEC_515
2007;243;03-11;48;63;111;SEC_243
2007;623;12-15;17;25;42;SEC_623
2007;231;16-17;6;6;12;SEC_231
2007;607;00-02;15;17;32;SEC_607
2007;529;18-24;56;47;103;SEC_529
2007;321;00-02;29;27;56;SEC_321
2007;401;16-17;13;15;28;SEC_401
2007;619;00-02;16;14;30;SEC_619
2007;105;16-17;16;24;40;SEC_105
2007;136;16-17;7;9;16;SEC_136
2007;226;35-49;135;147;282;SEC_226
2007;513;75 i +;42;23;65;SEC_513
2007;427;25-34;108;116;224;SEC_427
2007;604;03-11;23;35;58;SEC_604
2007;324;25-34;106;116;222;SEC_324
2007;514;35-49;87;111;198;SEC_514
2007;249;12-15;15;19;34;SEC_249
2007;236;18-24;58;50;108;SEC_236
2007;229;75 i +;60;36;96;SEC_229
2007;527;65-74;51;35;86;SEC_527
2007;206;12-15;14;16;30;SEC_206
2007;126;35-49;84;89;173;SEC_126
2007;423;00-02;16;21;37;SEC_423
2007;431;18-24;67;82;149;SEC_431
2007;237;35-49;175;205;380;SEC_237
2007;439;12-15;17;19;36;SEC_439
2007;225;50-64;48;34;82;SEC_225
2007;410;18-24;49;60;109;SEC_410
2007;517;03-11;53;69;122;SEC_517
2007;225;12-15;6;6;12;SEC_225
2007;115;12-15;21;29;50;SEC_115
2007;631;12-15;15;17;32;SEC_631
2007;525;03-11;34;31;65;SEC_525
2007;624;35-49;86;126;212;SEC_624
2007;605;25-34;50;63;113;SEC_605
2007;516;65-74;42;30;72;SEC_516
2007;519;18-24;38;34;72;SEC_519
2007;118;35-49;193;161;354;SEC_118
2007;608;65-74;71;46;117;SEC_608
2007;116;03-11;57;65;122;SEC_116
2007;218;65-74;34;28;62;SEC_218
2007;107;25-34;159;182;341;SEC_107
2007;246;25-34;130;151;281;SEC_246
2007;438;03-11;26;28;54;SEC_438
2007;531;75 i +;42;29;71;SEC_531
2007;140;16-17;4;5;9;SEC_140
2007;423;18-24;44;44;88;SEC_423
2007;129;00-02;17;13;30;SEC_129
2007;244;50-64;52;42;94;SEC_244
2007;323;50-64;362;361;723;SEC_323
2007;140;12-15;6;20;26;SEC_140
2007;306;35-49;183;196;379;SEC_306
2007;314;18-24;112;128;240;SEC_314
2007;211;35-49;184;248;432;SEC_211
2007;230;12-15;15;22;37;SEC_230
2007;230;00-02;17;15;32;SEC_230
2007;515;16-17;9;8;17;SEC_515
2007;119;03-11;29;40;69;SEC_119
2007;211;12-15;21;29;50;SEC_211
2007;520;16-17;7;12;19;SEC_520
2007;138;35-49;83;75;158;SEC_138
2007;429;00-02;9;5;14;SEC_429
2007;113;18-24;91;84;175;SEC_113
2007;321;18-24;94;92;186;SEC_321
2007;518;75 i +;56;37;93;SEC_518
2007;427;16-17;6;12;18;SEC_427
2007;435;12-15;9;15;24;SEC_435
2007;407;12-15;11;11;22;SEC_407
2007;212;12-15;20;35;55;SEC_212
2007;511;12-15;13;17;30;SEC_511
2007;240;18-24;25;21;46;SEC_240
2007;121;35-49;102;113;215;SEC_121
2007;611;03-11;66;77;143;SEC_611
2007;423;65-74;60;67;127;SEC_423
2007;211;03-11;51;57;108;SEC_211
2007;317;16-17;8;9;17;SEC_317
2007;536;16-17;8;4;12;SEC_536
2007;404;18-24;71;61;132;SEC_404
2007;617;12-15;16;19;35;SEC_617
2007;604;75 i +;26;15;41;SEC_604
2007;316;16-17;27;20;47;SEC_316
2007;218;25-34;89;112;201;SEC_218
2007;103;16-17;8;1;9;SEC_103
2007;302;50-64;178;163;341;SEC_302
2007;120;50-64;168;174;342;SEC_120
2007;207;35-49;76;76;152;SEC_207
2007;116;18-24;54;53;107;SEC_116
2007;506;18-24;63;79;142;SEC_506
2007;311;03-11;53;56;109;SEC_311
2007;221;03-11;40;36;76;SEC_221
2007;609;00-02;20;14;34;SEC_609
2007;216;25-34;111;116;227;SEC_216
2007;103;18-24;20;30;50;SEC_103
2007;509;12-15;11;18;29;SEC_509
2007;132;50-64;221;212;433;SEC_132
2007;538;25-34;107;127;234;SEC_538
2007;408;35-49;93;118;211;SEC_408
2007;307;03-11;32;41;73;SEC_307
2007;317;00-02;22;24;46;SEC_317
2007;412;50-64;188;163;351;SEC_412
2007;302;16-17;9;6;15;SEC_302
2007;208;03-11;42;45;87;SEC_208
2007;430;12-15;16;17;33;SEC_430
2007;625;16-17;15;18;33;SEC_625
2007;119;18-24;53;45;98;SEC_119
2007;123;35-49;164;164;328;SEC_123
2007;242;35-49;129;131;260;SEC_242
2007;138;12-15;12;10;22;SEC_138
2007;631;75 i +;50;24;74;SEC_631
2007;516;35-49;96;113;209;SEC_516
2007;611;18-24;62;55;117;SEC_611
2007;606;16-17;11;14;25;SEC_606
2007;321;35-49;266;252;518;SEC_321
2007;316;50-64;342;346;688;SEC_316
2007;231;00-02;13;16;29;SEC_231
2007;523;00-02;19;19;38;SEC_523
2007;423;12-15;12;11;23;SEC_423
2007;632;00-02;21;19;40;SEC_632
2007;403;12-15;12;13;25;SEC_403
2007;506;12-15;26;36;62;SEC_506
2007;431;50-64;101;104;205;SEC_431
2007;441;03-11;72;69;141;SEC_441
2007;210;12-15;15;6;21;SEC_210
2007;303;16-17;9;7;16;SEC_303
2007;502;75 i +;129;69;198;SEC_502
2007;526;25-34;69;69;138;SEC_526
2007;130;18-24;27;23;50;SEC_130
2007;426;25-34;105;141;246;SEC_426
2007;106;16-17;10;15;25;SEC_106
2007;112;65-74;63;46;109;SEC_112
2007;234;65-74;54;33;87;SEC_234
2007;404;65-74;79;68;147;SEC_404
2007;440;03-11;36;35;71;SEC_440
2007;231;25-34;108;129;237;SEC_231
2007;519;50-64;42;36;78;SEC_519
2007;441;16-17;19;27;46;SEC_441
2007;243;50-64;112;104;216;SEC_243
2007;405;25-34;88;86;174;SEC_405
2007;247;16-17;14;17;31;SEC_247
2007;317;25-34;121;139;260;SEC_317
2007;411;25-34;78;93;171;SEC_411
2007;502;65-74;76;74;150;SEC_502
2007;121;25-34;79;85;164;SEC_121
2007;127;03-11;27;27;54;SEC_127
2007;125;16-17;17;10;27;SEC_125
2007;423;35-49;108;111;219;SEC_423
2007;112;25-34;155;145;300;SEC_112
2007;302;18-24;55;50;105;SEC_302
2007;414;12-15;24;16;40;SEC_414
2007;512;35-49;108;106;214;SEC_512
2007;215;50-64;83;67;150;SEC_215
2007;630;35-49;74;96;170;SEC_630
2007;532;25-34;166;159;325;SEC_532
2007;238;25-34;82;104;186;SEC_238
2007;112;12-15;36;30;66;SEC_112
2007;219;18-24;49;54;103;SEC_219
2007;520;35-49;93;98;191;SEC_520
2007;427;50-64;70;56;126;SEC_427
2007;325;18-24;56;56;112;SEC_325
2007;520;75 i +;54;36;90;SEC_520
2007;504;12-15;10;11;21;SEC_504
2007;415;03-11;30;36;66;SEC_415
2007;208;12-15;21;28;49;SEC_208
2007;138;18-24;29;50;79;SEC_138
2007;507;00-02;18;10;28;SEC_507
2007;109;50-64;123;134;257;SEC_109
2007;232;25-34;94;108;202;SEC_232
2007;133;00-02;16;10;26;SEC_133
2007;629;03-11;23;14;37;SEC_629
2007;504;00-02;15;13;28;SEC_504
2007;224;16-17;2;6;8;SEC_224
2007;433;65-74;45;33;78;SEC_433
2007;313;50-64;216;184;400;SEC_313
2007;523;03-11;54;47;101;SEC_523
2007;619;65-74;104;90;194;SEC_619
2007;505;18-24;33;25;58;SEC_505
2007;401;03-11;56;62;118;SEC_401
2007;420;03-11;59;64;123;SEC_420
2007;424;25-34;62;77;139;SEC_424
2007;412;18-24;73;78;151;SEC_412
2007;620;50-64;74;64;138;SEC_620
2007;428;50-64;45;35;80;SEC_428
2007;621;65-74;48;60;108;SEC_621
2007;102;25-34;113;106;219;SEC_102
2007;114;35-49;167;166;333;SEC_114
2007;538;65-74;80;61;141;SEC_538
2007;426;65-74;42;39;81;SEC_426
2007;604;50-64;66;54;120;SEC_604
2007;605;65-74;66;61;127;SEC_605
2007;114;12-15;21;21;42;SEC_114
2007;241;16-17;14;7;21;SEC_241
2007;306;12-15;30;24;54;SEC_306
2007;131;35-49;138;170;308;SEC_131
2007;606;75 i +;68;40;108;SEC_606
2007;212;75 i +;69;42;111;SEC_212
2007;418;75 i +;60;38;98;SEC_418
2007;226;00-02;11;6;17;SEC_226
2007;617;35-49;97;106;203;SEC_617
2007;228;03-11;11;20;31;SEC_228
2007;611;50-64;148;111;259;SEC_611
2007;424;18-24;24;31;55;SEC_424
2007;305;00-02;26;11;37;SEC_305
2007;504;16-17;8;8;16;SEC_504
2007;506;25-34;139;143;282;SEC_506
2007;521;50-64;158;134;292;SEC_521
2007;632;18-24;34;48;82;SEC_632
2007;115;03-11;42;46;88;SEC_115
2007;420;18-24;58;74;132;SEC_420
2007;410;16-17;15;9;24;SEC_410
2007;413;65-74;30;25;55;SEC_413
2007;208;18-24;55;66;121;SEC_208
2007;427;35-49;115;125;240;SEC_427
2007;408;50-64;83;71;154;SEC_408
2007;116;00-02;24;15;39;SEC_116
2007;248;00-02;18;15;33;SEC_248
2007;248;16-17;15;9;24;SEC_248
2007;536;75 i +;66;50;116;SEC_536
2007;117;12-15;37;32;69;SEC_117
2007;228;12-15;25;14;39;SEC_228
2007;507;12-15;10;12;22;SEC_507
2007;116;25-34;120;142;262;SEC_116
2007;323;25-34;247;278;525;SEC_323
2007;308;00-02;31;36;67;SEC_308
2007;403;18-24;64;57;121;SEC_403
2007;135;16-17;15;10;25;SEC_135
2007;524;35-49;154;155;309;SEC_524
2007;514;75 i +;29;20;49;SEC_514
2007;511;18-24;22;23;45;SEC_511
2007;316;03-11;42;58;100;SEC_316
2007;628;18-24;33;41;74;SEC_628
2007;620;16-17;4;8;12;SEC_620
2007;244;03-11;21;22;43;SEC_244
2007;612;25-34;87;103;190;SEC_612
2007;616;12-15;66;67;133;SEC_616
2007;629;50-64;54;45;99;SEC_629
2007;627;65-74;39;43;82;SEC_627
2007;109;35-49;122;109;231;SEC_109
2007;621;35-49;137;144;281;SEC_621
2007;222;18-24;47;33;80;SEC_222
2007;430;00-02;19;22;41;SEC_430
2007;415;16-17;5;12;17;SEC_415
2007;427;12-15;18;22;40;SEC_427
2007;134;65-74;56;41;97;SEC_134
2007;429;12-15;11;11;22;SEC_429
2007;508;03-11;21;20;41;SEC_508
2007;244;00-02;9;9;18;SEC_244
2007;417;75 i +;30;19;49;SEC_417
2007;121;18-24;15;25;40;SEC_121
2007;431;75 i +;84;46;130;SEC_431
2007;614;16-17;9;6;15;SEC_614
2007;310;18-24;44;40;84;SEC_310
2007;112;75 i +;70;37;107;SEC_112
2007;413;50-64;40;37;77;SEC_413
2007;139;75 i +;40;22;62;SEC_139
2007;615;50-64;133;79;212;SEC_615
2007;538;18-24;54;59;113;SEC_538
2007;528;75 i +;59;42;101;SEC_528
2007;203;12-15;7;14;21;SEC_203
2007;512;75 i +;49;21;70;SEC_512
2007;105;50-64;138;112;250;SEC_105
2007;123;03-11;46;50;96;SEC_123
2007;101;16-17;8;15;23;SEC_101
2007;122;50-64;85;54;139;SEC_122
2007;602;35-49;62;67;129;SEC_602
2007;417;12-15;7;11;18;SEC_417
2007;305;25-34;112;125;237;SEC_305
2007;139;16-17;6;5;11;SEC_139
2007;511;25-34;61;74;135;SEC_511
2007;627;25-34;89;78;167;SEC_627
2007;508;00-02;9;13;22;SEC_508
2007;118;16-17;16;10;26;SEC_118
2007;220;18-24;36;35;71;SEC_220
2007;519;12-15;8;17;25;SEC_519
2007;518;65-74;78;65;143;SEC_518
2007;302;12-15;22;29;51;SEC_302
2007;617;50-64;87;79;166;SEC_617
2007;201;25-34;59;82;141;SEC_201
2007;124;16-17;9;9;18;SEC_124
2007;218;18-24;29;45;74;SEC_218
2007;406;18-24;73;64;137;SEC_406
2007;421;35-49;133;155;288;SEC_421
2007;625;03-11;35;44;79;SEC_625
2007;623;03-11;58;58;116;SEC_623
2007;140;50-64;87;90;177;SEC_140
2007;403;65-74;83;91;174;SEC_403
2007;512;50-64;64;70;134;SEC_512
2007;233;03-11;26;36;62;SEC_233
2007;603;35-49;60;72;132;SEC_603
2007;246;75 i +;77;50;127;SEC_246
2007;612;16-17;10;7;17;SEC_612
2007;627;12-15;6;17;23;SEC_627
2007;531;03-11;38;35;73;SEC_531
2007;630;18-24;36;34;70;SEC_630
2007;117;65-74;72;60;132;SEC_117
2007;305;12-15;38;18;56;SEC_305
2007;214;00-02;14;9;23;SEC_214
2007;536;35-49;99;107;206;SEC_536
2007;518;12-15;18;23;41;SEC_518
2007;528;16-17;9;7;16;SEC_528
2007;414;18-24;33;32;65;SEC_414
2007;227;35-49;77;80;157;SEC_227
2007;632;65-74;59;52;111;SEC_632
2007;118;50-64;212;205;417;SEC_118
2007;125;12-15;19;18;37;SEC_125
2007;513;65-74;60;43;103;SEC_513
2007;536;18-24;26;25;51;SEC_536
2007;222;00-02;15;15;30;SEC_222
2007;628;16-17;12;7;19;SEC_628
2007;229;18-24;28;31;59;SEC_229
2007;618;25-34;41;39;80;SEC_618
2007;102;75 i +;91;49;140;SEC_102
2007;509;18-24;40;36;76;SEC_509
2007;618;75 i +;25;15;40;SEC_618
2007;308;18-24;68;76;144;SEC_308
2007;631;03-11;32;37;69;SEC_631
2007;612;65-74;87;77;164;SEC_612
2007;320;00-02;19;21;40;SEC_320
2007;417;50-64;56;58;114;SEC_417
2007;128;35-49;122;119;241;SEC_128
2007;602;03-11;19;20;39;SEC_602
2007;530;65-74;77;83;160;SEC_530
2007;120;18-24;81;77;158;SEC_120
2007;516;18-24;30;34;64;SEC_516
2007;613;25-34;93;116;209;SEC_613
2007;601;65-74;83;94;177;SEC_601
2007;406;75 i +;55;53;108;SEC_406
2007;620;18-24;25;27;52;SEC_620
2007;210;35-49;91;84;175;SEC_210
2007;313;18-24;92;76;168;SEC_313
2007;618;18-24;19;19;38;SEC_618
2007;226;65-74;49;40;89;SEC_226
2007;521;00-02;10;10;20;SEC_521
2007;531;65-74;55;49;104;SEC_531
2007;620;00-02;4;6;10;SEC_620
2007;623;25-34;118;147;265;SEC_623
2007;511;03-11;35;25;60;SEC_511
2007;536;50-64;75;63;138;SEC_536
2007;615;03-11;35;22;57;SEC_615
2007;408;03-11;28;39;67;SEC_408
2007;230;50-64;40;38;78;SEC_230
2007;119;75 i +;77;52;129;SEC_119
2007;625;50-64;197;175;372;SEC_625
2007;223;16-17;11;18;29;SEC_223
2007;440;00-02;7;13;20;SEC_440
2007;538;00-02;18;25;43;SEC_538
2007;120;03-11;64;79;143;SEC_120
2007;312;50-64;174;150;324;SEC_312
2007;215;16-17;9;12;21;SEC_215
2007;301;35-49;306;295;601;SEC_301
2007;522;75 i +;40;22;62;SEC_522
2007;203;35-49;107;105;212;SEC_203
2007;227;25-34;67;65;132;SEC_227
2007;616;35-49;303;310;613;SEC_616
2007;503;65-74;36;30;66;SEC_503
2007;441;50-64;237;233;470;SEC_441
2007;523;35-49;169;176;345;SEC_523
2007;430;65-74;48;42;90;SEC_430
2007;131;00-02;13;24;37;SEC_131
2007;406;03-11;42;62;104;SEC_406
2007;437;12-15;14;19;33;SEC_437
2007;312;16-17;15;11;26;SEC_312
2007;537;18-24;50;47;97;SEC_537
2007;409;18-24;32;42;74;SEC_409
2007;611;25-34;186;189;375;SEC_611
2007;242;65-74;70;57;127;SEC_242
2007;307;00-02;13;12;25;SEC_307
2007;209;12-15;11;10;21;SEC_209
2007;619;75 i +;61;45;106;SEC_619
2007;216;03-11;62;37;99;SEC_216
2007;308;03-11;92;115;207;SEC_308
2007;537;25-34;97;127;224;SEC_537
2007;521;75 i +;48;32;80;SEC_521
2007;242;16-17;9;11;20;SEC_242
2007;611;16-17;18;16;34;SEC_611
2007;510;16-17;7;6;13;SEC_510
2007;228;65-74;46;38;84;SEC_228
2007;206;00-02;9;12;21;SEC_206
2007;625;18-24;63;81;144;SEC_625
2007;629;75 i +;33;15;48;SEC_629
2007;107;35-49;183;198;381;SEC_107
2007;615;35-49;71;83;154;SEC_615
2007;418;16-17;10;13;23;SEC_418
2007;242;25-34;97;112;209;SEC_242
2007;102;35-49;163;189;352;SEC_102
2007;626;12-15;8;12;20;SEC_626
2007;320;50-64;101;101;202;SEC_320
2007;313;35-49;221;212;433;SEC_313
2007;438;65-74;63;54;117;SEC_438
2007;512;03-11;23;36;59;SEC_512
2007;321;16-17;22;28;50;SEC_321
2007;110;35-49;106;107;213;SEC_110
2007;613;00-02;17;25;42;SEC_613
2007;244;75 i +;58;33;91;SEC_244
2007;137;18-24;66;52;118;SEC_137
2007;244;65-74;28;20;48;SEC_244
2007;526;50-64;61;51;112;SEC_526
2007;504;25-34;98;108;206;SEC_504
2007;303;65-74;132;125;257;SEC_303
2007;416;50-64;51;51;102;SEC_416
2007;116;35-49;154;157;311;SEC_116
2007;605;16-17;2;3;5;SEC_605
2007;411;00-02;12;8;20;SEC_411
2007;433;35-49;135;172;307;SEC_433
2007;239;03-11;44;43;87;SEC_239
2007;609;25-34;73;73;146;SEC_609
2007;626;03-11;42;45;87;SEC_626
2007;117;03-11;79;78;157;SEC_117
2007;409;03-11;25;23;48;SEC_409
2007;319;35-49;213;226;439;SEC_319
2007;120;12-15;42;33;75;SEC_120
2007;226;03-11;40;39;79;SEC_226
2007;606;25-34;111;117;228;SEC_606
2007;249;75 i +;74;50;124;SEC_249
2007;407;16-17;8;10;18;SEC_407
2007;402;03-11;35;36;71;SEC_402
2007;109;18-24;46;39;85;SEC_109
2007;423;16-17;4;9;13;SEC_423
2007;513;25-34;69;74;143;SEC_513
2007;526;00-02;16;9;25;SEC_526
2007;512;25-34;94;103;197;SEC_512
2007;221;25-34;92;115;207;SEC_221
2007;522;25-34;73;110;183;SEC_522
2007;407;35-49;119;145;264;SEC_407
2007;225;75 i +;50;28;78;SEC_225
2007;303;03-11;42;49;91;SEC_303
2007;308;12-15;32;38;70;SEC_308
2007;415;25-34;91;115;206;SEC_415
2007;207;25-34;83;80;163;SEC_207
2007;231;75 i +;85;47;132;SEC_231
2007;321;65-74;83;85;168;SEC_321
2007;202;65-74;37;33;70;SEC_202
2007;101;25-34;169;169;338;SEC_101
2007;416;16-17;4;3;7;SEC_416
2007;433;00-02;35;25;60;SEC_433
2007;134;03-11;46;53;99;SEC_134
2007;424;50-64;55;55;110;SEC_424
2007;318;00-02;12;8;20;SEC_318
2007;402;18-24;36;24;60;SEC_402
2007;429;35-49;61;68;129;SEC_429
2007;206;75 i +;77;42;119;SEC_206
2007;239;50-64;94;73;167;SEC_239
2007;220;25-34;78;73;151;SEC_220
2007;524;18-24;44;58;102;SEC_524
2007;531;50-64;85;73;158;SEC_531
2007;531;12-15;20;16;36;SEC_531
2007;236;65-74;68;48;116;SEC_236
2007;416;65-74;48;40;88;SEC_416
2007;243;35-49;199;209;408;SEC_243
2007;315;03-11;69;69;138;SEC_315
2007;212;16-17;19;13;32;SEC_212
2007;103;50-64;65;62;127;SEC_103
2007;407;00-02;11;15;26;SEC_407
2007;231;35-49;143;120;263;SEC_231
2007;628;50-64;121;104;225;SEC_628
2007;104;12-15;17;14;31;SEC_104
2007;104;35-49;100;120;220;SEC_104
2007;224;00-02;7;12;19;SEC_224
2007;429;03-11;19;21;40;SEC_429
2007;604;18-24;20;35;55;SEC_604
2007;304;75 i +;101;48;149;SEC_304
2007;532;35-49;150;155;305;SEC_532
2007;137;65-74;51;47;98;SEC_137
2007;527;00-02;19;32;51;SEC_527
2007;245;25-34;107;116;223;SEC_245
2007;230;16-17;6;10;16;SEC_230
2007;106;03-11;66;56;122;SEC_106
2007;410;65-74;126;100;226;SEC_410
2007;522;18-24;64;54;118;SEC_522
2007;202;16-17;4;6;10;SEC_202
2007;139;03-11;30;60;90;SEC_139
2007;317;18-24;51;45;96;SEC_317
2007;422;35-49;117;146;263;SEC_422
2007;432;03-11;46;40;86;SEC_432
2007;218;35-49;82;94;176;SEC_218
2007;104;75 i +;80;42;122;SEC_104
2007;424;00-02;7;9;16;SEC_424
2007;311;00-02;16;28;44;SEC_311
2007;112;35-49;188;167;355;SEC_112
2007;620;03-11;13;28;41;SEC_620
2007;409;75 i +;27;22;49;SEC_409
2007;122;65-74;72;69;141;SEC_122
2007;235;03-11;64;72;136;SEC_235
2007;123;25-34;110;89;199;SEC_123
2007;301;00-02;47;51;98;SEC_301
2007;501;12-15;17;15;32;SEC_501
2007;532;75 i +;77;60;137;SEC_532
2007;416;03-11;34;42;76;SEC_416
2007;210;65-74;61;45;106;SEC_210
2007;230;03-11;38;32;70;SEC_230
2007;609;75 i +;30;28;58;SEC_609
2007;140;75 i +;52;41;93;SEC_140
2007;222;50-64;75;70;145;SEC_222
2007;505;03-11;26;26;52;SEC_505
2007;242;18-24;42;54;96;SEC_242
2007;240;25-34;73;78;151;SEC_240
2007;316;00-02;17;14;31;SEC_316
2007;204;65-74;28;22;50;SEC_204
2007;213;18-24;58;53;111;SEC_213
2007;303;12-15;15;21;36;SEC_303
2007;325;50-64;206;183;389;SEC_325
2007;301;75 i +;104;65;169;SEC_301
2007;205;25-34;88;86;174;SEC_205
2007;110;75 i +;62;36;98;SEC_110
2007;605;03-11;17;21;38;SEC_605
2007;213;25-34;83;135;218;SEC_213
2007;414;35-49;97;113;210;SEC_414
2007;406;12-15;22;27;49;SEC_406
2007;436;16-17;7;11;18;SEC_436
2007;517;75 i +;59;27;86;SEC_517
2007;221;18-24;56;40;96;SEC_221
2007;431;12-15;27;35;62;SEC_431
2007;608;75 i +;41;28;69;SEC_608
2007;118;18-24;97;87;184;SEC_118
2007;521;65-74;65;69;134;SEC_521
2007;208;35-49;166;176;342;SEC_208
2007;631;16-17;13;8;21;SEC_631
2007;622;25-34;60;83;143;SEC_622
2007;415;35-49;91;140;231;SEC_415
2007;115;16-17;4;17;21;SEC_115
2007;610;12-15;13;24;37;SEC_610
2007;233;50-64;62;56;118;SEC_233
2007;413;16-17;11;7;18;SEC_413
2007;425;00-02;14;11;25;SEC_425
2007;125;03-11;54;58;112;SEC_125
2007;235;50-64;114;85;199;SEC_235
2007;417;65-74;39;23;62;SEC_417
2007;619;03-11;40;48;88;SEC_619
2007;323;75 i +;71;27;98;SEC_323
2007;108;18-24;47;44;91;SEC_108
2007;514;18-24;44;45;89;SEC_514
2007;244;18-24;26;27;53;SEC_244
2007;603;65-74;34;39;73;SEC_603
2007;243;18-24;63;58;121;SEC_243
2007;436;12-15;18;19;37;SEC_436
2007;630;00-02;9;12;21;SEC_630
2007;436;35-49;111;149;260;SEC_436
2007;123;00-02;15;18;33;SEC_123
2007;606;65-74;77;60;137;SEC_606
2007;111;35-49;98;98;196;SEC_111
2007;304;50-64;105;111;216;SEC_304
2007;216;50-64;133;107;240;SEC_216
2007;612;12-15;12;19;31;SEC_612
2007;527;35-49;150;166;316;SEC_527
2007;519;75 i +;28;26;54;SEC_519
2007;243;16-17;17;18;35;SEC_243
2007;203;25-34;90;120;210;SEC_203
2007;226;75 i +;90;50;140;SEC_226
2007;227;16-17;6;5;11;SEC_227
2007;103;25-34;74;86;160;SEC_103
2007;421;75 i +;81;53;134;SEC_421
2007;105;12-15;15;21;36;SEC_105
2007;318;65-74;31;22;53;SEC_318
2007;527;18-24;67;67;134;SEC_527
2007;436;03-11;48;55;103;SEC_436
2007;410;35-49;163;165;328;SEC_410
2007;622;16-17;11;12;23;SEC_622
2007;523;75 i +;108;50;158;SEC_523
2007;419;75 i +;41;30;71;SEC_419
2007;134;50-64;124;120;244;SEC_134
2007;302;75 i +;61;33;94;SEC_302
2007;223;25-34;113;100;213;SEC_223
2007;625;35-49;122;116;238;SEC_625
2007;411;75 i +;86;63;149;SEC_411
2007;110;16-17;7;13;20;SEC_110
2007;617;65-74;68;52;120;SEC_617
2007;108;16-17;11;11;22;SEC_108
2007;133;18-24;40;32;72;SEC_133
2007;441;00-02;19;19;38;SEC_441
2007;306;50-64;151;126;277;SEC_306
2007;532;03-11;44;48;92;SEC_532
2007;121;16-17;6;8;14;SEC_121
2007;501;03-11;42;48;90;SEC_501
2007;308;50-64;210;192;402;SEC_308
2007;411;03-11;32;25;57;SEC_411
2007;203;16-17;3;5;8;SEC_203
2007;315;65-74;60;55;115;SEC_315
2007;522;35-49;111;99;210;SEC_522
2007;232;16-17;8;5;13;SEC_232
2007;112;03-11;51;55;106;SEC_112
2007;506;75 i +;72;52;124;SEC_506
2007;215;75 i +;65;34;99;SEC_215
2007;103;00-02;11;5;16;SEC_103
2007;246;18-24;44;50;94;SEC_246
2007;318;35-49;110;103;213;SEC_318
2007;622;65-74;32;34;66;SEC_622
2007;224;12-15;15;7;22;SEC_224
2007;225;00-02;10;8;18;SEC_225
2007;234;18-24;35;37;72;SEC_234
2007;137;16-17;13;11;24;SEC_137
2007;310;25-34;104;103;207;SEC_310
2007;609;65-74;47;43;90;SEC_609
2007;438;75 i +;33;23;56;SEC_438
2007;622;50-64;103;90;193;SEC_622
2007;619;12-15;15;16;31;SEC_619
2007;201;18-24;25;36;61;SEC_201
2007;631;35-49;97;116;213;SEC_631
2007;128;03-11;29;37;66;SEC_128
2007;522;12-15;12;17;29;SEC_522
2007;110;12-15;14;17;31;SEC_110
2007;213;16-17;9;8;17;SEC_213
2007;415;75 i +;43;24;67;SEC_415
2007;601;18-24;37;47;84;SEC_601
2007;223;03-11;53;52;105;SEC_223
2007;421;65-74;85;59;144;SEC_421
2007;233;00-02;5;15;20;SEC_233
2007;601;50-64;147;117;264;SEC_601
2007;316;65-74;59;59;118;SEC_316
2007;525;25-34;98;109;207;SEC_525
2007;431;25-34;164;201;365;SEC_431
2007;224;25-34;66;66;132;SEC_224
2007;528;50-64;83;80;163;SEC_528
2007;239;65-74;71;56;127;SEC_239
2007;515;75 i +;29;13;42;SEC_515
2007;418;00-02;19;15;34;SEC_418
2007;535;12-15;18;16;34;SEC_535
2007;533;12-15;16;13;29;SEC_533
2007;245;12-15;8;22;30;SEC_245
2007;510;35-49;117;125;242;SEC_510
2007;105;25-34;106;106;212;SEC_105
2007;112;18-24;63;66;129;SEC_112
2007;407;65-74;62;45;107;SEC_407
2007;234;75 i +;73;42;115;SEC_234
2007;436;18-24;44;40;84;SEC_436
2007;505;16-17;12;7;19;SEC_505
2007;507;16-17;8;11;19;SEC_507
2007;312;25-34;150;161;311;SEC_312
2007;612;03-11;36;44;80;SEC_612
2007;113;12-15;17;28;45;SEC_113
2007;310;16-17;6;8;14;SEC_310
2007;428;18-24;44;36;80;SEC_428
2007;537;00-02;9;5;14;SEC_537
2007;125;65-74;52;60;112;SEC_125
2007;436;00-02;18;21;39;SEC_436
2007;204;18-24;27;34;61;SEC_204
2007;237;12-15;28;23;51;SEC_237
2007;620;75 i +;16;15;31;SEC_620
2007;510;18-24;40;48;88;SEC_510
2007;238;00-02;9;17;26;SEC_238
2007;318;18-24;45;40;85;SEC_318
2007;210;00-02;8;4;12;SEC_210
2007;213;65-74;41;44;85;SEC_213
2007;419;65-74;49;37;86;SEC_419
2007;233;75 i +;55;23;78;SEC_233
2007;610;16-17;10;6;16;SEC_610
2007;226;12-15;20;12;32;SEC_226
2007;604;00-02;13;8;21;SEC_604
2007;529;12-15;25;22;47;SEC_529
2007;410;03-11;51;82;133;SEC_410
2007;529;03-11;41;49;90;SEC_529
2007;126;50-64;121;94;215;SEC_126
2007;402;16-17;6;5;11;SEC_402
2007;125;25-34;137;169;306;SEC_125
2007;529;35-49;155;155;310;SEC_529
2007;123;12-15;21;33;54;SEC_123
2007;507;25-34;93;97;190;SEC_507
2007;238;16-17;7;9;16;SEC_238
2007;422;65-74;54;46;100;SEC_422
2007;325;03-11;70;66;136;SEC_325
2007;401;00-02;14;20;34;SEC_401
2007;607;12-15;15;19;34;SEC_607
2007;425;35-49;116;134;250;SEC_425
2007;613;50-64;153;98;251;SEC_613
2007;515;00-02;10;11;21;SEC_515
2007;630;25-34;85;115;200;SEC_630
2007;520;03-11;29;36;65;SEC_520
2007;534;35-49;137;111;248;SEC_534
2007;101;00-02;49;60;109;SEC_101
2007;305;03-11;62;53;115;SEC_305
2007;519;35-49;73;106;179;SEC_519
2007;226;25-34;123;135;258;SEC_226
2007;312;75 i +;62;33;95;SEC_312
2007;614;00-02;16;11;27;SEC_614
2007;127;18-24;35;37;72;SEC_127
2007;240;35-49;85;97;182;SEC_240
2007;204;16-17;6;5;11;SEC_204
2007;202;50-64;61;61;122;SEC_202
2007;304;25-34;159;174;333;SEC_304
2007;603;50-64;67;46;113;SEC_603
2007;306;25-34;128;149;277;SEC_306
2007;607;75 i +;47;29;76;SEC_607
2007;217;16-17;9;9;18;SEC_217
2007;628;75 i +;42;30;72;SEC_628
2007;232;65-74;62;47;109;SEC_232
2007;102;00-02;19;22;41;SEC_102
2007;619;25-34;93;103;196;SEC_619
2007;316;18-24;154;155;309;SEC_316
2007;528;65-74;63;61;124;SEC_528
2007;504;35-49;94;106;200;SEC_504
2007;247;03-11;48;46;94;SEC_247
2007;629;65-74;33;38;71;SEC_629
2007;101;18-24;61;54;115;SEC_101
2007;534;03-11;31;40;71;SEC_534
2007;323;35-49;337;345;682;SEC_323
2007;620;12-15;14;9;23;SEC_620
2007;235;75 i +;83;53;136;SEC_235
2007;502;35-49;155;172;327;SEC_502
2007;403;16-17;7;11;18;SEC_403
2007;518;00-02;13;12;25;SEC_518
2007;502;50-64;155;148;303;SEC_502
2007;118;65-74;51;67;118;SEC_118
2007;520;50-64;75;70;145;SEC_520
2007;424;12-15;7;11;18;SEC_424
2007;628;25-34;59;78;137;SEC_628
2007;310;50-64;83;103;186;SEC_310
2007;538;75 i +;76;42;118;SEC_538
2007;624;25-34;94;111;205;SEC_624
2007;611;00-02;23;40;63;SEC_611
2007;209;00-02;10;19;29;SEC_209
2007;228;50-64;51;49;100;SEC_228
2007;239;25-34;123;116;239;SEC_239
2007;519;03-11;28;40;68;SEC_519
2007;316;75 i +;72;31;103;SEC_316
2007;434;75 i +;58;24;82;SEC_434
2007;522;03-11;39;43;82;SEC_522
2007;530;50-64;107;83;190;SEC_530
2007;111;00-02;9;10;19;SEC_111
2007;423;75 i +;65;38;103;SEC_423
2007;109;12-15;13;16;29;SEC_109
2007;503;50-64;118;102;220;SEC_503
2007;603;00-02;7;8;15;SEC_603
2007;613;75 i +;57;33;90;SEC_613
2007;309;12-15;13;15;28;SEC_309
2007;515;65-74;31;25;56;SEC_515
2007;103;65-74;49;36;85;SEC_103
2007;408;25-34;104;129;233;SEC_408
2007;625;65-74;58;65;123;SEC_625
2007;428;65-74;27;17;44;SEC_428
2007;307;75 i +;80;57;137;SEC_307
2007;535;03-11;22;39;61;SEC_535
2007;107;00-02;27;36;63;SEC_107
2007;312;65-74;86;86;172;SEC_312
2007;311;25-34;105;140;245;SEC_311
2007;245;16-17;13;13;26;SEC_245
2007;527;03-11;65;39;104;SEC_527
2007;623;18-24;46;50;96;SEC_623
2007;522;16-17;6;6;12;SEC_522
2007;227;50-64;59;60;119;SEC_227
2007;325;00-02;20;20;40;SEC_325
2007;623;50-64;203;169;372;SEC_623
2007;127;25-34;58;70;128;SEC_127
2007;246;00-02;15;24;39;SEC_246
2007;428;03-11;31;20;51;SEC_428
2007;501;75 i +;28;16;44;SEC_501
2007;124;35-49;94;71;165;SEC_124
2007;308;35-49;250;257;507;SEC_308
2007;223;50-64;109;88;197;SEC_223
2007;234;35-49;114;131;245;SEC_234
2007;122;25-34;83;72;155;SEC_122
2007;528;25-34;132;152;284;SEC_528
2007;418;50-64;104;84;188;SEC_418
2007;140;25-34;93;123;216;SEC_140
2007;513;00-02;11;15;26;SEC_513
2007;315;25-34;166;177;343;SEC_315
2007;302;35-49;123;146;269;SEC_302
2007;118;75 i +;59;22;81;SEC_118
2007;322;25-34;166;151;317;SEC_322
2007;249;35-49;131;145;276;SEC_249
2007;426;03-11;41;39;80;SEC_426
2007;248;35-49;166;184;350;SEC_248
2007;313;25-34;191;187;378;SEC_313
2007;609;12-15;11;14;25;SEC_609
2007;630;03-11;28;37;65;SEC_630
2007;532;50-64;122;84;206;SEC_532
2007;139;35-49;108;123;231;SEC_139
2007;315;16-17;13;21;34;SEC_315
2007;310;75 i +;36;27;63;SEC_310
2007;224;35-49;73;89;162;SEC_224
2007;320;16-17;7;5;12;SEC_320
2007;123;65-74;57;61;118;SEC_123
2007;504;18-24;31;48;79;SEC_504
2007;424;75 i +;19;23;42;SEC_424
2007;418;18-24;51;70;121;SEC_418
2007;117;25-34;135;177;312;SEC_117
2007;528;03-11;65;51;116;SEC_528
2007;528;18-24;65;55;120;SEC_528
2007;108;65-74;64;42;106;SEC_108
2007;515;18-24;37;43;80;SEC_515
2007;504;75 i +;68;52;120;SEC_504
2007;310;12-15;13;12;25;SEC_310
2007;605;18-24;22;16;38;SEC_605
2007;240;00-02;10;7;17;SEC_240
2007;537;50-64;136;95;231;SEC_537
2007;501;65-74;39;33;72;SEC_501
2007;106;00-02;27;22;49;SEC_106
2007;436;50-64;56;53;109;SEC_436
2007;216;75 i +;68;49;117;SEC_216
2007;619;16-17;6;11;17;SEC_619
2007;324;50-64;72;71;143;SEC_324
2007;113;75 i +;52;37;89;SEC_113
2007;602;25-34;48;44;92;SEC_602
2007;415;65-74;25;29;54;SEC_415
2007;246;16-17;14;14;28;SEC_246
2007;237;65-74;75;53;128;SEC_237
2007;608;25-34;59;76;135;SEC_608
2007;227;00-02;12;5;17;SEC_227
2007;402;75 i +;51;39;90;SEC_402
2007;434;16-17;8;3;11;SEC_434
2007;321;12-15;28;42;70;SEC_321
2007;234;25-34;93;102;195;SEC_234
2007;117;35-49;230;215;445;SEC_117
2007;535;65-74;58;72;130;SEC_535
2007;632;35-49;95;98;193;SEC_632
2007;137;25-34;126;124;250;SEC_137
2007;609;35-49;79;83;162;SEC_609
2007;420;35-49;183;194;377;SEC_420
2007;524;16-17;10;6;16;SEC_524
2007;501;50-64;161;154;315;SEC_501
2007;204;00-02;10;14;24;SEC_204
2007;511;65-74;45;39;84;SEC_511
2007;520;18-24;32;39;71;SEC_520
2007;418;25-34;119;148;267;SEC_418
2007;210;18-24;17;30;47;SEC_210
2007;233;12-15;12;11;23;SEC_233
2007;619;35-49;128;138;266;SEC_619
2007;434;35-49;85;87;172;SEC_434
2007;419;50-64;61;55;116;SEC_419
2007;530;25-34;129;173;302;SEC_530
2007;438;12-15;12;18;30;SEC_438
2007;406;00-02;19;23;42;SEC_406
2007;517;65-74;58;54;112;SEC_517
2007;212;25-34;134;174;308;SEC_212
2007;601;35-49;125;151;276;SEC_601
2007;439;03-11;51;61;112;SEC_439
2007;129;65-74;55;60;115;SEC_129
2007;124;03-11;27;22;49;SEC_124
2007;239;00-02;17;15;32;SEC_239
2007;218;03-11;25;27;52;SEC_218
2007;122;35-49;90;102;192;SEC_122
2007;243;00-02;18;21;39;SEC_243
2007;533;16-17;5;10;15;SEC_533
2007;134;75 i +;73;35;108;SEC_134
2007;213;50-64;85;86;171;SEC_213
2007;432;35-49;126;121;247;SEC_432
2007;317;65-74;31;30;61;SEC_317
2007;404;03-11;56;62;118;SEC_404
2007;110;50-64;182;142;324;SEC_110
2007;425;65-74;64;46;110;SEC_425
2007;236;75 i +;79;51;130;SEC_236
2007;136;25-34;129;122;251;SEC_136
2007;504;03-11;26;31;57;SEC_504
2007;312;00-02;25;21;46;SEC_312
2007;425;12-15;12;16;28;SEC_425
2007;412;75 i +;82;57;139;SEC_412
2007;106;35-49;187;183;370;SEC_106
2007;219;03-11;54;50;104;SEC_219
2007;209;50-64;73;62;135;SEC_209
2007;104;18-24;14;19;33;SEC_104
2007;401;18-24;46;72;118;SEC_401
2007;209;25-34;75;78;153;SEC_209
2007;208;16-17;12;4;16;SEC_208
2007;212;00-02;26;26;52;SEC_212
2007;246;65-74;54;46;100;SEC_246
2007;616;00-02;31;43;74;SEC_616
2007;627;35-49;85;80;165;SEC_627
2007;111;65-74;60;48;108;SEC_111
2007;315;35-49;225;222;447;SEC_315
2007;602;12-15;7;10;17;SEC_602
2007;316;35-49;199;137;336;SEC_316
2007;520;65-74;52;40;92;SEC_520
2007;132;75 i +;79;55;134;SEC_132
2007;409;16-17;6;7;13;SEC_409
2007;236;35-49;125;136;261;SEC_236
2007;615;18-24;22;23;45;SEC_615
2007;416;18-24;37;41;78;SEC_416
2007;232;03-11;33;38;71;SEC_232
2007;241;75 i +;71;32;103;SEC_241
2007;529;25-34;128;131;259;SEC_529
2007;603;12-15;13;10;23;SEC_603
2007;435;16-17;12;14;26;SEC_435
2007;314;35-49;305;279;584;SEC_314
2007;220;35-49;123;130;253;SEC_220
2007;418;03-11;40;47;87;SEC_418
2007;535;35-49;103;97;200;SEC_535
2007;247;35-49;162;180;342;SEC_247
2007;401;75 i +;90;46;136;SEC_401
2007;224;18-24;31;22;53;SEC_224
2007;125;75 i +;54;36;90;SEC_125
2007;534;25-34;85;95;180;SEC_534
2007;303;00-02;21;16;37;SEC_303
2007;234;03-11;28;32;60;SEC_234
2007;525;75 i +;52;34;86;SEC_525
2007;222;65-74;34;33;67;SEC_222
2007;130;25-34;77;79;156;SEC_130
2007;441;25-34;143;159;302;SEC_441
2007;603;16-17;4;7;11;SEC_603
2007;212;65-74;65;59;124;SEC_212
2007;241;18-24;30;32;62;SEC_241
2007;531;25-34;96;110;206;SEC_531
2007;307;65-74;79;58;137;SEC_307
2007;606;03-11;41;46;87;SEC_606
2007;537;65-74;72;73;145;SEC_537
2007;522;65-74;31;32;63;SEC_522
2007;302;25-34;146;179;325;SEC_302
2007;606;50-64;84;57;141;SEC_606
2007;442;16-17;4;7;11;SEC_442
2007;325;25-34;123;130;253;SEC_325
2007;125;35-49;165;214;379;SEC_125
2007;210;25-34;72;62;134;SEC_210
2007;602;75 i +;23;16;39;SEC_602
2007;240;12-15;13;12;25;SEC_240
2007;626;65-74;61;50;111;SEC_626
2007;249;65-74;61;31;92;SEC_249
2007;222;16-17;14;16;30;SEC_222
2007;127;00-02;10;17;27;SEC_127
2007;403;25-34;99;118;217;SEC_403
2007;215;00-02;13;14;27;SEC_215
2007;523;50-64;106;99;205;SEC_523
2007;530;12-15;20;22;42;SEC_530
2007;429;18-24;23;39;62;SEC_429
2007;524;03-11;49;55;104;SEC_524
2007;104;16-17;6;6;12;SEC_104
2007;130;16-17;5;14;19;SEC_130
2007;527;50-64;78;67;145;SEC_527
2007;628;03-11;33;42;75;SEC_628
2007;432;18-24;52;58;110;SEC_432
2007;120;25-34;122;139;261;SEC_120
2007;122;03-11;34;39;73;SEC_122
2007;410;25-34;118;125;243;SEC_410
2007;239;35-49;136;153;289;SEC_239
2007;202;25-34;98;99;197;SEC_202
2007;517;25-34;141;166;307;SEC_517
2007;627;03-11;31;22;53;SEC_627
2007;220;12-15;14;15;29;SEC_220
2007;136;75 i +;65;44;109;SEC_136
2007;503;75 i +;38;11;49;SEC_503
2007;403;50-64;127;96;223;SEC_403
2007;206;35-49;106;114;220;SEC_206
2007;126;16-17;7;4;11;SEC_126
2007;201;75 i +;43;28;71;SEC_201
2007;113;00-02;23;30;53;SEC_113
2007;225;35-49;54;56;110;SEC_225
2007;405;16-17;10;6;16;SEC_405
2007;230;65-74;39;34;73;SEC_230
2007;238;65-74;39;35;74;SEC_238
2007;437;16-17;8;9;17;SEC_437
2007;631;25-34;96;108;204;SEC_631
2007;420;65-74;79;64;143;SEC_420
2007;225;16-17;5;5;10;SEC_225
2007;232;50-64;90;91;181;SEC_232
2007;632;12-15;19;20;39;SEC_632
2007;429;75 i +;42;24;66;SEC_429
2007;127;65-74;39;33;72;SEC_127
2007;520;25-34;67;78;145;SEC_520
2007;515;25-34;61;63;124;SEC_515
2007;509;35-49;91;101;192;SEC_509
2007;623;35-49;135;136;271;SEC_623
2007;311;16-17;9;19;28;SEC_311
2007;628;12-15;20;14;34;SEC_628
2007;126;18-24;31;28;59;SEC_126
2007;304;65-74;75;58;133;SEC_304
2007;210;16-17;6;1;7;SEC_210
2007;310;35-49;108;98;206;SEC_310
2007;321;50-64;297;276;573;SEC_321
2007;508;12-15;11;7;18;SEC_508
2007;534;75 i +;58;34;92;SEC_534
2007;527;16-17;16;13;29;SEC_527
2007;203;50-64;58;60;118;SEC_203
2007;135;12-15;20;14;34;SEC_135
2007;122;00-02;13;11;24;SEC_122
2007;435;35-49;105;141;246;SEC_435
2007;426;18-24;53;41;94;SEC_426
2007;120;65-74;48;49;97;SEC_120
2007;505;35-49;115;110;225;SEC_505
2007;306;03-11;55;57;112;SEC_306
2007;306;75 i +;105;65;170;SEC_306
2007;535;00-02;10;4;14;SEC_535
2007;503;16-17;4;11;15;SEC_503
2007;426;16-17;3;10;13;SEC_426
2007;429;25-34;58;74;132;SEC_429
2007;615;12-15;7;9;16;SEC_615
2007;506;03-11;68;72;140;SEC_506
2007;614;35-49;97;100;197;SEC_614
2007;535;75 i +;43;28;71;SEC_535
2007;439;75 i +;48;36;84;SEC_439
2007;624;65-74;54;67;121;SEC_624
2007;109;65-74;40;44;84;SEC_109
2007;311;18-24;51;50;101;SEC_311
2007;211;25-34;130;199;329;SEC_211
2007;114;50-64;185;150;335;SEC_114
2007;414;00-02;15;11;26;SEC_414
2007;438;50-64;68;62;130;SEC_438
2007;213;00-02;18;15;33;SEC_213
2007;525;50-64;65;65;130;SEC_525
2007;120;75 i +;65;26;91;SEC_120
2007;613;65-74;82;104;186;SEC_613
2007;505;75 i +;59;42;101;SEC_505
2007;140;65-74;63;55;118;SEC_140
2007;404;50-64;107;104;211;SEC_404
2007;138;00-02;7;9;16;SEC_138
2007;238;75 i +;66;41;107;SEC_238
2007;205;16-17;7;10;17;SEC_205
2007;504;65-74;87;84;171;SEC_504
2007;525;65-74;67;48;115;SEC_525
2007;118;25-34;163;184;347;SEC_118
2007;614;65-74;68;65;133;SEC_614
2007;511;00-02;8;10;18;SEC_511
2007;601;03-11;41;42;83;SEC_601
2007;111;25-34;83;82;165;SEC_111
2007;237;50-64;89;92;181;SEC_237
2007;312;35-49;194;204;398;SEC_312
2007;311;75 i +;95;51;146;SEC_311
2007;213;35-49;125;116;241;SEC_213
2007;607;25-34;81;106;187;SEC_607
2007;303;18-24;43;46;89;SEC_303
2007;102;03-11;62;70;132;SEC_102
2007;616;16-17;26;43;69;SEC_616
2007;215;03-11;27;44;71;SEC_215
2007;113;50-64;204;205;409;SEC_113
2007;203;18-24;45;32;77;SEC_203
2007;514;65-74;53;41;94;SEC_514
2007;439;65-74;61;57;118;SEC_439
2007;403;35-49;110;117;227;SEC_403
2007;232;75 i +;67;38;105;SEC_232
2007;237;03-11;55;55;110;SEC_237
2007;505;12-15;25;12;37;SEC_505
2007;218;00-02;13;15;28;SEC_218
2007;325;65-74;99;78;177;SEC_325
2007;426;35-49;120;134;254;SEC_426
2007;432;12-15;15;28;43;SEC_432
2007;405;65-74;86;65;151;SEC_405
2007;620;25-34;42;45;87;SEC_620
2007;235;16-17;12;14;26;SEC_235
2007;402;00-02;7;13;20;SEC_402
2007;602;16-17;5;3;8;SEC_602
2007;308;65-74;93;90;183;SEC_308
2007;301;65-74;127;116;243;SEC_301
2007;130;12-15;11;12;23;SEC_130
2007;219;12-15;26;16;42;SEC_219
2007;202;03-11;26;23;49;SEC_202
2007;621;16-17;18;14;32;SEC_621
2007;219;50-64;85;76;161;SEC_219
2007;514;00-02;11;14;25;SEC_514
2007;316;12-15;35;42;77;SEC_316
2007;122;16-17;9;3;12;SEC_122
2007;517;50-64;86;82;168;SEC_517
2007;105;75 i +;63;34;97;SEC_105
2007;227;12-15;11;8;19;SEC_227
2007;308;25-34;171;154;325;SEC_308
2007;313;00-02;30;30;60;SEC_313
2007;408;16-17;6;6;12;SEC_408
2007;204;50-64;42;42;84;SEC_204
2007;608;12-15;19;16;35;SEC_608
2007;607;18-24;42;44;86;SEC_607
2007;125;18-24;62;70;132;SEC_125
2007;235;12-15;25;20;45;SEC_235
2007;116;75 i +;65;46;111;SEC_116
2007;324;65-74;35;36;71;SEC_324
2007;416;12-15;18;16;34;SEC_416
2007;128;50-64;100;76;176;SEC_128
2007;234;50-64;57;51;108;SEC_234
2007;608;50-64;83;65;148;SEC_608
2007;307;18-24;48;56;104;SEC_307
2007;122;18-24;34;15;49;SEC_122
2007;536;25-34;74;80;154;SEC_536
2007;137;75 i +;55;26;81;SEC_137
2007;318;50-64;97;99;196;SEC_318
2007;217;25-34;73;91;164;SEC_217
2007;208;00-02;14;16;30;SEC_208
2007;534;16-17;5;6;11;SEC_534
2007;130;65-74;81;55;136;SEC_130
2007;113;16-17;13;16;29;SEC_113
2007;124;65-74;35;35;70;SEC_124
2007;129;16-17;6;9;15;SEC_129
2007;506;00-02;18;22;40;SEC_506
2007;131;12-15;16;24;40;SEC_131
2007;618;16-17;4;7;11;SEC_618
2007;114;00-02;12;20;32;SEC_114
2007;413;18-24;26;28;54;SEC_413
2007;431;16-17;12;19;31;SEC_431
2007;126;00-02;8;14;22;SEC_126
2007;519;00-02;12;15;27;SEC_519
2007;217;50-64;37;47;84;SEC_217
2007;510;65-74;65;47;112;SEC_510
2007;242;50-64;93;92;185;SEC_242
2007;537;03-11;48;41;89;SEC_537
2007;631;65-74;61;56;117;SEC_631
2007;118;00-02;30;26;56;SEC_118
2007;430;16-17;5;8;13;SEC_430
2007;605;12-15;9;3;12;SEC_605
2007;216;18-24;51;55;106;SEC_216
2007;210;50-64;86;78;164;SEC_210
2007;239;12-15;15;21;36;SEC_239
2007;239;75 i +;93;60;153;SEC_239
2007;624;00-02;12;17;29;SEC_624
2007;602;50-64;53;37;90;SEC_602
2007;322;00-02;39;16;55;SEC_322
2007;608;16-17;6;9;15;SEC_608
2007;106;25-34;168;186;354;SEC_106
2007;518;50-64;88;65;153;SEC_518
2007;201;50-64;59;39;98;SEC_201
2007;627;75 i +;43;22;65;SEC_627
2007;429;65-74;37;28;65;SEC_429
2007;127;16-17;9;9;18;SEC_127
2007;244;12-15;13;9;22;SEC_244
2007;119;65-74;57;57;114;SEC_119
2007;134;12-15;17;22;39;SEC_134
2007;616;18-24;125;130;255;SEC_616
2007;601;00-02;17;17;34;SEC_601
2007;530;16-17;12;10;22;SEC_530
2007;501;18-24;33;31;64;SEC_501
2007;210;75 i +;98;53;151;SEC_210
2007;422;18-24;46;69;115;SEC_422
2007;425;25-34;86;74;160;SEC_425
2007;302;03-11;40;51;91;SEC_302
2007;308;16-17;14;17;31;SEC_308
2007;203;00-02;14;18;32;SEC_203
2007;502;03-11;46;58;104;SEC_502
2007;117;18-24;99;91;190;SEC_117
