AnyPadro;Seccio;GrupEdat;Dones;Homes;Total;IdSeccio
2020;614;18-24;29;31;60;SEC_614
2020;624;16-17;11;6;17;SEC_624
2020;223;18-24;50;51;101;SEC_223
2020;122;16-17;13;9;22;SEC_122
2020;602;00-02;9;14;23;SEC_602
2020;427;25-34;145;130;275;SEC_427
2020;407;50-64;98;100;198;SEC_407
2020;435;16-17;13;6;19;SEC_435
2020;525;18-24;44;28;72;SEC_525
2020;101;65-74;77;69;146;SEC_101
2020;425;75 i +;70;43;113;SEC_425
2020;411;75 i +;101;69;170;SEC_411
2020;109;25-34;68;65;133;SEC_109
2020;533;25-34;139;160;299;SEC_533
2020;308;16-17;26;28;54;SEC_308
2020;529;50-64;128;100;228;SEC_529
2020;615;75 i +;90;64;154;SEC_615
2020;632;50-64;87;79;166;SEC_632
2020;239;12-15;14;12;26;SEC_239
2020;524;35-49;191;176;367;SEC_524
2020;606;18-24;36;44;80;SEC_606
2020;115;35-49;159;164;323;SEC_115
2020;612;18-24;30;41;71;SEC_612
2020;317;00-02;20;16;36;SEC_317
2020;328;03-11;138;157;295;SEC_328
2020;514;65-74;44;34;78;SEC_514
2020;614;75 i +;89;67;156;SEC_614
2020;111;75 i +;78;52;130;SEC_111
2020;304;25-34;170;146;316;SEC_304
2020;506;75 i +;135;104;239;SEC_506
2020;102;50-64;145;138;283;SEC_102
2020;612;03-11;36;22;58;SEC_612
2020;328;18-24;67;45;112;SEC_328
2020;117;35-49;200;204;404;SEC_117
2020;521;16-17;6;14;20;SEC_521
2020;420;65-74;95;70;165;SEC_420
2020;529;25-34;112;102;214;SEC_529
2020;625;25-34;41;49;90;SEC_625
2020;313;65-74;134;112;246;SEC_313
2020;214;65-74;72;49;121;SEC_214
2020;630;00-02;6;6;12;SEC_630
2020;306;35-49;178;190;368;SEC_306
2020;632;16-17;9;17;26;SEC_632
2020;106;75 i +;80;70;150;SEC_106
2020;107;75 i +;118;79;197;SEC_107
2020;534;50-64;82;81;163;SEC_534
2020;228;16-17;25;23;48;SEC_228
2020;122;12-15;17;20;37;SEC_122
2020;105;12-15;30;26;56;SEC_105
2020;320;03-11;24;20;44;SEC_320
2020;608;00-02;15;10;25;SEC_608
2020;133;25-34;62;58;120;SEC_133
2020;403;03-11;50;58;108;SEC_403
2020;621;35-49;154;171;325;SEC_621
2020;605;12-15;36;30;66;SEC_605
2020;104;00-02;8;14;22;SEC_104
2020;605;50-64;173;137;310;SEC_605
2020;226;50-64;190;161;351;SEC_226
2020;140;25-34;64;65;129;SEC_140
2020;243;16-17;13;18;31;SEC_243
2020;530;65-74;52;41;93;SEC_530
2020;214;50-64;219;214;433;SEC_214
2020;613;18-24;30;39;69;SEC_613
2020;614;50-64;84;87;171;SEC_614
2020;626;75 i +;79;37;116;SEC_626
2020;528;35-49;158;156;314;SEC_528
2020;532;75 i +;102;62;164;SEC_532
2020;505;00-02;9;7;16;SEC_505
2020;606;65-74;47;23;70;SEC_606
2020;310;75 i +;47;25;72;SEC_310
2020;139;65-74;60;50;110;SEC_139
2020;220;03-11;78;78;156;SEC_220
2020;304;12-15;29;25;54;SEC_304
2020;524;75 i +;71;30;101;SEC_524
2020;425;18-24;48;48;96;SEC_425
2020;213;00-02;14;17;31;SEC_213
2020;231;00-02;20;24;44;SEC_231
2020;307;35-49;132;129;261;SEC_307
2020;126;50-64;82;72;154;SEC_126
2020;127;18-24;22;26;48;SEC_127
2020;319;75 i +;56;45;101;SEC_319
2020;214;18-24;104;97;201;SEC_214
2020;529;00-02;26;21;47;SEC_529
2020;532;65-74;61;39;100;SEC_532
2020;317;16-17;14;18;32;SEC_317
2020;133;65-74;58;45;103;SEC_133
2020;321;35-49;213;206;419;SEC_321
2020;238;03-11;45;40;85;SEC_238
2020;616;12-15;61;50;111;SEC_616
2020;124;75 i +;54;39;93;SEC_124
2020;133;12-15;17;18;35;SEC_133
2020;410;65-74;99;78;177;SEC_410
2020;317;35-49;156;169;325;SEC_317
2020;517;18-24;96;124;220;SEC_517
2020;314;65-74;140;133;273;SEC_314
2020;233;16-17;5;10;15;SEC_233
2020;611;12-15;35;53;88;SEC_611
2020;525;35-49;126;132;258;SEC_525
2020;430;03-11;58;55;113;SEC_430
2020;101;18-24;62;46;108;SEC_101
2020;306;25-34;139;132;271;SEC_306
2020;631;12-15;19;19;38;SEC_631
2020;404;18-24;61;64;125;SEC_404
2020;320;65-74;78;64;142;SEC_320
2020;605;16-17;18;17;35;SEC_605
2020;204;16-17;14;10;24;SEC_204
2020;245;00-02;17;18;35;SEC_245
2020;435;75 i +;52;23;75;SEC_435
2020;329;16-17;23;15;38;SEC_329
2020;437;12-15;34;36;70;SEC_437
2020;622;03-11;28;26;54;SEC_622
2020;308;75 i +;127;90;217;SEC_308
2020;427;50-64;157;162;319;SEC_427
2020;132;03-11;92;93;185;SEC_132
2020;537;03-11;57;46;103;SEC_537
2020;249;50-64;113;107;220;SEC_249
2020;305;65-74;105;94;199;SEC_305
2020;118;35-49;169;169;338;SEC_118
2020;528;75 i +;80;53;133;SEC_528
2020;618;18-24;44;57;101;SEC_618
2020;234;12-15;10;16;26;SEC_234
2020;212;25-34;132;132;264;SEC_212
2020;237;65-74;52;40;92;SEC_237
2020;533;00-02;32;26;58;SEC_533
2020;407;18-24;64;54;118;SEC_407
2020;502;75 i +;140;91;231;SEC_502
2020;414;65-74;53;41;94;SEC_414
2020;410;03-11;69;60;129;SEC_410
2020;106;16-17;16;11;27;SEC_106
2020;116;35-49;157;161;318;SEC_116
2020;405;50-64;173;169;342;SEC_405
2020;212;12-15;29;31;60;SEC_212
2020;123;03-11;51;43;94;SEC_123
2020;315;12-15;29;41;70;SEC_315
2020;517;75 i +;96;53;149;SEC_517
2020;114;35-49;169;180;349;SEC_114
2020;414;35-49;254;280;534;SEC_414
2020;240;50-64;175;169;344;SEC_240
2020;130;12-15;24;20;44;SEC_130
2020;138;16-17;7;2;9;SEC_138
2020;537;16-17;14;9;23;SEC_537
2020;532;18-24;57;56;113;SEC_532
2020;416;16-17;16;22;38;SEC_416
2020;238;50-64;87;77;164;SEC_238
2020;127;75 i +;40;29;69;SEC_127
2020;506;65-74;178;110;288;SEC_506
2020;248;16-17;12;6;18;SEC_248
2020;326;00-02;40;46;86;SEC_326
2020;139;18-24;34;50;84;SEC_139
2020;210;16-17;10;10;20;SEC_210
2020;510;03-11;48;39;87;SEC_510
2020;537;65-74;66;50;116;SEC_537
2020;631;16-17;4;10;14;SEC_631
2020;605;00-02;15;23;38;SEC_605
2020;406;25-34;105;87;192;SEC_406
2020;137;16-17;19;9;28;SEC_137
2020;422;50-64;124;116;240;SEC_422
2020;228;75 i +;144;75;219;SEC_228
2020;513;12-15;31;31;62;SEC_513
2020;523;03-11;61;56;117;SEC_523
2020;130;35-49;131;138;269;SEC_130
2020;433;03-11;104;116;220;SEC_433
2020;117;18-24;60;64;124;SEC_117
2020;240;65-74;71;44;115;SEC_240
2020;410;35-49;189;177;366;SEC_410
2020;232;00-02;13;14;27;SEC_232
2020;217;35-49;174;220;394;SEC_217
2020;619;75 i +;126;93;219;SEC_619
2020;605;65-74;101;65;166;SEC_605
2020;510;16-17;9;7;16;SEC_510
2020;504;00-02;12;8;20;SEC_504
2020;506;50-64;162;157;319;SEC_506
2020;121;35-49;120;117;237;SEC_121
2020;406;65-74;65;51;116;SEC_406
2020;238;18-24;38;41;79;SEC_238
2020;529;18-24;50;78;128;SEC_529
2020;204;35-49;208;218;426;SEC_204
2020;432;00-02;16;12;28;SEC_432
2020;313;18-24;69;75;144;SEC_313
2020;134;00-02;14;20;34;SEC_134
2020;535;12-15;16;16;32;SEC_535
2020;307;65-74;134;112;246;SEC_307
2020;107;50-64;146;130;276;SEC_107
2020;630;03-11;27;41;68;SEC_630
2020;403;35-49;150;141;291;SEC_403
2020;517;35-49;256;273;529;SEC_517
2020;248;25-34;109;122;231;SEC_248
2020;609;18-24;26;29;55;SEC_609
2020;534;16-17;9;6;15;SEC_534
2020;101;00-02;25;24;49;SEC_101
2020;309;00-02;20;16;36;SEC_309
2020;211;16-17;9;14;23;SEC_211
2020;422;12-15;26;25;51;SEC_422
2020;615;18-24;29;27;56;SEC_615
2020;406;75 i +;85;65;150;SEC_406
2020;520;00-02;12;9;21;SEC_520
2020;122;65-74;34;25;59;SEC_122
2020;325;65-74;131;87;218;SEC_325
2020;535;35-49;86;86;172;SEC_535
2020;305;35-49;186;187;373;SEC_305
2020;502;50-64;144;156;300;SEC_502
2020;528;50-64;120;103;223;SEC_528
2020;535;18-24;24;37;61;SEC_535
2020;418;75 i +;85;62;147;SEC_418
2020;531;50-64;100;92;192;SEC_531
2020;303;65-74;98;73;171;SEC_303
2020;614;03-11;27;36;63;SEC_614
2020;528;18-24;53;53;106;SEC_528
2020;239;50-64;119;123;242;SEC_239
2020;601;50-64;200;200;400;SEC_601
2020;130;50-64;116;105;221;SEC_130
2020;114;00-02;10;16;26;SEC_114
2020;105;35-49;128;139;267;SEC_105
2020;304;75 i +;90;56;146;SEC_304
2020;224;25-34;104;105;209;SEC_224
2020;232;03-11;62;48;110;SEC_232
2020;425;03-11;47;42;89;SEC_425
2020;506;35-49;174;170;344;SEC_506
2020;134;12-15;31;28;59;SEC_134
2020;324;50-64;90;92;182;SEC_324
2020;538;65-74;60;34;94;SEC_538
2020;502;65-74;84;72;156;SEC_502
2020;327;16-17;12;10;22;SEC_327
2020;601;35-49;213;236;449;SEC_601
2020;611;75 i +;127;106;233;SEC_611
2020;308;03-11;66;77;143;SEC_308
2020;320;25-34;37;40;77;SEC_320
2020;441;75 i +;113;106;219;SEC_441
2020;419;18-24;90;93;183;SEC_419
2020;103;03-11;38;37;75;SEC_103
2020;404;03-11;61;76;137;SEC_404
2020;525;65-74;38;34;72;SEC_525
2020;328;12-15;59;55;114;SEC_328
2020;119;35-49;115;142;257;SEC_119
2020;624;25-34;55;42;97;SEC_624
2020;535;50-64;101;91;192;SEC_535
2020;245;35-49;137;145;282;SEC_245
2020;115;25-34;59;101;160;SEC_115
2020;323;03-11;66;89;155;SEC_323
2020;503;03-11;13;23;36;SEC_503
2020;423;75 i +;70;51;121;SEC_423
2020;226;65-74;93;66;159;SEC_226
2020;105;18-24;26;37;63;SEC_105
2020;513;00-02;18;29;47;SEC_513
2020;621;12-15;16;24;40;SEC_621
2020;301;35-49;153;158;311;SEC_301
2020;514;16-17;15;22;37;SEC_514
2020;503;75 i +;48;37;85;SEC_503
2020;329;65-74;38;41;79;SEC_329
2020;141;75 i +;15;10;25;SEC_141
2020;420;75 i +;122;70;192;SEC_420
2020;402;18-24;32;31;63;SEC_402
2020;426;00-02;19;11;30;SEC_426
2020;405;65-74;67;50;117;SEC_405
2020;213;03-11;50;38;88;SEC_213
2020;401;50-64;137;117;254;SEC_401
2020;212;03-11;60;69;129;SEC_212
2020;514;25-34;120;95;215;SEC_514
2020;504;75 i +;118;80;198;SEC_504
2020;418;16-17;12;16;28;SEC_418
2020;609;65-74;58;35;93;SEC_609
2020;420;35-49;233;286;519;SEC_420
2020;213;18-24;33;49;82;SEC_213
2020;507;75 i +;52;33;85;SEC_507
2020;248;50-64;129;113;242;SEC_248
2020;409;12-15;30;39;69;SEC_409
2020;104;50-64;94;98;192;SEC_104
2020;622;16-17;7;5;12;SEC_622
2020;307;12-15;22;15;37;SEC_307
2020;103;25-34;53;47;100;SEC_103
2020;118;03-11;51;69;120;SEC_118
2020;619;25-34;57;66;123;SEC_619
2020;525;50-64;78;78;156;SEC_525
2020;213;35-49;136;125;261;SEC_213
2020;217;03-11;62;61;123;SEC_217
2020;503;16-17;2;3;5;SEC_503
2020;328;65-74;29;21;50;SEC_328
2020;317;12-15;22;27;49;SEC_317
2020;110;35-49;131;124;255;SEC_110
2020;108;35-49;181;164;345;SEC_108
2020;430;65-74;33;23;56;SEC_430
2020;224;03-11;57;63;120;SEC_224
2020;409;18-24;82;82;164;SEC_409
2020;116;50-64;146;131;277;SEC_116
2020;129;12-15;15;23;38;SEC_129
2020;605;03-11;77;61;138;SEC_605
2020;246;50-64;101;103;204;SEC_246
2020;231;16-17;7;13;20;SEC_231
2020;523;65-74;53;38;91;SEC_523
2020;422;35-49;179;171;350;SEC_422
2020;301;16-17;14;15;29;SEC_301
2020;610;00-02;16;9;25;SEC_610
2020;205;35-49;106;87;193;SEC_205
2020;220;12-15;42;30;72;SEC_220
2020;122;00-02;14;13;27;SEC_122
2020;617;35-49;111;114;225;SEC_617
2020;214;16-17;20;25;45;SEC_214
2020;125;25-34;88;88;176;SEC_125
2020;617;16-17;6;17;23;SEC_617
2020;518;75 i +;88;48;136;SEC_518
2020;316;75 i +;104;65;169;SEC_316
2020;309;25-34;81;81;162;SEC_309
2020;209;18-24;48;46;94;SEC_209
2020;414;50-64;198;154;352;SEC_414
2020;123;25-34;83;83;166;SEC_123
2020;239;18-24;52;49;101;SEC_239
2020;626;50-64;75;88;163;SEC_626
2020;631;18-24;36;26;62;SEC_631
2020;112;12-15;23;29;52;SEC_112
2020;324;25-34;92;99;191;SEC_324
2020;129;65-74;56;41;97;SEC_129
2020;614;65-74;75;42;117;SEC_614
2020;612;25-34;55;54;109;SEC_612
2020;602;65-74;51;37;88;SEC_602
2020;248;00-02;11;15;26;SEC_248
2020;318;12-15;13;14;27;SEC_318
2020;436;03-11;67;75;142;SEC_436
2020;202;18-24;76;86;162;SEC_202
2020;140;50-64;122;98;220;SEC_140
2020;420;16-17;16;18;34;SEC_420
2020;426;65-74;39;33;72;SEC_426
2020;521;25-34;42;36;78;SEC_521
2020;441;03-11;70;81;151;SEC_441
2020;433;25-34;168;162;330;SEC_433
2020;433;12-15;41;40;81;SEC_433
2020;315;35-49;227;245;472;SEC_315
2020;124;25-34;71;65;136;SEC_124
2020;412;50-64;166;127;293;SEC_412
2020;405;12-15;40;23;63;SEC_405
2020;534;65-74;47;39;86;SEC_534
2020;504;35-49;126;125;251;SEC_504
2020;423;35-49;133;127;260;SEC_423
2020;138;25-34;33;45;78;SEC_138
2020;436;18-24;85;92;177;SEC_436
2020;528;12-15;27;34;61;SEC_528
2020;505;75 i +;124;120;244;SEC_505
2020;321;75 i +;137;100;237;SEC_321
2020;131;00-02;17;11;28;SEC_131
2020;201;35-49;261;271;532;SEC_201
2020;124;50-64;94;76;170;SEC_124
2020;109;75 i +;74;53;127;SEC_109
2020;420;00-02;16;39;55;SEC_420
2020;202;35-49;232;272;504;SEC_202
2020;416;03-11;64;83;147;SEC_416
2020;229;16-17;16;12;28;SEC_229
2020;223;35-49;166;176;342;SEC_223
2020;608;25-34;60;78;138;SEC_608
2020;221;00-02;25;32;57;SEC_221
2020;440;03-11;42;43;85;SEC_440
2020;123;12-15;13;22;35;SEC_123
2020;407;35-49;128;146;274;SEC_407
2020;232;16-17;9;12;21;SEC_232
2020;433;65-74;72;65;137;SEC_433
2020;105;75 i +;59;47;106;SEC_105
2020;201;03-11;92;102;194;SEC_201
2020;202;12-15;31;35;66;SEC_202
2020;431;00-02;28;27;55;SEC_431
2020;108;50-64;147;147;294;SEC_108
2020;216;18-24;56;58;114;SEC_216
2020;435;18-24;46;63;109;SEC_435
2020;318;65-74;53;47;100;SEC_318
2020;441;65-74;143;126;269;SEC_441
2020;321;00-02;21;17;38;SEC_321
2020;243;25-34;137;126;263;SEC_243
2020;305;25-34;123;104;227;SEC_305
2020;236;50-64;100;96;196;SEC_236
2020;140;65-74;52;35;87;SEC_140
2020;224;65-74;48;46;94;SEC_224
2020;611;35-49;227;240;467;SEC_611
2020;247;35-49;175;163;338;SEC_247
2020;108;18-24;66;54;120;SEC_108
2020;630;18-24;23;30;53;SEC_630
2020;508;35-49;205;194;399;SEC_508
2020;404;35-49;174;171;345;SEC_404
2020;405;25-34;154;124;278;SEC_405
2020;323;25-34;102;87;189;SEC_323
2020;311;00-02;16;25;41;SEC_311
2020;217;65-74;64;60;124;SEC_217
2020;316;00-02;16;21;37;SEC_316
2020;112;75 i +;91;50;141;SEC_112
2020;315;00-02;16;28;44;SEC_315
2020;618;25-34;45;54;99;SEC_618
2020;609;03-11;37;34;71;SEC_609
2020;129;00-02;6;12;18;SEC_129
2020;616;00-02;20;29;49;SEC_616
2020;101;16-17;21;22;43;SEC_101
2020;108;16-17;8;6;14;SEC_108
2020;237;75 i +;77;46;123;SEC_237
2020;517;16-17;13;25;38;SEC_517
2020;125;00-02;14;15;29;SEC_125
2020;607;03-11;38;33;71;SEC_607
2020;422;00-02;25;13;38;SEC_422
2020;418;03-11;73;62;135;SEC_418
2020;607;25-34;57;59;116;SEC_607
2020;513;65-74;43;38;81;SEC_513
2020;426;35-49;127;157;284;SEC_426
2020;327;00-02;14;12;26;SEC_327
2020;632;03-11;29;41;70;SEC_632
2020;622;25-34;31;41;72;SEC_622
2020;329;18-24;39;47;86;SEC_329
2020;240;35-49;239;224;463;SEC_240
2020;238;65-74;37;32;69;SEC_238
2020;226;75 i +;118;78;196;SEC_226
2020;621;65-74;143;112;255;SEC_621
2020;131;18-24;27;42;69;SEC_131
2020;229;03-11;85;102;187;SEC_229
2020;302;00-02;15;11;26;SEC_302
2020;416;35-49;211;176;387;SEC_416
2020;531;03-11;39;42;81;SEC_531
2020;427;18-24;66;75;141;SEC_427
2020;224;50-64;138;106;244;SEC_224
2020;316;35-49;185;224;409;SEC_316
2020;623;50-64;119;112;231;SEC_623
2020;307;00-02;11;8;19;SEC_307
2020;121;75 i +;60;29;89;SEC_121
2020;327;75 i +;44;33;77;SEC_327
2020;137;50-64;168;144;312;SEC_137
2020;106;12-15;24;22;46;SEC_106
2020;113;18-24;47;54;101;SEC_113
2020;605;18-24;49;44;93;SEC_605
2020;305;03-11;53;56;109;SEC_305
2020;217;25-34;122;120;242;SEC_217
2020;249;00-02;8;16;24;SEC_249
2020;123;75 i +;91;64;155;SEC_123
2020;207;00-02;13;32;45;SEC_207
2020;213;12-15;15;24;39;SEC_213
2020;530;12-15;25;49;74;SEC_530
2020;119;50-64;117;96;213;SEC_119
2020;104;16-17;2;12;14;SEC_104
2020;613;50-64;98;106;204;SEC_613
2020;501;03-11;24;31;55;SEC_501
2020;614;16-17;11;10;21;SEC_614
2020;209;16-17;10;13;23;SEC_209
2020;321;16-17;19;18;37;SEC_321
2020;127;35-49;96;82;178;SEC_127
2020;609;12-15;14;23;37;SEC_609
2020;606;16-17;13;10;23;SEC_606
2020;615;12-15;15;14;29;SEC_615
2020;402;75 i +;56;43;99;SEC_402
2020;204;25-34;127;123;250;SEC_204
2020;128;75 i +;66;41;107;SEC_128
2020;414;18-24;78;99;177;SEC_414
2020;141;00-02;37;44;81;SEC_141
2020;216;50-64;117;105;222;SEC_216
2020;302;12-15;23;16;39;SEC_302
2020;314;03-11;102;106;208;SEC_314
2020;328;50-64;100;118;218;SEC_328
2020;205;18-24;41;50;91;SEC_205
2020;513;50-64;134;137;271;SEC_513
2020;510;12-15;17;18;35;SEC_510
2020;224;16-17;12;8;20;SEC_224
2020;221;03-11;77;85;162;SEC_221
2020;618;75 i +;114;89;203;SEC_618
2020;240;03-11;93;73;166;SEC_240
2020;120;25-34;115;113;228;SEC_120
2020;210;35-49;106;88;194;SEC_210
2020;137;35-49;171;147;318;SEC_137
2020;112;00-02;18;22;40;SEC_112
2020;213;50-64;99;79;178;SEC_213
2020;207;16-17;15;21;36;SEC_207
2020;423;03-11;58;63;121;SEC_423
2020;537;18-24;61;48;109;SEC_537
2020;103;65-74;39;37;76;SEC_103
2020;236;00-02;13;7;20;SEC_236
2020;402;35-49;111;106;217;SEC_402
2020;113;25-34;109;124;233;SEC_113
2020;329;12-15;42;55;97;SEC_329
2020;245;75 i +;69;39;108;SEC_245
2020;126;25-34;58;48;106;SEC_126
2020;238;12-15;18;23;41;SEC_238
2020;425;65-74;38;30;68;SEC_425
2020;201;16-17;12;21;33;SEC_201
2020;538;16-17;15;20;35;SEC_538
2020;526;12-15;36;48;84;SEC_526
2020;125;35-49;193;193;386;SEC_125
2020;210;75 i +;77;43;120;SEC_210
2020;114;75 i +;124;89;213;SEC_114
2020;204;12-15;31;32;63;SEC_204
2020;619;00-02;15;5;20;SEC_619
2020;216;16-17;16;18;34;SEC_216
2020;435;03-11;69;64;133;SEC_435
2020;135;03-11;50;71;121;SEC_135
2020;307;25-34;64;77;141;SEC_307
2020;631;50-64;80;77;157;SEC_631
2020;108;75 i +;76;56;132;SEC_108
2020;202;75 i +;82;61;143;SEC_202
2020;305;18-24;63;69;132;SEC_305
2020;436;12-15;19;23;42;SEC_436
2020;226;35-49;239;223;462;SEC_226
2020;609;75 i +;74;69;143;SEC_609
2020;310;16-17;7;7;14;SEC_310
2020;538;35-49;168;162;330;SEC_538
2020;504;50-64;76;88;164;SEC_504
2020;124;03-11;32;27;59;SEC_124
2020;123;65-74;71;67;138;SEC_123
2020;128;50-64;86;89;175;SEC_128
2020;403;25-34;84;88;172;SEC_403
2020;626;03-11;31;37;68;SEC_626
2020;525;12-15;26;13;39;SEC_525
2020;221;35-49;235;283;518;SEC_221
2020;308;12-15;49;34;83;SEC_308
2020;524;12-15;27;29;56;SEC_524
2020;504;65-74;64;44;108;SEC_504
2020;242;50-64;122;116;238;SEC_242
2020;431;65-74;55;57;112;SEC_431
2020;532;35-49;171;180;351;SEC_532
2020;322;50-64;113;100;213;SEC_322
2020;246;25-34;102;104;206;SEC_246
2020;322;75 i +;80;43;123;SEC_322
2020;325;35-49;191;184;375;SEC_325
2020;139;75 i +;52;39;91;SEC_139
2020;233;25-34;90;98;188;SEC_233
2020;301;12-15;34;26;60;SEC_301
2020;104;75 i +;67;40;107;SEC_104
2020;249;35-49;133;138;271;SEC_249
2020;530;16-17;12;19;31;SEC_530
2020;404;75 i +;90;54;144;SEC_404
2020;418;25-34;111;112;223;SEC_418
2020;323;00-02;12;18;30;SEC_323
2020;418;35-49;172;177;349;SEC_418
2020;401;12-15;28;29;57;SEC_401
2020;501;50-64;99;102;201;SEC_501
2020;325;12-15;35;32;67;SEC_325
2020;401;75 i +;84;52;136;SEC_401
2020;314;12-15;37;43;80;SEC_314
2020;624;00-02;7;11;18;SEC_624
2020;523;18-24;58;57;115;SEC_523
2020;513;25-34;117;127;244;SEC_513
2020;205;12-15;16;18;34;SEC_205
2020;440;00-02;7;11;18;SEC_440
2020;309;03-11;58;67;125;SEC_309
2020;324;12-15;20;16;36;SEC_324
2020;221;75 i +;122;77;199;SEC_221
2020;319;03-11;70;90;160;SEC_319
2020;534;00-02;12;15;27;SEC_534
2020;303;00-02;14;22;36;SEC_303
2020;617;25-34;57;52;109;SEC_617
2020;622;12-15;13;15;28;SEC_622
2020;138;65-74;58;57;115;SEC_138
2020;402;25-34;86;74;160;SEC_402
2020;226;12-15;38;29;67;SEC_226
2020;125;18-24;43;63;106;SEC_125
2020;505;65-74;112;52;164;SEC_505
2020;105;25-34;64;78;142;SEC_105
2020;248;75 i +;67;44;111;SEC_248
2020;625;03-11;33;31;64;SEC_625
2020;630;75 i +;51;36;87;SEC_630
2020;523;00-02;24;20;44;SEC_523
2020;239;25-34;82;108;190;SEC_239
2020;234;03-11;41;40;81;SEC_234
2020;530;35-49;274;265;539;SEC_530
2020;217;16-17;15;19;34;SEC_217
2020;207;50-64;222;166;388;SEC_207
2020;318;50-64;108;86;194;SEC_318
2020;411;65-74;51;36;87;SEC_411
2020;605;35-49;168;172;340;SEC_605
2020;237;03-11;68;63;131;SEC_237
2020;104;35-49;124;115;239;SEC_104
2020;418;12-15;45;31;76;SEC_418
2020;503;18-24;19;21;40;SEC_503
2020;431;25-34;137;143;280;SEC_431
2020;324;35-49;158;183;341;SEC_324
2020;610;12-15;19;18;37;SEC_610
2020;247;25-34;106;109;215;SEC_247
2020;514;75 i +;98;53;151;SEC_514
2020;525;25-34;73;73;146;SEC_525
2020;510;65-74;60;35;95;SEC_510
2020;313;25-34;120;123;243;SEC_313
2020;404;50-64;135;128;263;SEC_404
2020;421;75 i +;97;73;170;SEC_421
2020;320;00-02;6;10;16;SEC_320
2020;524;16-17;14;11;25;SEC_524
2020;213;16-17;14;14;28;SEC_213
2020;421;12-15;25;25;50;SEC_421
2020;617;12-15;16;20;36;SEC_617
2020;430;00-02;24;14;38;SEC_430
2020;621;18-24;35;50;85;SEC_621
2020;507;00-02;13;12;25;SEC_507
2020;625;50-64;131;97;228;SEC_625
2020;220;35-49;242;210;452;SEC_220
2020;324;16-17;16;15;31;SEC_324
2020;327;25-34;77;72;149;SEC_327
2020;317;03-11;48;55;103;SEC_317
2020;201;25-34;131;128;259;SEC_201
2020;612;50-64;79;82;161;SEC_612
2020;234;35-49;138;153;291;SEC_234
2020;210;65-74;50;44;94;SEC_210
2020;234;00-02;12;13;25;SEC_234
2020;312;25-34;162;132;294;SEC_312
2020;209;35-49;144;121;265;SEC_209
2020;135;35-49;158;177;335;SEC_135
2020;537;00-02;14;7;21;SEC_537
2020;228;12-15;37;58;95;SEC_228
2020;221;16-17;18;21;39;SEC_221
2020;207;03-11;72;74;146;SEC_207
2020;528;00-02;13;20;33;SEC_528
2020;127;16-17;8;7;15;SEC_127
2020;430;18-24;42;60;102;SEC_430
2020;307;75 i +;116;74;190;SEC_307
2020;623;35-49;151;163;314;SEC_623
2020;323;18-24;67;70;137;SEC_323
2020;141;18-24;32;34;66;SEC_141
2020;619;18-24;36;42;78;SEC_619
2020;120;12-15;18;40;58;SEC_120
2020;105;65-74;87;70;157;SEC_105
2020;126;35-49;123;115;238;SEC_126
2020;303;16-17;16;10;26;SEC_303
2020;102;16-17;17;17;34;SEC_102
2020;533;65-74;74;51;125;SEC_533
2020;309;65-74;64;40;104;SEC_309
2020;501;00-02;9;6;15;SEC_501
2020;242;75 i +;75;57;132;SEC_242
2020;306;50-64;177;151;328;SEC_306
2020;128;65-74;53;40;93;SEC_128
2020;419;03-11;96;106;202;SEC_419
2020;322;00-02;16;21;37;SEC_322
2020;406;18-24;71;51;122;SEC_406
2020;133;50-64;90;84;174;SEC_133
2020;502;00-02;30;15;45;SEC_502
2020;524;65-74;45;42;87;SEC_524
2020;437;03-11;65;94;159;SEC_437
2020;407;00-02;12;14;26;SEC_407
2020;237;50-64;140;118;258;SEC_237
2020;239;00-02;14;15;29;SEC_239
2020;305;75 i +;75;54;129;SEC_305
2020;106;65-74;165;126;291;SEC_106
2020;124;35-49;98;92;190;SEC_124
2020;618;03-11;30;34;64;SEC_618
2020;617;00-02;7;7;14;SEC_617
2020;304;65-74;71;46;117;SEC_304
2020;410;12-15;32;23;55;SEC_410
2020;301;18-24;30;43;73;SEC_301
2020;534;35-49;130;133;263;SEC_534
2020;427;00-02;27;31;58;SEC_427
2020;220;18-24;57;61;118;SEC_220
2020;430;12-15;33;26;59;SEC_430
2020;245;18-24;43;51;94;SEC_245
2020;423;16-17;12;10;22;SEC_423
2020;538;12-15;19;30;49;SEC_538
2020;303;75 i +;158;117;275;SEC_303
2020;432;12-15;31;24;55;SEC_432
2020;520;16-17;5;12;17;SEC_520
2020;129;16-17;13;11;24;SEC_129
2020;435;35-49;136;173;309;SEC_435
2020;425;50-64;115;113;228;SEC_425
2020;611;16-17;23;19;42;SEC_611
2020;140;12-15;16;24;40;SEC_140
2020;530;18-24;58;70;128;SEC_530
2020;329;35-49;273;254;527;SEC_329
2020;238;35-49;129;140;269;SEC_238
2020;117;25-34;102;89;191;SEC_117
2020;320;00-02;10;16;26;SEC_320
2020;217;75 i +;71;44;115;SEC_217
2020;523;12-15;24;29;53;SEC_523
2020;314;35-49;287;297;584;SEC_314
2020;223;50-64;127;110;237;SEC_223
2020;210;03-11;29;31;60;SEC_210
2020;525;00-02;13;12;25;SEC_525
2020;535;00-02;7;6;13;SEC_535
2020;324;75 i +;44;25;69;SEC_324
2020;404;65-74;64;52;116;SEC_404
2020;422;25-34;98;95;193;SEC_422
2020;532;03-11;54;66;120;SEC_532
2020;217;18-24;54;65;119;SEC_217
2020;513;18-24;56;73;129;SEC_513
2020;326;12-15;35;30;65;SEC_326
2020;409;75 i +;118;87;205;SEC_409
2020;420;25-34;170;184;354;SEC_420
2020;233;35-49;146;144;290;SEC_233
2020;208;75 i +;209;104;313;SEC_208
2020;437;25-34;120;123;243;SEC_437
2020;534;12-15;14;21;35;SEC_534
2020;138;50-64;98;65;163;SEC_138
2020;236;18-24;28;40;68;SEC_236
2020;247;75 i +;73;48;121;SEC_247
2020;510;18-24;45;41;86;SEC_510
2020;103;16-17;5;5;10;SEC_103
2020;238;75 i +;52;38;90;SEC_238
2020;611;18-24;57;56;113;SEC_611
2020;302;25-34;102;96;198;SEC_302
2020;601;25-34;105;129;234;SEC_601
2020;437;18-24;70;92;162;SEC_437
2020;431;35-49;225;246;471;SEC_431
2020;127;12-15;17;19;36;SEC_127
2020;529;12-15;26;34;60;SEC_529
2020;440;12-15;15;16;31;SEC_440
2020;433;75 i +;62;40;102;SEC_433
2020;410;25-34;97;107;204;SEC_410
2020;232;12-15;9;22;31;SEC_232
2020;616;03-11;94;98;192;SEC_616
2020;513;03-11;78;92;170;SEC_513
2020;314;75 i +;96;74;170;SEC_314
2020;538;50-64;138;118;256;SEC_538
2020;140;00-02;11;14;25;SEC_140
2020;510;35-49;114;137;251;SEC_510
2020;513;75 i +;102;64;166;SEC_513
2020;430;25-34;98;94;192;SEC_430
2020;311;50-64;145;146;291;SEC_311
2020;325;18-24;59;68;127;SEC_325
2020;213;25-34;75;91;166;SEC_213
2020;507;18-24;23;44;67;SEC_507
2020;103;12-15;13;9;22;SEC_103
2020;616;35-49;256;226;482;SEC_616
2020;506;18-24;54;67;121;SEC_506
2020;315;75 i +;74;58;132;SEC_315
2020;518;12-15;26;22;48;SEC_518
2020;624;12-15;22;30;52;SEC_624
2020;125;50-64;154;160;314;SEC_125
2020;128;25-34;70;75;145;SEC_128
2020;310;18-24;34;31;65;SEC_310
2020;602;18-24;43;54;97;SEC_602
2020;138;12-15;8;15;23;SEC_138
2020;632;35-49;109;125;234;SEC_632
2020;312;03-11;69;65;134;SEC_312
2020;208;16-17;10;12;22;SEC_208
2020;243;00-02;18;19;37;SEC_243
2020;524;25-34;106;129;235;SEC_524
2020;216;25-34;104;91;195;SEC_216
2020;121;50-64;94;99;193;SEC_121
2020;242;12-15;12;26;38;SEC_242
2020;627;50-64;84;69;153;SEC_627
2020;613;65-74;69;28;97;SEC_613
2020;104;18-24;30;33;63;SEC_104
2020;102;12-15;31;25;56;SEC_102
2020;616;50-64;250;223;473;SEC_616
2020;404;12-15;35;21;56;SEC_404
2020;403;65-74;72;42;114;SEC_403
2020;308;65-74;126;114;240;SEC_308
2020;202;00-02;30;26;56;SEC_202
2020;610;18-24;39;50;89;SEC_610
2020;138;35-49;84;77;161;SEC_138
2020;616;18-24;84;101;185;SEC_616
2020;310;65-74;51;57;108;SEC_310
2020;321;25-34;116;158;274;SEC_321
2020;320;18-24;61;50;111;SEC_320
2020;320;75 i +;3;5;8;SEC_320
2020;406;12-15;16;30;46;SEC_406
2020;211;75 i +;77;41;118;SEC_211
2020;304;16-17;17;8;25;SEC_304
2020;503;00-02;3;4;7;SEC_503
2020;411;12-15;14;18;32;SEC_411
2020;303;35-49;206;205;411;SEC_303
2020;502;25-34;97;87;184;SEC_502
2020;120;65-74;117;108;225;SEC_120
2020;237;25-34;112;113;225;SEC_237
2020;211;65-74;33;31;64;SEC_211
2020;313;75 i +;107;75;182;SEC_313
2020;314;00-02;19;30;49;SEC_314
2020;217;12-15;20;24;44;SEC_217
2020;115;18-24;50;48;98;SEC_115
2020;625;00-02;11;6;17;SEC_625
2020;231;35-49;184;192;376;SEC_231
2020;436;00-02;24;34;58;SEC_436
2020;511;25-34;187;194;381;SEC_511
2020;505;25-34;68;54;122;SEC_505
2020;246;65-74;43;35;78;SEC_246
2020;416;18-24;60;61;121;SEC_416
2020;320;16-17;0;1;1;SEC_320
2020;538;00-02;9;15;24;SEC_538
2020;440;25-34;58;80;138;SEC_440
2020;601;03-11;67;87;154;SEC_601
2020;508;12-15;36;40;76;SEC_508
2020;311;03-11;73;89;162;SEC_311
2020;129;18-24;29;52;81;SEC_129
2020;611;03-11;74;83;157;SEC_611
2020;101;35-49;210;231;441;SEC_101
2020;140;03-11;52;44;96;SEC_140
2020;423;25-34;99;81;180;SEC_423
2020;631;35-49;114;108;222;SEC_631
2020;129;35-49;129;129;258;SEC_129
2020;625;12-15;13;19;32;SEC_625
2020;124;16-17;10;6;16;SEC_124
2020;108;03-11;62;67;129;SEC_108
2020;302;50-64;133;117;250;SEC_302
2020;441;16-17;22;24;46;SEC_441
2020;419;00-02;23;37;60;SEC_419
2020;205;16-17;9;11;20;SEC_205
2020;125;16-17;13;15;28;SEC_125
2020;325;03-11;51;67;118;SEC_325
2020;127;65-74;29;31;60;SEC_127
2020;242;18-24;49;64;113;SEC_242
2020;137;75 i +;76;68;144;SEC_137
2020;317;75 i +;40;24;64;SEC_317
2020;407;25-34;89;89;178;SEC_407
2020;329;03-11;105;118;223;SEC_329
2020;311;65-74;69;41;110;SEC_311
2020;401;16-17;15;10;25;SEC_401
2020;414;03-11;97;94;191;SEC_414
2020;612;65-74;48;33;81;SEC_612
2020;313;50-64;208;151;359;SEC_313
2020;611;65-74;66;46;112;SEC_611
2020;110;03-11;39;38;77;SEC_110
2020;435;50-64;96;118;214;SEC_435
2020;524;00-02;25;19;44;SEC_524
2020;528;65-74;49;36;85;SEC_528
2020;228;25-34;200;188;388;SEC_228
2020;314;16-17;17;21;38;SEC_314
2020;630;16-17;9;8;17;SEC_630
2020;433;35-49;223;225;448;SEC_433
2020;626;65-74;62;46;108;SEC_626
2020;304;18-24;45;52;97;SEC_304
2020;529;65-74;41;33;74;SEC_529
2020;626;35-49;104;101;205;SEC_626
2020;601;12-15;42;43;85;SEC_601
2020;329;75 i +;20;24;44;SEC_329
2020;538;75 i +;98;54;152;SEC_538
2020;125;65-74;105;77;182;SEC_125
2020;116;12-15;32;18;50;SEC_116
2020;607;75 i +;122;87;209;SEC_607
2020;104;65-74;41;30;71;SEC_104
2020;502;12-15;26;24;50;SEC_502
2020;623;12-15;33;33;66;SEC_623
2020;416;50-64;127;137;264;SEC_416
2020;518;65-74;49;38;87;SEC_518
2020;405;75 i +;148;87;235;SEC_405
2020;412;12-15;26;31;57;SEC_412
2020;113;65-74;136;119;255;SEC_113
2020;410;50-64;177;157;334;SEC_410
2020;623;75 i +;106;82;188;SEC_623
2020;440;16-17;14;9;23;SEC_440
2020;132;35-49;276;306;582;SEC_132
2020;511;65-74;85;50;135;SEC_511
2020;319;18-24;58;68;126;SEC_319
2020;618;50-64;138;119;257;SEC_618
2020;324;18-24;45;43;88;SEC_324
2020;404;25-34;107;103;210;SEC_404
2020;416;00-02;19;26;45;SEC_416
2020;508;00-02;20;25;45;SEC_508
2020;115;00-02;10;10;20;SEC_115
2020;621;16-17;14;16;30;SEC_621
2020;501;35-49;98;116;214;SEC_501
2020;626;12-15;14;14;28;SEC_626
2020;141;25-34;61;65;126;SEC_141
2020;326;16-17;15;9;24;SEC_326
2020;502;35-49;182;166;348;SEC_502
2020;327;50-64;144;125;269;SEC_327
2020;419;65-74;65;46;111;SEC_419
2020;221;65-74;80;59;139;SEC_221
2020;508;50-64;143;140;283;SEC_508
2020;501;18-24;40;38;78;SEC_501
2020;121;03-11;36;45;81;SEC_121
2020;617;75 i +;66;42;108;SEC_617
2020;106;35-49;179;183;362;SEC_106
2020;128;35-49;155;152;307;SEC_128
2020;229;50-64;184;178;362;SEC_229
2020;531;35-49;121;132;253;SEC_531
2020;609;25-34;41;36;77;SEC_609
2020;525;16-17;7;6;13;SEC_525
2020;131;65-74;114;94;208;SEC_131
2020;610;03-11;43;48;91;SEC_610
2020;121;12-15;12;22;34;SEC_121
2020;136;16-17;12;13;25;SEC_136
2020;240;18-24;72;74;146;SEC_240
2020;319;35-49;245;229;474;SEC_319
2020;437;16-17;15;21;36;SEC_437
2020;236;35-49;122;124;246;SEC_236
2020;618;35-49;84;90;174;SEC_618
2020;518;35-49;141;137;278;SEC_518
2020;613;25-34;56;59;115;SEC_613
2020;432;18-24;48;67;115;SEC_432
2020;326;75 i +;8;9;17;SEC_326
2020;632;18-24;39;27;66;SEC_632
2020;323;50-64;191;171;362;SEC_323
2020;111;12-15;14;18;32;SEC_111
2020;526;35-49;287;292;579;SEC_526
2020;238;25-34;83;102;185;SEC_238
2020;508;18-24;70;52;122;SEC_508
2020;301;03-11;53;48;101;SEC_301
2020;136;00-02;10;14;24;SEC_136
2020;316;03-11;54;83;137;SEC_316
2020;220;16-17;16;19;35;SEC_220
2020;115;75 i +;71;52;123;SEC_115
2020;436;65-74;50;56;106;SEC_436
2020;223;00-02;14;15;29;SEC_223
2020;521;00-02;11;11;22;SEC_521
2020;320;25-34;68;67;135;SEC_320
2020;511;35-49;296;312;608;SEC_511
2020;320;16-17;29;18;47;SEC_320
2020;318;25-34;38;49;87;SEC_318
2020;526;65-74;58;50;108;SEC_526
2020;229;65-74;53;33;86;SEC_229
2020;420;12-15;47;35;82;SEC_420
2020;205;75 i +;69;42;111;SEC_205
2020;303;50-64;131;127;258;SEC_303
2020;520;25-34;58;68;126;SEC_520
2020;131;50-64;120;112;232;SEC_131
2020;315;50-64;198;172;370;SEC_315
2020;202;50-64;164;163;327;SEC_202
2020;310;35-49;108;126;234;SEC_310
2020;325;16-17;18;15;33;SEC_325
2020;120;75 i +;67;57;124;SEC_120
2020;503;50-64;94;60;154;SEC_503
2020;329;00-02;21;30;51;SEC_329
2020;405;16-17;13;13;26;SEC_405
2020;205;00-02;11;5;16;SEC_205
2020;621;50-64;124;97;221;SEC_621
2020;601;00-02;21;12;33;SEC_601
2020;127;03-11;27;26;53;SEC_127
2020;126;18-24;44;37;81;SEC_126
2020;121;16-17;12;4;16;SEC_121
2020;139;12-15;14;20;34;SEC_139
2020;507;50-64;77;77;154;SEC_507
2020;221;25-34;166;171;337;SEC_221
2020;532;12-15;24;25;49;SEC_532
2020;607;16-17;12;4;16;SEC_607
2020;113;03-11;75;80;155;SEC_113
2020;411;00-02;10;9;19;SEC_411
2020;120;03-11;67;53;120;SEC_120
2020;414;00-02;29;26;55;SEC_414
2020;532;25-34;131;100;231;SEC_532
2020;133;03-11;38;32;70;SEC_133
2020;623;16-17;8;21;29;SEC_623
2020;220;25-34;163;157;320;SEC_220
2020;619;12-15;19;25;44;SEC_619
2020;423;65-74;41;34;75;SEC_423
2020;426;75 i +;41;24;65;SEC_426
2020;243;50-64;184;169;353;SEC_243
2020;606;12-15;26;20;46;SEC_606
2020;411;16-17;6;14;20;SEC_411
2020;619;03-11;49;50;99;SEC_619
2020;247;03-11;59;72;131;SEC_247
2020;211;50-64;132;113;245;SEC_211
2020;114;03-11;44;66;110;SEC_114
2020;623;25-34;64;62;126;SEC_623
2020;502;03-11;80;71;151;SEC_502
2020;426;25-34;90;84;174;SEC_426
2020;632;00-02;3;8;11;SEC_632
2020;505;18-24;22;27;49;SEC_505
2020;425;35-49;136;117;253;SEC_425
2020;441;12-15;33;37;70;SEC_441
2020;505;12-15;22;23;45;SEC_505
2020;521;75 i +;94;87;181;SEC_521
2020;537;75 i +;92;63;155;SEC_537
2020;441;00-02;25;23;48;SEC_441
2020;228;50-64;189;207;396;SEC_228
2020;107;35-49;183;201;384;SEC_107
2020;126;12-15;15;18;33;SEC_126
2020;231;18-24;68;77;145;SEC_231
2020;204;00-02;20;25;45;SEC_204
2020;229;12-15;32;54;86;SEC_229
2020;407;03-11;47;59;106;SEC_407
2020;325;50-64;212;170;382;SEC_325
2020;627;00-02;7;10;17;SEC_627
2020;613;00-02;15;11;26;SEC_613
2020;632;65-74;48;38;86;SEC_632
2020;514;03-11;55;60;115;SEC_514
2020;131;35-49;143;159;302;SEC_131
2020;440;75 i +;85;77;162;SEC_440
2020;405;18-24;91;99;190;SEC_405
2020;117;50-64;219;206;425;SEC_117
2020;249;16-17;7;8;15;SEC_249
2020;518;00-02;17;20;37;SEC_518
2020;128;12-15;19;26;45;SEC_128
2020;504;25-34;69;50;119;SEC_504
2020;119;12-15;21;20;41;SEC_119
2020;234;25-34;101;119;220;SEC_234
2020;109;00-02;10;7;17;SEC_109
2020;210;00-02;6;6;12;SEC_210
2020;238;00-02;13;15;28;SEC_238
2020;113;12-15;32;43;75;SEC_113
2020;131;12-15;21;26;47;SEC_131
2020;135;18-24;53;42;95;SEC_135
2020;312;35-49;259;265;524;SEC_312
2020;513;35-49;202;196;398;SEC_513
2020;614;35-49;98;107;205;SEC_614
2020;246;00-02;15;18;33;SEC_246
2020;402;00-02;15;16;31;SEC_402
2020;140;16-17;6;15;21;SEC_140
2020;606;75 i +;80;54;134;SEC_606
2020;421;50-64;132;117;249;SEC_421
2020;322;16-17;10;19;29;SEC_322
2020;212;18-24;70;73;143;SEC_212
2020;410;16-17;10;17;27;SEC_410
2020;246;03-11;64;47;111;SEC_246
2020;608;03-11;56;49;105;SEC_608
2020;123;16-17;13;13;26;SEC_123
2020;209;12-15;20;15;35;SEC_209
2020;615;03-11;32;29;61;SEC_615
2020;421;16-17;15;6;21;SEC_421
2020;245;50-64;100;108;208;SEC_245
2020;124;12-15;17;26;43;SEC_124
2020;407;65-74;41;22;63;SEC_407
2020;102;75 i +;149;118;267;SEC_102
2020;111;50-64;94;76;170;SEC_111
2020;233;00-02;17;10;27;SEC_233
2020;605;25-34;78;67;145;SEC_605
2020;224;18-24;52;52;104;SEC_224
2020;615;35-49;102;88;190;SEC_615
2020;510;25-34;69;74;143;SEC_510
2020;412;03-11;43;67;110;SEC_412
2020;518;18-24;40;47;87;SEC_518
2020;504;12-15;12;21;33;SEC_504
2020;518;16-17;7;12;19;SEC_518
2020;513;16-17;15;13;28;SEC_513
2020;521;18-24;21;27;48;SEC_521
2020;306;18-24;60;66;126;SEC_306
2020;236;65-74;44;30;74;SEC_236
2020;626;00-02;7;15;22;SEC_626
2020;121;00-02;6;18;24;SEC_121
2020;109;16-17;10;7;17;SEC_109
2020;402;50-64;90;79;169;SEC_402
2020;437;35-49;208;206;414;SEC_437
2020;133;16-17;5;8;13;SEC_133
2020;231;03-11;68;73;141;SEC_231
2020;112;35-49;206;192;398;SEC_112
2020;601;18-24;57;67;124;SEC_601
2020;130;75 i +;100;51;151;SEC_130
2020;322;12-15;39;31;70;SEC_322
2020;115;16-17;11;13;24;SEC_115
2020;304;50-64;149;156;305;SEC_304
2020;526;18-24;88;74;162;SEC_526
2020;329;50-64;150;146;296;SEC_329
2020;234;75 i +;59;40;99;SEC_234
2020;531;12-15;16;19;35;SEC_531
2020;534;18-24;33;43;76;SEC_534
2020;607;50-64;109;98;207;SEC_607
2020;608;18-24;47;43;90;SEC_608
2020;119;18-24;27;32;59;SEC_119
2020;436;35-49;191;223;414;SEC_436
2020;403;00-02;13;11;24;SEC_403
2020;325;00-02;14;13;27;SEC_325
2020;532;00-02;19;18;37;SEC_532
2020;135;50-64;161;148;309;SEC_135
2020;208;18-24;58;63;121;SEC_208
2020;401;00-02;16;10;26;SEC_401
2020;621;03-11;50;55;105;SEC_621
2020;319;00-02;18;26;44;SEC_319
2020;105;16-17;15;10;25;SEC_105
2020;416;12-15;27;39;66;SEC_416
2020;602;03-11;49;62;111;SEC_602
2020;613;35-49;139;132;271;SEC_613
2020;234;18-24;40;51;91;SEC_234
2020;209;50-64;137;101;238;SEC_209
2020;237;00-02;21;21;42;SEC_237
2020;127;50-64;103;85;188;SEC_127
2020;410;75 i +;160;108;268;SEC_410
2020;125;75 i +;82;72;154;SEC_125
2020;435;00-02;14;22;36;SEC_435
2020;412;75 i +;137;97;234;SEC_412
2020;115;65-74;84;68;152;SEC_115
2020;109;03-11;49;40;89;SEC_109
2020;116;18-24;60;55;115;SEC_116
2020;619;16-17;14;10;24;SEC_619
2020;401;25-34;104;99;203;SEC_401
2020;208;35-49;160;166;326;SEC_208
2020;111;35-49;82;87;169;SEC_111
2020;233;75 i +;58;26;84;SEC_233
2020;503;35-49;76;76;152;SEC_503
2020;214;75 i +;112;64;176;SEC_214
2020;248;65-74;45;40;85;SEC_248
2020;311;25-34;117;106;223;SEC_311
2020;325;75 i +;182;109;291;SEC_325
2020;612;16-17;7;12;19;SEC_612
2020;419;12-15;36;51;87;SEC_419
2020;117;12-15;35;38;73;SEC_117
2020;136;12-15;23;24;47;SEC_136
2020;414;16-17;14;16;30;SEC_414
2020;323;35-49;215;221;436;SEC_323
2020;610;16-17;12;12;24;SEC_610
2020;532;16-17;17;16;33;SEC_532
2020;228;03-11;115;92;207;SEC_228
2020;102;18-24;50;52;102;SEC_102
2020;224;75 i +;71;23;94;SEC_224
2020;626;25-34;45;47;92;SEC_626
2020;406;00-02;19;24;43;SEC_406
2020;414;12-15;47;43;90;SEC_414
2020;436;50-64;164;160;324;SEC_436
2020;212;75 i +;75;45;120;SEC_212
2020;610;50-64;106;96;202;SEC_610
2020;411;03-11;39;35;74;SEC_411
2020;109;18-24;43;37;80;SEC_109
2020;212;50-64;133;121;254;SEC_212
2020;129;03-11;33;51;84;SEC_129
2020;137;25-34;76;76;152;SEC_137
2020;234;65-74;32;18;50;SEC_234
2020;322;03-11;47;74;121;SEC_322
2020;214;00-02;35;29;64;SEC_214
2020;216;00-02;7;17;24;SEC_216
2020;510;50-64;113;110;223;SEC_510
2020;613;12-15;19;26;45;SEC_613
2020;315;65-74;93;93;186;SEC_315
2020;435;65-74;39;33;72;SEC_435
2020;138;03-11;28;28;56;SEC_138
2020;423;50-64;113;85;198;SEC_423
2020;121;25-34;53;53;106;SEC_121
2020;532;50-64;129;101;230;SEC_532
2020;622;00-02;11;4;15;SEC_622
2020;231;50-64;133;122;255;SEC_231
2020;622;50-64;87;87;174;SEC_622
2020;232;75 i +;78;51;129;SEC_232
2020;103;50-64;83;77;160;SEC_103
2020;229;35-49;261;266;527;SEC_229
2020;141;16-17;26;19;45;SEC_141
2020;113;50-64;172;151;323;SEC_113
2020;514;00-02;17;21;38;SEC_514
2020;114;65-74;100;77;177;SEC_114
2020;312;65-74;103;53;156;SEC_312
2020;214;35-49;319;321;640;SEC_214
2020;316;50-64;258;169;427;SEC_316
2020;409;16-17;16;26;42;SEC_409
2020;419;75 i +;116;62;178;SEC_419
2020;326;35-49;326;337;663;SEC_326
2020;211;03-11;68;64;132;SEC_211
2020;328;16-17;54;15;69;SEC_328
2020;420;50-64;226;208;434;SEC_420
2020;119;00-02;11;5;16;SEC_119
2020;208;00-02;12;13;25;SEC_208
2020;104;12-15;23;18;41;SEC_104
2020;617;03-11;36;52;88;SEC_617
2020;138;75 i +;57;44;101;SEC_138
2020;123;00-02;12;10;22;SEC_123
2020;228;18-24;92;106;198;SEC_228
2020;410;18-24;63;91;154;SEC_410
2020;441;25-34;147;135;282;SEC_441
2020;119;75 i +;118;82;200;SEC_119
2020;134;35-49;163;168;331;SEC_134
2020;119;03-11;41;30;71;SEC_119
2020;115;50-64;124;122;246;SEC_115
2020;523;16-17;16;16;32;SEC_523
2020;246;12-15;33;24;57;SEC_246
2020;437;50-64;171;146;317;SEC_437
2020;308;50-64;222;197;419;SEC_308
2020;247;18-24;57;49;106;SEC_247
2020;226;03-11;85;83;168;SEC_226
2020;523;35-49;192;194;386;SEC_523
2020;137;03-11;54;54;108;SEC_137
2020;627;03-11;24;34;58;SEC_627
2020;320;18-24;13;7;20;SEC_320
2020;533;16-17;14;21;35;SEC_533
2020;105;00-02;13;12;25;SEC_105
2020;107;12-15;25;28;53;SEC_107
2020;316;12-15;24;30;54;SEC_316
2020;422;65-74;46;36;82;SEC_422
2020;323;65-74;138;125;263;SEC_323
2020;108;00-02;23;15;38;SEC_108
2020;535;25-34;52;61;113;SEC_535
2020;506;25-34;83;96;179;SEC_506
2020;209;00-02;12;12;24;SEC_209
2020;520;75 i +;59;43;102;SEC_520
2020;112;25-34;118;99;217;SEC_112
2020;624;18-24;27;39;66;SEC_624
2020;427;12-15;36;46;82;SEC_427
2020;615;00-02;7;8;15;SEC_615
2020;306;65-74;89;81;170;SEC_306
2020;137;12-15;41;32;73;SEC_137
2020;618;65-74;76;50;126;SEC_618
2020;313;12-15;34;37;71;SEC_313
2020;224;00-02;14;13;27;SEC_224
2020;623;65-74;120;80;200;SEC_623
2020;247;16-17;17;10;27;SEC_247
2020;132;75 i +;123;87;210;SEC_132
2020;224;35-49;164;155;319;SEC_224
2020;313;16-17;19;20;39;SEC_313
2020;601;65-74;107;88;195;SEC_601
2020;134;65-74;67;58;125;SEC_134
2020;306;12-15;26;35;61;SEC_306
2020;608;16-17;16;14;30;SEC_608
2020;529;35-49;190;161;351;SEC_529
2020;630;12-15;9;13;22;SEC_630
2020;508;65-74;53;29;82;SEC_508
2020;223;25-34;117;109;226;SEC_223
2020;601;75 i +;170;130;300;SEC_601
2020;124;00-02;13;7;20;SEC_124
2020;422;75 i +;71;36;107;SEC_422
2020;122;25-34;62;52;114;SEC_122
2020;132;25-34;167;176;343;SEC_132
2020;320;65-74;5;6;11;SEC_320
2020;624;03-11;44;38;82;SEC_624
2020;110;16-17;8;11;19;SEC_110
2020;118;50-64;162;126;288;SEC_118
2020;402;65-74;32;24;56;SEC_402
2020;511;50-64;226;197;423;SEC_511
2020;226;00-02;17;18;35;SEC_226
2020;616;16-17;20;21;41;SEC_616
2020;110;75 i +;101;66;167;SEC_110
2020;521;12-15;15;12;27;SEC_521
2020;320;12-15;28;35;63;SEC_320
2020;129;50-64;104;100;204;SEC_129
2020;602;50-64;104;103;207;SEC_602
2020;308;25-34;103;128;231;SEC_308
2020;425;25-34;100;92;192;SEC_425
2020;220;65-74;64;46;110;SEC_220
2020;106;00-02;9;10;19;SEC_106
2020;117;03-11;57;65;122;SEC_117
2020;303;18-24;45;57;102;SEC_303
2020;318;18-24;29;29;58;SEC_318
2020;326;50-64;91;100;191;SEC_326
2020;326;18-24;36;31;67;SEC_326
2020;221;12-15;34;35;69;SEC_221
2020;133;75 i +;61;33;94;SEC_133
2020;607;18-24;32;34;66;SEC_607
2020;104;03-11;38;46;84;SEC_104
2020;223;65-74;51;36;87;SEC_223
2020;531;18-24;41;42;83;SEC_531
2020;301;75 i +;160;95;255;SEC_301
2020;207;12-15;34;27;61;SEC_207
2020;317;50-64;97;98;195;SEC_317
2020;613;03-11;46;46;92;SEC_613
2020;320;75 i +;73;61;134;SEC_320
2020;302;18-24;35;50;85;SEC_302
2020;234;16-17;9;5;14;SEC_234
2020;312;50-64;172;171;343;SEC_312
2020;521;65-74;107;62;169;SEC_521
2020;616;75 i +;83;43;126;SEC_616
2020;138;00-02;4;12;16;SEC_138
2020;102;25-34;64;61;125;SEC_102
2020;514;35-49;182;195;377;SEC_514
2020;304;03-11;103;112;215;SEC_304
2020;320;03-11;49;54;103;SEC_320
2020;117;00-02;26;22;48;SEC_117
2020;529;75 i +;86;59;145;SEC_529
2020;526;00-02;32;25;57;SEC_526
2020;220;75 i +;94;47;141;SEC_220
2020;305;00-02;12;18;30;SEC_305
2020;209;65-74;35;31;66;SEC_209
2020;204;75 i +;111;52;163;SEC_204
2020;111;16-17;3;6;9;SEC_111
2020;111;25-34;43;36;79;SEC_111
2020;403;12-15;17;20;37;SEC_403
2020;602;25-34;60;59;119;SEC_602
2020;612;75 i +;121;87;208;SEC_612
2020;129;25-34;69;56;125;SEC_129
2020;108;12-15;26;29;55;SEC_108
2020;404;00-02;21;14;35;SEC_404
2020;135;00-02;17;13;30;SEC_135
2020;607;65-74;41;25;66;SEC_607
2020;242;03-11;57;55;112;SEC_242
2020;505;03-11;34;37;71;SEC_505
2020;501;16-17;7;11;18;SEC_501
2020;501;75 i +;67;57;124;SEC_501
2020;245;03-11;57;58;115;SEC_245
2020;405;35-49;246;237;483;SEC_405
2020;249;25-34;90;96;186;SEC_249
2020;327;12-15;24;30;54;SEC_327
2020;623;18-24;43;45;88;SEC_623
2020;311;12-15;20;33;53;SEC_311
2020;312;12-15;26;37;63;SEC_312
2020;321;18-24;82;77;159;SEC_321
2020;412;65-74;101;79;180;SEC_412
2020;210;12-15;21;12;33;SEC_210
2020;528;16-17;11;11;22;SEC_528
2020;221;18-24;88;96;184;SEC_221
2020;212;65-74;58;45;103;SEC_212
2020;120;50-64;210;185;395;SEC_120
2020;226;25-34;134;167;301;SEC_226
2020;313;35-49;213;219;432;SEC_313
2020;623;00-02;8;14;22;SEC_623
2020;622;65-74;60;36;96;SEC_622
2020;117;65-74;143;111;254;SEC_117
2020;311;18-24;60;73;133;SEC_311
2020;246;16-17;20;13;33;SEC_246
2020;236;75 i +;84;48;132;SEC_236
2020;608;35-49;126;154;280;SEC_608
2020;226;18-24;71;82;153;SEC_226
2020;232;65-74;49;41;90;SEC_232
2020;239;75 i +;97;49;146;SEC_239
2020;310;12-15;16;25;41;SEC_310
2020;534;75 i +;69;56;125;SEC_534
2020;406;35-49;171;166;337;SEC_406
2020;141;50-64;96;120;216;SEC_141
2020;242;16-17;8;8;16;SEC_242
2020;502;16-17;12;17;29;SEC_502
2020;320;35-49;167;182;349;SEC_320
2020;318;75 i +;49;35;84;SEC_318
2020;106;50-64;197;147;344;SEC_106
2020;131;16-17;7;8;15;SEC_131
2020;207;35-49;250;241;491;SEC_207
2020;416;65-74;52;44;96;SEC_416
2020;507;12-15;14;17;31;SEC_507
2020;102;35-49;139;154;293;SEC_102
2020;511;00-02;28;33;61;SEC_511
2020;613;75 i +;141;102;243;SEC_613
2020;139;25-34;59;49;108;SEC_139
2020;611;50-64;169;179;348;SEC_611
2020;609;16-17;8;4;12;SEC_609
2020;111;18-24;29;29;58;SEC_111
2020;209;03-11;37;39;76;SEC_209
2020;432;50-64;112;111;223;SEC_432
2020;430;75 i +;61;34;95;SEC_430
2020;511;75 i +;147;95;242;SEC_511
2020;618;12-15;21;26;47;SEC_618
2020;627;18-24;29;19;48;SEC_627
2020;440;50-64;93;93;186;SEC_440
2020;135;75 i +;95;59;154;SEC_135
2020;135;12-15;20;18;38;SEC_135
2020;133;00-02;12;11;23;SEC_133
2020;135;65-74;102;85;187;SEC_135
2020;233;18-24;34;50;84;SEC_233
2020;107;16-17;18;21;39;SEC_107
2020;631;25-34;59;53;112;SEC_631
2020;611;00-02;15;14;29;SEC_611
2020;212;00-02;20;18;38;SEC_212
2020;518;03-11;46;47;93;SEC_518
2020;506;12-15;16;34;50;SEC_506
2020;631;00-02;9;8;17;SEC_631
2020;111;65-74;49;38;87;SEC_111
2020;223;03-11;62;59;121;SEC_223
2020;427;75 i +;88;33;121;SEC_427
2020;301;00-02;9;9;18;SEC_301
2020;530;03-11;83;107;190;SEC_530
2020;239;35-49;172;152;324;SEC_239
2020;528;03-11;49;51;100;SEC_528
2020;237;18-24;52;66;118;SEC_237
2020;607;12-15;12;19;31;SEC_607
2020;232;50-64;104;102;206;SEC_232
2020;607;35-49;96;116;212;SEC_607
2020;616;65-74;126;117;243;SEC_616
2020;606;00-02;5;19;24;SEC_606
2020;530;75 i +;99;55;154;SEC_530
2020;321;03-11;53;80;133;SEC_321
2020;249;03-11;45;39;84;SEC_249
2020;432;35-49;147;163;310;SEC_432
2020;414;75 i +;89;62;151;SEC_414
2020;301;25-34;80;91;171;SEC_301
2020;210;18-24;37;37;74;SEC_210
2020;441;18-24;67;72;139;SEC_441
2020;514;50-64;139;128;267;SEC_514
2020;130;65-74;38;23;61;SEC_130
2020;606;03-11;34;55;89;SEC_606
2020;511;12-15;48;47;95;SEC_511
2020;507;65-74;42;30;72;SEC_507
2020;309;35-49;191;200;391;SEC_309
2020;120;18-24;57;71;128;SEC_120
2020;240;25-34;165;165;330;SEC_240
2020;431;16-17;20;23;43;SEC_431
2020;622;18-24;19;37;56;SEC_622
2020;514;18-24;72;66;138;SEC_514
2020;431;50-64;137;119;256;SEC_431
2020;314;18-24;73;57;130;SEC_314
2020;302;35-49;179;178;357;SEC_302
2020;204;03-11;60;80;140;SEC_204
2020;302;65-74;128;93;221;SEC_302
2020;217;50-64;143;149;292;SEC_217
2020;119;25-34;54;59;113;SEC_119
2020;440;65-74;59;46;105;SEC_440
2020;537;25-34;87;97;184;SEC_537
2020;236;16-17;7;5;12;SEC_236
2020;139;35-49;97;104;201;SEC_139
2020;409;35-49;275;262;537;SEC_409
2020;116;65-74;112;79;191;SEC_116
2020;430;50-64;111;91;202;SEC_430
2020;321;12-15;41;35;76;SEC_321
2020;312;16-17;10;9;19;SEC_312
2020;504;18-24;36;34;70;SEC_504
2020;407;75 i +;77;38;115;SEC_407
2020;624;65-74;91;58;149;SEC_624
2020;216;65-74;75;53;128;SEC_216
2020;109;50-64;137;111;248;SEC_109
2020;101;25-34;97;99;196;SEC_101
2020;517;25-34;157;186;343;SEC_517
2020;207;75 i +;106;50;156;SEC_207
2020;324;65-74;43;33;76;SEC_324
2020;314;25-34;133;176;309;SEC_314
2020;431;75 i +;78;38;116;SEC_431
2020;118;16-17;17;9;26;SEC_118
2020;205;03-11;36;26;62;SEC_205
2020;423;12-15;21;18;39;SEC_423
2020;101;75 i +;58;48;106;SEC_101
2020;112;50-64;173;146;319;SEC_112
2020;103;75 i +;64;33;97;SEC_103
2020;606;50-64;105;103;208;SEC_606
2020;247;00-02;25;26;51;SEC_247
2020;320;50-64;156;139;295;SEC_320
2020;126;65-74;76;48;124;SEC_126
2020;133;35-49;102;107;209;SEC_133
2020;116;16-17;11;17;28;SEC_116
2020;140;75 i +;61;48;109;SEC_140
2020;140;35-49;125;125;250;SEC_140
2020;432;16-17;11;10;21;SEC_432
2020;310;03-11;52;40;92;SEC_310
2020;122;75 i +;92;56;148;SEC_122
2020;613;16-17;7;9;16;SEC_613
2020;211;12-15;27;18;45;SEC_211
2020;505;50-64;107;96;203;SEC_505
2020;125;12-15;42;35;77;SEC_125
2020;128;16-17;9;6;15;SEC_128
2020;118;18-24;56;37;93;SEC_118
2020;307;18-24;27;36;63;SEC_307
2020;630;25-34;41;30;71;SEC_630
2020;242;65-74;49;42;91;SEC_242
2020;107;03-11;70;47;117;SEC_107
2020;520;35-49;93;96;189;SEC_520
2020;321;50-64;264;215;479;SEC_321
2020;208;03-11;38;52;90;SEC_208
2020;537;12-15;24;23;47;SEC_537
2020;533;03-11;95;82;177;SEC_533
2020;411;25-34;70;57;127;SEC_411
2020;237;35-49;197;177;374;SEC_237
2020;427;16-17;15;14;29;SEC_427
2020;321;65-74;215;165;380;SEC_321
2020;137;65-74;100;60;160;SEC_137
2020;107;25-34;91;94;185;SEC_107
2020;301;50-64;140;114;254;SEC_301
2020;243;03-11;60;61;121;SEC_243
2020;140;18-24;42;43;85;SEC_140
2020;406;50-64;144;133;277;SEC_406
2020;104;25-34;49;46;95;SEC_104
2020;220;50-64;187;155;342;SEC_220
2020;232;18-24;53;47;100;SEC_232
2020;420;03-11;84;89;173;SEC_420
2020;508;25-34;137;117;254;SEC_508
2020;112;16-17;20;14;34;SEC_112
2020;535;16-17;10;8;18;SEC_535
2020;625;75 i +;92;62;154;SEC_625
2020;409;50-64;164;173;337;SEC_409
2020;120;00-02;15;15;30;SEC_120
2020;240;16-17;16;16;32;SEC_240
2020;201;75 i +;64;48;112;SEC_201
2020;409;65-74;84;62;146;SEC_409
2020;409;00-02;22;27;49;SEC_409
2020;529;16-17;15;13;28;SEC_529
2020;618;00-02;6;3;9;SEC_618
2020;624;50-64;84;92;176;SEC_624
2020;121;18-24;37;38;75;SEC_121
2020;615;16-17;9;2;11;SEC_615
2020;537;50-64;134;97;231;SEC_537
2020;610;25-34;55;78;133;SEC_610
2020;606;25-34;55;64;119;SEC_606
2020;127;00-02;9;4;13;SEC_127
2020;441;35-49;226;230;456;SEC_441
2020;608;50-64;150;138;288;SEC_608
2020;102;00-02;21;10;31;SEC_102
2020;233;03-11;38;62;100;SEC_233
2020;318;03-11;23;28;51;SEC_318
2020;128;03-11;38;49;87;SEC_128
2020;440;35-49;110;122;232;SEC_440
2020;103;35-49;96;106;202;SEC_103
2020;538;18-24;54;70;124;SEC_538
2020;617;65-74;61;40;101;SEC_617
2020;625;16-17;10;9;19;SEC_625
2020;136;35-49;153;162;315;SEC_136
2020;510;00-02;10;13;23;SEC_510
2020;407;16-17;7;13;20;SEC_407
2020;307;50-64;141;95;236;SEC_307
2020;113;00-02;17;15;32;SEC_113
2020;318;16-17;6;13;19;SEC_318
2020;328;25-34;90;89;179;SEC_328
2020;124;65-74;53;37;90;SEC_124
2020;524;50-64;137;116;253;SEC_524
2020;619;35-49;131;132;263;SEC_619
2020;437;00-02;34;21;55;SEC_437
2020;626;16-17;11;9;20;SEC_626
2020;115;03-11;52;51;103;SEC_115
2020;322;25-34;108;90;198;SEC_322
2020;217;00-02;25;23;48;SEC_217
2020;619;65-74;89;84;173;SEC_619
2020;239;03-11;42;30;72;SEC_239
2020;231;75 i +;74;32;106;SEC_231
2020;407;12-15;25;20;45;SEC_407
2020;245;25-34;94;95;189;SEC_245
2020;436;75 i +;77;47;124;SEC_436
2020;208;12-15;20;21;41;SEC_208
2020;103;00-02;10;13;23;SEC_103
2020;240;12-15;49;26;75;SEC_240
2020;137;00-02;14;16;30;SEC_137
2020;101;03-11;64;74;138;SEC_101
2020;537;35-49;162;151;313;SEC_537
2020;402;03-11;41;46;87;SEC_402
2020;249;65-74;39;32;71;SEC_249
2020;436;16-17;16;17;33;SEC_436
2020;601;16-17;19;24;43;SEC_601
2020;316;25-34;146;128;274;SEC_316
2020;605;75 i +;164;136;300;SEC_605
2020;208;65-74;122;87;209;SEC_208
2020;431;18-24;71;84;155;SEC_431
2020;212;35-49;196;191;387;SEC_212
2020;319;50-64;181;174;355;SEC_319
2020;216;12-15;29;35;64;SEC_216
2020;204;50-64;160;137;297;SEC_204
2020;117;16-17;12;14;26;SEC_117
2020;432;03-11;52;56;108;SEC_432
2020;526;50-64;178;162;340;SEC_526
2020;113;35-49;225;208;433;SEC_113
2020;247;65-74;57;49;106;SEC_247
2020;305;16-17;13;13;26;SEC_305
2020;141;35-49;345;336;681;SEC_141
2020;102;03-11;49;43;92;SEC_102
2020;606;35-49;127;113;240;SEC_606
2020;240;00-02;26;24;50;SEC_240
2020;127;25-34;49;50;99;SEC_127
2020;208;50-64;175;132;307;SEC_208
2020;123;35-49;143;122;265;SEC_123
2020;245;16-17;11;15;26;SEC_245
2020;214;25-34;205;190;395;SEC_214
2020;615;25-34;35;32;67;SEC_615
2020;323;16-17;18;23;41;SEC_323
2020;136;03-11;53;51;104;SEC_136
2020;614;00-02;3;11;14;SEC_614
2020;535;65-74;82;53;135;SEC_535
2020;630;35-49;92;98;190;SEC_630
2020;312;75 i +;129;85;214;SEC_312
2020;404;16-17;14;11;25;SEC_404
2020;610;35-49;117;96;213;SEC_610
2020;614;12-15;23;20;43;SEC_614
2020;101;12-15;38;36;74;SEC_101
2020;116;00-02;18;10;28;SEC_116
2020;520;50-64;92;74;166;SEC_520
2020;205;25-34;83;85;168;SEC_205
2020;419;50-64;185;221;406;SEC_419
2020;508;16-17;17;9;26;SEC_508
2020;624;75 i +;76;81;157;SEC_624
2020;621;25-34;68;56;124;SEC_621
2020;609;50-64;64;65;129;SEC_609
2020;248;35-49;164;164;328;SEC_248
2020;533;35-49;239;249;488;SEC_533
2020;106;03-11;52;70;122;SEC_106
2020;130;00-02;13;11;24;SEC_130
2020;401;18-24;45;62;107;SEC_401
2020;402;16-17;10;4;14;SEC_402
2020;538;25-34;89;87;176;SEC_538
2020;403;50-64;111;116;227;SEC_403
2020;309;50-64;112;103;215;SEC_309
2020;209;25-34;97;99;196;SEC_209
2020;520;18-24;31;39;70;SEC_520
2020;526;25-34;148;145;293;SEC_526
2020;320;12-15;7;3;10;SEC_320
2020;126;03-11;38;33;71;SEC_126
2020;109;35-49;118;119;237;SEC_109
2020;231;12-15;20;29;49;SEC_231
2020;421;35-49;148;152;300;SEC_421
2020;105;03-11;40;44;84;SEC_105
2020;202;16-17;12;10;22;SEC_202
2020;435;25-34;94;107;201;SEC_435
2020;623;03-11;51;58;109;SEC_623
2020;602;16-17;12;13;25;SEC_602
2020;518;50-64;99;98;197;SEC_518
2020;236;03-11;35;51;86;SEC_236
2020;118;25-34;94;88;182;SEC_118
2020;246;35-49;173;191;364;SEC_246
2020;419;25-34;164;174;338;SEC_419
2020;107;65-74;105;74;179;SEC_107
2020;135;25-34;98;93;191;SEC_135
2020;327;18-24;45;42;87;SEC_327
2020;630;50-64;80;66;146;SEC_630
2020;422;03-11;53;66;119;SEC_422
2020;119;65-74;125;93;218;SEC_119
2020;249;18-24;52;46;98;SEC_249
2020;122;50-64;75;82;157;SEC_122
2020;612;12-15;27;14;41;SEC_612
2020;233;65-74;24;17;41;SEC_233
2020;426;12-15;24;21;45;SEC_426
2020;210;25-34;57;51;108;SEC_210
2020;502;18-24;58;58;116;SEC_502
2020;243;35-49;195;211;406;SEC_243
2020;236;25-34;89;80;169;SEC_236
2020;136;25-34;72;66;138;SEC_136
2020;306;03-11;52;63;115;SEC_306
2020;141;12-15;61;80;141;SEC_141
2020;249;75 i +;66;33;99;SEC_249
2020;521;03-11;37;29;66;SEC_521
2020;207;65-74;81;65;146;SEC_207
2020;503;25-34;36;49;85;SEC_503
2020;617;18-24;27;30;57;SEC_617
2020;627;35-49;85;99;184;SEC_627
2020;324;03-11;60;59;119;SEC_324
2020;401;65-74;59;48;107;SEC_401
2020;313;03-11;82;71;153;SEC_313
2020;405;03-11;90;75;165;SEC_405
2020;319;16-17;26;20;46;SEC_319
2020;405;00-02;24;27;51;SEC_405
2020;427;65-74;49;40;89;SEC_427
2020;209;75 i +;70;42;112;SEC_209
2020;411;18-24;36;49;85;SEC_411
2020;207;18-24;79;81;160;SEC_207
2020;418;00-02;15;23;38;SEC_418
2020;229;25-34;149;172;321;SEC_229
2020;223;16-17;14;12;26;SEC_223
2020;113;75 i +;78;54;132;SEC_113
2020;113;16-17;12;17;29;SEC_113
2020;612;35-49;112;124;236;SEC_612
2020;139;03-11;23;28;51;SEC_139
2020;530;25-34;123;144;267;SEC_530
2020;242;25-34;90;106;196;SEC_242
2020;432;75 i +;79;56;135;SEC_432
2020;421;25-34;89;87;176;SEC_421
2020;518;25-34;75;88;163;SEC_518
2020;117;75 i +;109;80;189;SEC_117
2020;328;75 i +;30;10;40;SEC_328
2020;211;35-49;204;207;411;SEC_211
2020;228;00-02;27;23;50;SEC_228
2020;231;65-74;34;30;64;SEC_231
2020;531;65-74;39;30;69;SEC_531
2020;201;50-64;129;105;234;SEC_201
2020;501;12-15;11;15;26;SEC_501
2020;432;25-34;97;102;199;SEC_432
2020;302;03-11;63;56;119;SEC_302
2020;524;03-11;71;79;150;SEC_524
2020;419;16-17;22;25;47;SEC_419
2020;622;75 i +;45;28;73;SEC_622
2020;315;16-17;10;19;29;SEC_315
2020;523;75 i +;96;67;163;SEC_523
2020;131;25-34;80;62;142;SEC_131
2020;426;16-17;10;11;21;SEC_426
2020;141;65-74;24;22;46;SEC_141
2020;535;03-11;31;20;51;SEC_535
2020;627;25-34;31;44;75;SEC_627
2020;249;12-15;13;22;35;SEC_249
2020;412;18-24;63;71;134;SEC_412
2020;229;00-02;29;35;64;SEC_229
2020;141;03-11;147;158;305;SEC_141
2020;411;50-64;96;85;181;SEC_411
2020;204;65-74;64;56;120;SEC_204
2020;316;65-74;217;227;444;SEC_316
2020;531;00-02;13;20;33;SEC_531
2020;122;03-11;48;54;102;SEC_122
2020;306;16-17;23;10;33;SEC_306
2020;134;50-64;154;121;275;SEC_134
2020;310;00-02;16;7;23;SEC_310
2020;615;65-74;71;25;96;SEC_615
2020;211;25-34;113;147;260;SEC_211
2020;326;65-74;23;28;51;SEC_326
2020;135;16-17;10;14;24;SEC_135
2020;242;35-49;150;159;309;SEC_242
2020;630;65-74;82;61;143;SEC_630
2020;130;18-24;34;31;65;SEC_130
2020;312;18-24;62;64;126;SEC_312
2020;517;00-02;25;26;51;SEC_517
2020;320;50-64;23;29;52;SEC_320
2020;425;00-02;15;12;27;SEC_425
2020;110;12-15;19;14;33;SEC_110
2020;246;18-24;49;52;101;SEC_246
2020;609;00-02;10;6;16;SEC_609
2020;305;50-64;201;171;372;SEC_305
2020;524;18-24;63;81;144;SEC_524
2020;124;18-24;23;19;42;SEC_124
2020;243;75 i +;113;60;173;SEC_243
2020;504;03-11;30;44;74;SEC_504
2020;214;12-15;44;48;92;SEC_214
2020;245;65-74;48;29;77;SEC_245
2020;136;75 i +;78;39;117;SEC_136
2020;103;18-24;30;31;61;SEC_103
2020;237;12-15;30;34;64;SEC_237
2020;412;25-34;124;96;220;SEC_412
2020;316;16-17;13;16;29;SEC_316
2020;533;50-64;191;169;360;SEC_533
2020;631;03-11;33;46;79;SEC_631
2020;302;16-17;6;6;12;SEC_302
2020;608;65-74;69;57;126;SEC_608
2020;632;75 i +;62;36;98;SEC_632
2020;508;75 i +;82;48;130;SEC_508
2020;626;18-24;25;34;59;SEC_626
2020;322;35-49;193;190;383;SEC_322
2020;131;75 i +;92;62;154;SEC_131
2020;418;18-24;49;59;108;SEC_418
2020;403;16-17;16;6;22;SEC_403
2020;420;18-24;92;112;204;SEC_420
2020;239;16-17;17;12;29;SEC_239
2020;205;50-64;102;106;208;SEC_205
2020;625;65-74;123;120;243;SEC_625
2020;419;35-49;237;269;506;SEC_419
2020;411;35-49;111;115;226;SEC_411
2020;412;35-49;171;203;374;SEC_412
2020;308;00-02;22;14;36;SEC_308
2020;304;00-02;36;29;65;SEC_304
2020;130;16-17;9;7;16;SEC_130
2020;440;18-24;43;48;91;SEC_440
2020;111;00-02;3;7;10;SEC_111
2020;205;65-74;56;38;94;SEC_205
2020;126;16-17;12;9;21;SEC_126
2020;433;00-02;33;32;65;SEC_433
2020;507;03-11;37;38;75;SEC_507
2020;530;00-02;28;30;58;SEC_530
2020;520;03-11;35;39;74;SEC_520
2020;248;03-11;42;63;105;SEC_248
2020;426;18-24;41;41;82;SEC_426
2020;208;25-34;120;131;251;SEC_208
2020;237;16-17;9;22;31;SEC_237
2020;202;65-74;66;52;118;SEC_202
2020;211;00-02;26;16;42;SEC_211
2020;309;16-17;6;17;23;SEC_309
2020;303;03-11;59;63;122;SEC_303
2020;242;00-02;12;22;34;SEC_242
2020;422;16-17;9;17;26;SEC_422
2020;631;65-74;91;52;143;SEC_631
2020;246;75 i +;66;41;107;SEC_246
2020;316;18-24;51;61;112;SEC_316
2020;128;18-24;28;30;58;SEC_128
2020;501;65-74;114;90;204;SEC_501
2020;617;50-64;87;85;172;SEC_617
2020;302;75 i +;72;66;138;SEC_302
2020;310;50-64;108;81;189;SEC_310
2020;627;12-15;11;14;25;SEC_627
2020;126;75 i +;96;76;172;SEC_126
2020;627;65-74;109;83;192;SEC_627
2020;236;12-15;27;18;45;SEC_236
2020;131;03-11;56;47;103;SEC_131
2020;319;25-34;99;94;193;SEC_319
2020;137;18-24;57;57;114;SEC_137
2020;304;35-49;308;309;617;SEC_304
2020;538;03-11;62;49;111;SEC_538
2020;310;25-34;78;73;151;SEC_310
2020;216;35-49;165;183;348;SEC_216
2020;625;18-24;36;38;74;SEC_625
2020;506;03-11;53;53;106;SEC_506
2020;232;25-34;96;111;207;SEC_232
2020;132;16-17;17;13;30;SEC_132
2020;130;03-11;40;50;90;SEC_130
2020;243;65-74;48;46;94;SEC_243
2020;202;25-34;153;162;315;SEC_202
2020;130;25-34;58;58;116;SEC_130
2020;432;65-74;99;72;171;SEC_432
2020;318;00-02;6;5;11;SEC_318
2020;229;18-24;102;103;205;SEC_229
2020;114;12-15;20;21;41;SEC_114
2020;126;00-02;9;6;15;SEC_126
2020;507;35-49;104;105;209;SEC_507
2020;118;75 i +;82;74;156;SEC_118
2020;243;18-24;57;74;131;SEC_243
2020;313;00-02;17;20;37;SEC_313
2020;107;18-24;55;56;111;SEC_107
2020;224;12-15;25;32;57;SEC_224
2020;231;25-34;119;99;218;SEC_231
2020;120;35-49;172;181;353;SEC_120
2020;114;16-17;16;13;29;SEC_114
2020;106;25-34;81;78;159;SEC_106
2020;615;50-64;60;67;127;SEC_615
2020;311;16-17;8;11;19;SEC_311
2020;108;65-74;78;60;138;SEC_108
2020;210;50-64;77;80;157;SEC_210
2020;309;18-24;28;48;76;SEC_309
2020;521;35-49;94;95;189;SEC_521
2020;614;25-34;45;49;94;SEC_614
2020;301;65-74;76;61;137;SEC_301
2020;511;16-17;20;24;44;SEC_511
2020;112;65-74;106;98;204;SEC_112
2020;112;18-24;61;70;131;SEC_112
2020;416;75 i +;92;49;141;SEC_416
2020;102;65-74;114;80;194;SEC_102
2020;110;65-74;107;75;182;SEC_110
2020;501;25-34;43;43;86;SEC_501
2020;530;50-64;161;142;303;SEC_530
2020;122;18-24;29;33;62;SEC_122
2020;510;75 i +;77;49;126;SEC_510
2020;234;50-64;110;100;210;SEC_234
2020;409;25-34;142;162;304;SEC_409
2020;139;00-02;6;9;15;SEC_139
2020;243;12-15;31;34;65;SEC_243
2020;507;16-17;4;6;10;SEC_507
2020;134;18-24;50;56;106;SEC_134
2020;531;16-17;11;9;20;SEC_531
2020;410;00-02;21;14;35;SEC_410
2020;138;18-24;30;23;53;SEC_138
2020;533;12-15;36;38;74;SEC_533
2020;625;35-49;120;104;224;SEC_625
2020;319;12-15;42;60;102;SEC_319
2020;118;00-02;16;9;25;SEC_118
2020;110;25-34;53;58;111;SEC_110
2020;425;12-15;13;21;34;SEC_425
2020;311;75 i +;90;51;141;SEC_311
2020;433;50-64;194;176;370;SEC_433
2020;506;16-17;11;19;30;SEC_506
2020;308;18-24;76;91;167;SEC_308
2020;118;12-15;45;32;77;SEC_118
2020;105;50-64;129;85;214;SEC_105
2020;406;03-11;64;51;115;SEC_406
2020;610;75 i +;120;108;228;SEC_610
2020;423;18-24;44;47;91;SEC_423
2020;602;12-15;25;27;52;SEC_602
2020;317;65-74;28;33;61;SEC_317
2020;245;12-15;18;23;41;SEC_245
2020;328;00-02;34;39;73;SEC_328
2020;514;12-15;38;33;71;SEC_514
2020;421;65-74;58;39;97;SEC_421
2020;608;12-15;18;21;39;SEC_608
2020;311;35-49;203;234;437;SEC_311
2020;535;75 i +;91;79;170;SEC_535
2020;528;25-34;93;84;177;SEC_528
2020;221;50-64;191;186;377;SEC_221
2020;110;00-02;5;17;22;SEC_110
2020;116;25-34;76;70;146;SEC_116
2020;248;12-15;31;18;49;SEC_248
2020;529;03-11;51;51;102;SEC_529
2020;132;50-64;249;250;499;SEC_132
2020;602;75 i +;113;93;206;SEC_602
2020;118;65-74;155;123;278;SEC_118
2020;618;16-17;18;13;31;SEC_618
2020;403;18-24;35;51;86;SEC_403
2020;121;65-74;23;22;45;SEC_121
2020;436;25-34;123;136;259;SEC_436
2020;327;65-74;101;84;185;SEC_327
2020;134;75 i +;93;48;141;SEC_134
2020;426;03-11;59;54;113;SEC_426
2020;525;75 i +;68;35;103;SEC_525
2020;427;03-11;86;98;184;SEC_427
2020;517;65-74;62;59;121;SEC_517
2020;430;16-17;10;10;20;SEC_430
2020;114;50-64;157;138;295;SEC_114
2020;119;16-17;8;6;14;SEC_119
2020;326;25-34;96;82;178;SEC_326
2020;122;35-49;130;116;246;SEC_122
2020;248;18-24;56;63;119;SEC_248
2020;507;25-34;61;78;139;SEC_507
2020;223;75 i +;66;46;112;SEC_223
2020;232;35-49;156;156;312;SEC_232
2020;114;25-34;71;72;143;SEC_114
2020;216;03-11;60;61;121;SEC_216
2020;422;18-24;56;61;117;SEC_422
2020;223;12-15;23;33;56;SEC_223
2020;306;75 i +;80;53;133;SEC_306
2020;421;18-24;51;57;108;SEC_421
2020;423;00-02;24;17;41;SEC_423
2020;534;25-34;92;83;175;SEC_534
2020;213;75 i +;55;42;97;SEC_213
2020;431;03-11;101;92;193;SEC_431
2020;503;12-15;8;5;13;SEC_503
2020;608;75 i +;96;56;152;SEC_608
2020;207;25-34;151;144;295;SEC_207
2020;315;03-11;86;70;156;SEC_315
2020;136;18-24;38;48;86;SEC_136
2020;416;25-34;110;104;214;SEC_416
2020;211;18-24;55;82;137;SEC_211
2020;437;65-74;77;55;132;SEC_437
2020;111;03-11;31;18;49;SEC_111
2020;406;16-17;16;17;33;SEC_406
2020;526;75 i +;90;54;144;SEC_526
2020;303;25-34;98;74;172;SEC_303
2020;309;75 i +;53;32;85;SEC_309
2020;402;12-15;16;20;36;SEC_402
2020;323;75 i +;69;54;123;SEC_323
2020;319;65-74;89;68;157;SEC_319
2020;616;25-34;96;114;210;SEC_616
2020;414;25-34;155;158;313;SEC_414
2020;112;03-11;57;60;117;SEC_112
2020;327;35-49;141;136;277;SEC_327
2020;627;75 i +;60;66;126;SEC_627
2020;430;35-49;135;166;301;SEC_430
2020;433;18-24;77;87;164;SEC_433
2020;247;12-15;29;38;67;SEC_247
2020;216;75 i +;97;56;153;SEC_216
2020;134;03-11;62;60;122;SEC_134
2020;109;65-74;73;71;144;SEC_109
2020;324;00-02;19;7;26;SEC_324
2020;627;16-17;3;4;7;SEC_627
2020;106;18-24;48;54;102;SEC_106
2020;132;18-24;61;67;128;SEC_132
2020;327;03-11;38;64;102;SEC_327
2020;611;25-34;100;127;227;SEC_611
2020;229;75 i +;77;36;113;SEC_229
2020;403;75 i +;110;83;193;SEC_403
2020;132;00-02;26;35;61;SEC_132
2020;520;65-74;54;31;85;SEC_520
2020;233;50-64;107;73;180;SEC_233
2020;214;03-11;97;113;210;SEC_214
2020;632;12-15;19;25;44;SEC_632
2020;239;65-74;39;24;63;SEC_239
2020;133;18-24;27;28;55;SEC_133
2020;109;12-15;17;17;34;SEC_109
2020;622;35-49;98;92;190;SEC_622
2020;401;03-11;51;53;104;SEC_401
2020;433;16-17;24;20;44;SEC_433
2020;107;00-02;17;20;37;SEC_107
2020;520;12-15;23;12;35;SEC_520
2020;116;03-11;56;52;108;SEC_116
2020;328;35-49;304;277;581;SEC_328
2020;120;16-17;8;21;29;SEC_120
2020;531;25-34;98;94;192;SEC_531
2020;511;18-24;89;105;194;SEC_511
2020;326;03-11;130;141;271;SEC_326
2020;431;12-15;44;41;85;SEC_431
2020;517;03-11;99;120;219;SEC_517
2020;531;75 i +;49;31;80;SEC_531
2020;226;16-17;20;18;38;SEC_226
2020;425;16-17;7;14;21;SEC_425
2020;129;75 i +;109;55;164;SEC_129
2020;621;75 i +;86;65;151;SEC_621
2020;523;50-64;134;128;262;SEC_523
2020;607;00-02;13;7;20;SEC_607
2020;115;12-15;19;28;47;SEC_115
2020;441;50-64;238;190;428;SEC_441
2020;309;12-15;27;28;55;SEC_309
2020;139;16-17;7;8;15;SEC_139
2020;409;03-11;92;81;173;SEC_409
2020;427;35-49;251;241;492;SEC_427
2020;314;50-64;291;207;498;SEC_314
2020;421;00-02;13;9;22;SEC_421
2020;306;00-02;16;24;40;SEC_306
2020;418;50-64;131;151;282;SEC_418
2020;526;16-17;16;21;37;SEC_526
2020;134;16-17;11;19;30;SEC_134
2020;523;25-34;116;114;230;SEC_523
2020;128;00-02;12;14;26;SEC_128
2020;312;00-02;20;19;39;SEC_312
2020;116;75 i +;116;89;205;SEC_116
2020;110;18-24;30;31;61;SEC_110
2020;233;12-15;20;23;43;SEC_233
2020;317;18-24;41;58;99;SEC_317
2020;110;50-64;105;84;189;SEC_110
2020;204;18-24;77;70;147;SEC_204
2020;323;12-15;47;40;87;SEC_323
2020;426;50-64;102;105;207;SEC_426
2020;534;03-11;47;55;102;SEC_534
2020;506;00-02;12;8;20;SEC_506
2020;212;16-17;8;15;23;SEC_212
2020;201;12-15;34;33;67;SEC_201
2020;521;50-64;68;75;143;SEC_521
2020;533;18-24;80;77;157;SEC_533
2020;526;03-11;88;107;195;SEC_526
2020;517;50-64;232;194;426;SEC_517
2020;412;16-17;8;21;29;SEC_412
2020;247;50-64;116;108;224;SEC_247
2020;631;75 i +;91;77;168;SEC_631
2020;412;00-02;20;25;45;SEC_412
2020;401;35-49;147;126;273;SEC_401
2020;418;65-74;55;43;98;SEC_418
2020;132;65-74;141;127;268;SEC_132
2020;307;16-17;4;11;15;SEC_307
2020;505;35-49;127;126;253;SEC_505
2020;320;35-49;67;83;150;SEC_320
2020;202;03-11;66;85;151;SEC_202
2020;132;12-15;47;34;81;SEC_132
2020;228;35-49;335;314;649;SEC_228
2020;240;75 i +;98;65;163;SEC_240
2020;315;18-24;59;68;127;SEC_315
2020;602;35-49;148;132;280;SEC_602
2020;305;12-15;30;35;65;SEC_305
2020;632;25-34;37;47;84;SEC_632
2020;525;03-11;41;54;95;SEC_525
2020;511;03-11;104;123;227;SEC_511
2020;610;65-74;85;44;129;SEC_610
2020;437;75 i +;113;73;186;SEC_437
2020;612;00-02;7;10;17;SEC_612
2020;125;03-11;50;67;117;SEC_125
2020;503;65-74;78;61;139;SEC_503
2020;136;50-64;117;102;219;SEC_136
2020;238;16-17;11;7;18;SEC_238
2020;317;25-34;102;98;200;SEC_317
2020;308;35-49;223;204;427;SEC_308
2020;108;25-34;106;95;201;SEC_108
2020;505;16-17;6;7;13;SEC_505
2020;307;03-11;50;42;92;SEC_307
2020;114;18-24;50;46;96;SEC_114
2020;508;03-11;67;76;143;SEC_508
2020;220;00-02;20;29;49;SEC_220
2020;619;50-64;134;120;254;SEC_619
2020;621;00-02;11;15;26;SEC_621
2020;322;18-24;60;50;110;SEC_322
2020;517;12-15;52;36;88;SEC_517
2020;421;03-11;52;57;109;SEC_421
2020;101;50-64;199;185;384;SEC_101
2020;201;18-24;36;60;96;SEC_201
2020;139;50-64;83;104;187;SEC_139
2020;303;12-15;24;34;58;SEC_303
2020;329;25-34;77;69;146;SEC_329
2020;136;65-74;73;67;140;SEC_136
2020;228;65-74;71;51;122;SEC_228
2020;134;25-34;79;83;162;SEC_134
2020;533;75 i +;128;66;194;SEC_533
2020;201;65-74;54;37;91;SEC_201
2020;325;25-34;90;92;182;SEC_325
2020;123;18-24;40;52;92;SEC_123
2020;435;12-15;21;37;58;SEC_435
2020;123;50-64;152;137;289;SEC_123
2020;213;65-74;54;34;88;SEC_213
2020;609;35-49;100;96;196;SEC_609
2020;504;16-17;6;9;15;SEC_504
2020;318;35-49;71;74;145;SEC_318
2020;322;65-74;59;58;117;SEC_322
2020;315;25-34;108;117;225;SEC_315
2020;201;00-02;19;45;64;SEC_201
2020;624;35-49;101;121;222;SEC_624
