AnyPadro;Seccio;GrupEdat;Dones;Homes;Total;IdSeccio
2017;223;75 i +;63;39;102;SEC_223
2017;425;65-74;45;30;75;SEC_425
2017;224;75 i +;71;32;103;SEC_224
2017;114;50-64;145;113;258;SEC_114
2017;315;35-49;249;253;502;SEC_315
2017;234;35-49;144;142;286;SEC_234
2017;504;35-49;131;133;264;SEC_504
2017;403;12-15;25;15;40;SEC_403
2017;109;50-64;134;112;246;SEC_109
2017;123;18-24;31;49;80;SEC_123
2017;304;75 i +;123;58;181;SEC_304
2017;302;16-17;6;8;14;SEC_302
2017;243;50-64;171;159;330;SEC_243
2017;123;00-02;11;11;22;SEC_123
2017;423;03-11;40;39;79;SEC_423
2017;126;75 i +;80;70;150;SEC_126
2017;402;16-17;8;9;17;SEC_402
2017;238;65-74;40;34;74;SEC_238
2017;304;50-64;211;215;426;SEC_304
2017;123;25-34;77;63;140;SEC_123
2017;320;16-17;16;16;32;SEC_320
2017;139;75 i +;46;29;75;SEC_139
2017;517;18-24;91;100;191;SEC_517
2017;426;12-15;16;23;39;SEC_426
2017;411;00-02;7;13;20;SEC_411
2017;242;03-11;49;56;105;SEC_242
2017;514;12-15;27;31;58;SEC_514
2017;502;25-34;90;100;190;SEC_502
2017;324;65-74;47;31;78;SEC_324
2017;627;75 i +;48;42;90;SEC_627
2017;513;18-24;58;64;122;SEC_513
2017;606;16-17;9;12;21;SEC_606
2017;127;00-02;9;8;17;SEC_127
2017;134;25-34;82;86;168;SEC_134
2017;307;75 i +;102;61;163;SEC_307
2017;514;16-17;7;18;25;SEC_514
2017;625;12-15;21;23;44;SEC_625
2017;619;25-34;42;63;105;SEC_619
2017;248;75 i +;69;45;114;SEC_248
2017;616;03-11;115;107;222;SEC_616
2017;618;16-17;12;15;27;SEC_618
2017;220;50-64;179;159;338;SEC_220
2017;320;25-34;25;31;56;SEC_320
2017;216;25-34;80;88;168;SEC_216
2017;325;12-15;36;38;74;SEC_325
2017;211;12-15;19;36;55;SEC_211
2017;101;65-74;81;84;165;SEC_101
2017;437;18-24;60;77;137;SEC_437
2017;140;35-49;126;134;260;SEC_140
2017;111;00-02;5;5;10;SEC_111
2017;125;03-11;70;79;149;SEC_125
2017;619;03-11;44;53;97;SEC_619
2017;302;35-49;178;191;369;SEC_302
2017;118;35-49;181;187;368;SEC_118
2017;523;50-64;116;117;233;SEC_523
2017;113;75 i +;62;50;112;SEC_113
2017;123;12-15;20;24;44;SEC_123
2017;102;50-64;149;133;282;SEC_102
2017;325;16-17;10;15;25;SEC_325
2017;111;03-11;30;19;49;SEC_111
2017;242;65-74;64;42;106;SEC_242
2017;404;35-49;156;168;324;SEC_404
2017;247;50-64;121;106;227;SEC_247
2017;238;12-15;12;19;31;SEC_238
2017;236;25-34;76;91;167;SEC_236
2017;237;65-74;52;49;101;SEC_237
2017;613;18-24;27;39;66;SEC_613
2017;234;18-24;42;52;94;SEC_234
2017;520;35-49;90;93;183;SEC_520
2017;105;50-64;128;105;233;SEC_105
2017;525;03-11;49;42;91;SEC_525
2017;228;35-49;301;316;617;SEC_228
2017;535;25-34;54;47;101;SEC_535
2017;615;18-24;22;22;44;SEC_615
2017;320;75 i +;63;43;106;SEC_320
2017;246;12-15;27;25;52;SEC_246
2017;508;75 i +;80;49;129;SEC_508
2017;316;35-49;169;179;348;SEC_316
2017;321;18-24;69;73;142;SEC_321
2017;606;65-74;53;30;83;SEC_606
2017;317;00-02;15;15;30;SEC_317
2017;630;18-24;16;32;48;SEC_630
2017;625;75 i +;72;53;125;SEC_625
2017;423;65-74;47;36;83;SEC_423
2017;524;65-74;50;38;88;SEC_524
2017;440;03-11;42;52;94;SEC_440
2017;102;65-74;130;115;245;SEC_102
2017;124;16-17;7;7;14;SEC_124
2017;506;25-34;96;101;197;SEC_506
2017;307;12-15;13;15;28;SEC_307
2017;626;16-17;5;12;17;SEC_626
2017;111;65-74;68;44;112;SEC_111
2017;425;75 i +;74;45;119;SEC_425
2017;124;50-64;92;74;166;SEC_124
2017;313;50-64;198;165;363;SEC_313
2017;324;03-11;59;71;130;SEC_324
2017;321;00-02;21;36;57;SEC_321
2017;610;75 i +;84;93;177;SEC_610
2017;228;25-34;193;185;378;SEC_228
2017;526;03-11;85;92;177;SEC_526
2017;627;35-49;92;99;191;SEC_627
2017;524;35-49;164;190;354;SEC_524
2017;211;16-17;10;18;28;SEC_211
2017;117;12-15;31;35;66;SEC_117
2017;128;65-74;64;42;106;SEC_128
2017;243;18-24;52;79;131;SEC_243
2017;436;50-64;144;138;282;SEC_436
2017;111;12-15;11;18;29;SEC_111
2017;205;18-24;33;44;77;SEC_205
2017;313;12-15;37;42;79;SEC_313
2017;132;25-34;131;144;275;SEC_132
2017;318;00-02;6;8;14;SEC_318
2017;611;12-15;42;32;74;SEC_611
2017;502;50-64;137;133;270;SEC_502
2017;533;65-74;85;60;145;SEC_533
2017;613;50-64;74;78;152;SEC_613
2017;605;12-15;30;27;57;SEC_605
2017;407;16-17;8;13;21;SEC_407
2017;609;50-64;55;58;113;SEC_609
2017;228;65-74;96;60;156;SEC_228
2017;105;18-24;30;27;57;SEC_105
2017;316;00-02;24;24;48;SEC_316
2017;110;18-24;22;28;50;SEC_110
2017;127;65-74;27;23;50;SEC_127
2017;237;35-49;169;178;347;SEC_237
2017;312;03-11;56;70;126;SEC_312
2017;114;25-34;68;60;128;SEC_114
2017;607;18-24;27;45;72;SEC_607
2017;121;25-34;44;52;96;SEC_121
2017;325;50-64;210;151;361;SEC_325
2017;239;75 i +;89;50;139;SEC_239
2017;243;00-02;24;16;40;SEC_243
2017;440;18-24;41;34;75;SEC_440
2017;319;03-11;89;116;205;SEC_319
2017;127;18-24;25;22;47;SEC_127
2017;119;16-17;4;7;11;SEC_119
2017;140;25-34;74;54;128;SEC_140
2017;111;16-17;7;10;17;SEC_111
2017;617;35-49;115;122;237;SEC_617
2017;618;50-64;108;103;211;SEC_618
2017;602;35-49;155;143;298;SEC_602
2017;228;12-15;41;57;98;SEC_228
2017;427;65-74;48;33;81;SEC_427
2017;239;50-64;112;98;210;SEC_239
2017;134;35-49;169;178;347;SEC_134
2017;204;25-34;140;133;273;SEC_204
2017;320;25-34;64;68;132;SEC_320
2017;306;35-49;203;184;387;SEC_306
2017;124;75 i +;49;41;90;SEC_124
2017;605;50-64;146;111;257;SEC_605
2017;419;65-74;72;49;121;SEC_419
2017;101;12-15;75;81;156;SEC_101
2017;622;50-64;81;83;164;SEC_622
2017;314;25-34;145;168;313;SEC_314
2017;115;00-02;11;14;25;SEC_115
2017;525;18-24;42;34;76;SEC_525
2017;534;03-11;40;51;91;SEC_534
2017;624;35-49;102;135;237;SEC_624
2017;243;35-49;187;197;384;SEC_243
2017;120;50-64;208;184;392;SEC_120
2017;237;00-02;17;20;37;SEC_237
2017;314;12-15;32;42;74;SEC_314
2017;224;12-15;22;19;41;SEC_224
2017;511;75 i +;145;95;240;SEC_511
2017;229;35-49;251;260;511;SEC_229
2017;119;75 i +;101;71;172;SEC_119
2017;112;18-24;55;55;110;SEC_112
2017;624;03-11;46;45;91;SEC_624
2017;627;03-11;25;37;62;SEC_627
2017;532;50-64;111;83;194;SEC_532
2017;238;50-64;68;65;133;SEC_238
2017;404;16-17;12;19;31;SEC_404
2017;104;25-34;46;50;96;SEC_104
2017;410;03-11;50;44;94;SEC_410
2017;432;25-34;73;93;166;SEC_432
2017;122;12-15;21;16;37;SEC_122
2017;324;25-34;83;63;146;SEC_324
2017;112;25-34;95;99;194;SEC_112
2017;521;35-49;88;112;200;SEC_521
2017;232;75 i +;75;48;123;SEC_232
2017;103;75 i +;53;31;84;SEC_103
2017;528;18-24;56;40;96;SEC_528
2017;309;16-17;5;14;19;SEC_309
2017;117;65-74;122;108;230;SEC_117
2017;232;35-49;128;133;261;SEC_232
2017;631;18-24;28;26;54;SEC_631
2017;621;35-49;154;190;344;SEC_621
2017;511;03-11;85;101;186;SEC_511
2017;423;75 i +;75;59;134;SEC_423
2017;436;25-34;108;115;223;SEC_436
2017;324;75 i +;39;28;67;SEC_324
2017;140;50-64;93;74;167;SEC_140
2017;245;65-74;57;29;86;SEC_245
2017;305;65-74;86;78;164;SEC_305
2017;119;03-11;43;37;80;SEC_119
2017;618;18-24;38;56;94;SEC_618
2017;234;03-11;45;38;83;SEC_234
2017;534;16-17;11;7;18;SEC_534
2017;211;25-34;101;131;232;SEC_211
2017;609;35-49;103;95;198;SEC_609
2017;236;18-24;44;37;81;SEC_236
2017;303;18-24;42;50;92;SEC_303
2017;309;65-74;46;41;87;SEC_309
2017;136;50-64;124;94;218;SEC_136
2017;614;50-64;76;75;151;SEC_614
2017;326;65-74;18;12;30;SEC_326
2017;134;00-02;18;18;36;SEC_134
2017;239;12-15;16;14;30;SEC_239
2017;326;35-49;227;277;504;SEC_326
2017;627;50-64;105;80;185;SEC_627
2017;211;00-02;15;23;38;SEC_211
2017;105;16-17;4;11;15;SEC_105
2017;242;35-49;148;154;302;SEC_242
2017;607;65-74;62;27;89;SEC_607
2017;403;00-02;15;13;28;SEC_403
2017;119;00-02;20;10;30;SEC_119
2017;409;35-49;220;240;460;SEC_409
2017;302;18-24;37;45;82;SEC_302
2017;425;18-24;36;47;83;SEC_425
2017;135;65-74;83;79;162;SEC_135
2017;513;00-02;24;36;60;SEC_513
2017;131;65-74;120;118;238;SEC_131
2017;530;03-11;75;95;170;SEC_530
2017;528;00-02;13;15;28;SEC_528
2017;134;75 i +;97;44;141;SEC_134
2017;229;75 i +;85;50;135;SEC_229
2017;229;16-17;22;18;40;SEC_229
2017;627;00-02;8;11;19;SEC_627
2017;108;50-64;154;138;292;SEC_108
2017;125;00-02;17;18;35;SEC_125
2017;632;00-02;11;17;28;SEC_632
2017;627;25-34;43;54;97;SEC_627
2017;233;03-11;46;46;92;SEC_233
2017;207;75 i +;107;57;164;SEC_207
2017;108;75 i +;93;55;148;SEC_108
2017;511;16-17;13;19;32;SEC_511
2017;404;18-24;47;63;110;SEC_404
2017;626;25-34;50;40;90;SEC_626
2017;138;25-34;38;54;92;SEC_138
2017;301;75 i +;158;101;259;SEC_301
2017;410;75 i +;160;110;270;SEC_410
2017;139;18-24;39;43;82;SEC_139
2017;123;50-64;138;120;258;SEC_123
2017;528;65-74;53;43;96;SEC_528
2017;609;75 i +;49;46;95;SEC_609
2017;501;75 i +;45;41;86;SEC_501
2017;237;03-11;71;61;132;SEC_237
2017;107;35-49;181;205;386;SEC_107
2017;248;50-64;124;115;239;SEC_248
2017;425;16-17;5;10;15;SEC_425
2017;104;35-49;116;112;228;SEC_104
2017;212;75 i +;78;50;128;SEC_212
2017;312;75 i +;102;67;169;SEC_312
2017;202;35-49;238;275;513;SEC_202
2017;525;00-02;14;22;36;SEC_525
2017;601;16-17;13;19;32;SEC_601
2017;402;00-02;13;14;27;SEC_402
2017;201;50-64;108;98;206;SEC_201
2017;412;25-34;98;85;183;SEC_412
2017;302;12-15;15;11;26;SEC_302
2017;406;75 i +;77;64;141;SEC_406
2017;624;25-34;51;44;95;SEC_624
2017;108;25-34;112;92;204;SEC_108
2017;426;75 i +;47;29;76;SEC_426
2017;517;35-49;257;298;555;SEC_517
2017;202;03-11;60;79;139;SEC_202
2017;309;00-02;14;18;32;SEC_309
2017;119;18-24;26;34;60;SEC_119
2017;416;50-64;121;110;231;SEC_416
2017;231;16-17;22;15;37;SEC_231
2017;507;50-64;81;74;155;SEC_507
2017;208;75 i +;210;120;330;SEC_208
2017;121;50-64;85;86;171;SEC_121
2017;102;35-49;160;167;327;SEC_102
2017;104;50-64;77;83;160;SEC_104
2017;103;00-02;14;11;25;SEC_103
2017;102;25-34;65;69;134;SEC_102
2017;615;16-17;10;4;14;SEC_615
2017;505;16-17;6;6;12;SEC_505
2017;321;25-34;128;125;253;SEC_321
2017;431;65-74;53;52;105;SEC_431
2017;632;50-64;85;73;158;SEC_632
2017;224;00-02;22;27;49;SEC_224
2017;240;12-15;29;32;61;SEC_240
2017;237;25-34;115;109;224;SEC_237
2017;325;75 i +;185;95;280;SEC_325
2017;405;65-74;79;57;136;SEC_405
2017;102;03-11;55;48;103;SEC_102
2017;207;25-34;153;131;284;SEC_207
2017;320;65-74;85;77;162;SEC_320
2017;125;35-49;212;223;435;SEC_125
2017;613;25-34;48;49;97;SEC_613
2017;623;03-11;52;51;103;SEC_623
2017;248;35-49;156;164;320;SEC_248
2017;320;75 i +;1;4;5;SEC_320
2017;247;18-24;45;37;82;SEC_247
2017;303;75 i +;150;119;269;SEC_303
2017;510;25-34;77;85;162;SEC_510
2017;406;25-34;105;93;198;SEC_406
2017;622;12-15;11;12;23;SEC_622
2017;411;65-74;64;43;107;SEC_411
2017;221;35-49;261;268;529;SEC_221
2017;441;25-34;163;156;319;SEC_441
2017;608;12-15;32;27;59;SEC_608
2017;138;16-17;6;6;12;SEC_138
2017;122;35-49;122;113;235;SEC_122
2017;311;50-64;124;129;253;SEC_311
2017;124;12-15;18;15;33;SEC_124
2017;210;35-49;97;86;183;SEC_210
2017;109;16-17;7;15;22;SEC_109
2017;412;00-02;8;17;25;SEC_412
2017;432;00-02;15;12;27;SEC_432
2017;422;50-64;104;107;211;SEC_422
2017;223;16-17;10;12;22;SEC_223
2017;403;50-64;108;111;219;SEC_403
2017;606;75 i +;84;67;151;SEC_606
2017;113;25-34;92;101;193;SEC_113
2017;104;75 i +;74;42;116;SEC_104
2017;210;16-17;7;6;13;SEC_210
2017;313;03-11;76;78;154;SEC_313
2017;128;03-11;37;57;94;SEC_128
2017;309;18-24;32;36;68;SEC_309
2017;511;18-24;91;99;190;SEC_511
2017;326;00-02;46;55;101;SEC_326
2017;425;00-02;12;10;22;SEC_425
2017;615;65-74;100;51;151;SEC_615
2017;138;03-11;19;30;49;SEC_138
2017;129;03-11;38;58;96;SEC_129
2017;532;18-24;51;52;103;SEC_532
2017;430;12-15;24;17;41;SEC_430
2017;607;03-11;36;40;76;SEC_607
2017;133;25-34;58;45;103;SEC_133
2017;621;75 i +;57;49;106;SEC_621
2017;115;50-64;115;130;245;SEC_115
2017;212;18-24;60;62;122;SEC_212
2017;513;75 i +;104;58;162;SEC_513
2017;327;03-11;49;60;109;SEC_327
2017;504;75 i +;98;78;176;SEC_504
2017;521;16-17;8;6;14;SEC_521
2017;139;12-15;11;18;29;SEC_139
2017;110;50-64;115;91;206;SEC_110
2017;126;35-49;110;110;220;SEC_126
2017;217;35-49;183;212;395;SEC_217
2017;326;50-64;41;66;107;SEC_326
2017;532;25-34;108;99;207;SEC_532
2017;614;00-02;11;10;21;SEC_614
2017;315;65-74;78;86;164;SEC_315
2017;320;00-02;8;4;12;SEC_320
2017;310;75 i +;41;22;63;SEC_310
2017;136;00-02;15;15;30;SEC_136
2017;606;50-64;85;91;176;SEC_606
2017;128;35-49;152;155;307;SEC_128
2017;423;12-15;23;20;43;SEC_423
2017;505;12-15;17;13;30;SEC_505
2017;324;18-24;34;42;76;SEC_324
2017;208;65-74;129;82;211;SEC_208
2017;209;75 i +;74;50;124;SEC_209
2017;323;65-74;122;133;255;SEC_323
2017;304;12-15;82;47;129;SEC_304
2017;217;75 i +;63;45;108;SEC_217
2017;226;65-74;87;75;162;SEC_226
2017;616;00-02;26;25;51;SEC_616
2017;248;25-34;111;108;219;SEC_248
2017;207;03-11;77;74;151;SEC_207
2017;243;16-17;14;14;28;SEC_243
2017;535;12-15;12;16;28;SEC_535
2017;138;12-15;12;6;18;SEC_138
2017;505;75 i +;95;93;188;SEC_505
2017;535;75 i +;71;70;141;SEC_535
2017;427;18-24;84;74;158;SEC_427
2017;238;25-34;84;86;170;SEC_238
2017;229;18-24;98;66;164;SEC_229
2017;505;35-49;134;125;259;SEC_505
2017;423;35-49;132;133;265;SEC_423
2017;437;12-15;31;33;64;SEC_437
2017;609;00-02;11;10;21;SEC_609
2017;619;35-49;128;132;260;SEC_619
2017;308;50-64;214;206;420;SEC_308
2017;517;12-15;43;36;79;SEC_517
2017;441;00-02;35;23;58;SEC_441
2017;322;65-74;58;59;117;SEC_322
2017;508;18-24;63;64;127;SEC_508
2017;613;35-49;134;147;281;SEC_613
2017;301;03-11;161;158;319;SEC_301
2017;139;65-74;58;57;115;SEC_139
2017;422;18-24;50;57;107;SEC_422
2017;208;35-49;170;152;322;SEC_208
2017;204;16-17;11;14;25;SEC_204
2017;524;50-64;105;83;188;SEC_524
2017;315;12-15;31;40;71;SEC_315
2017;314;50-64;278;242;520;SEC_314
2017;246;50-64;103;102;205;SEC_246
2017;610;50-64;86;86;172;SEC_610
2017;420;18-24;96;87;183;SEC_420
2017;626;50-64;71;75;146;SEC_626
2017;209;03-11;33;37;70;SEC_209
2017;404;03-11;70;68;138;SEC_404
2017;403;16-17;7;5;12;SEC_403
2017;120;00-02;25;19;44;SEC_120
2017;530;16-17;14;16;30;SEC_530
2017;223;18-24;69;54;123;SEC_223
2017;318;35-49;84;73;157;SEC_318
2017;626;18-24;31;29;60;SEC_626
2017;213;35-49;125;115;240;SEC_213
2017;503;00-02;4;8;12;SEC_503
2017;501;00-02;14;7;21;SEC_501
2017;118;65-74;138;142;280;SEC_118
2017;311;35-49;195;216;411;SEC_311
2017;137;18-24;52;54;106;SEC_137
2017;207;12-15;31;27;58;SEC_207
2017;602;18-24;46;51;97;SEC_602
2017;317;18-24;39;49;88;SEC_317
2017;421;12-15;28;20;48;SEC_421
2017;229;03-11;70;89;159;SEC_229
2017;214;35-49;313;320;633;SEC_214
2017;511;12-15;42;48;90;SEC_511
2017;209;16-17;8;7;15;SEC_209
2017;139;16-17;10;10;20;SEC_139
2017;109;25-34;69;66;135;SEC_109
2017;246;16-17;6;9;15;SEC_246
2017;612;35-49;109;142;251;SEC_612
2017;532;16-17;14;9;23;SEC_532
2017;129;65-74;69;47;116;SEC_129
2017;436;18-24;75;70;145;SEC_436
2017;507;75 i +;49;25;74;SEC_507
2017;101;50-64;239;239;478;SEC_101
2017;617;03-11;33;55;88;SEC_617
2017;205;00-02;11;12;23;SEC_205
2017;302;50-64;135;103;238;SEC_302
2017;209;18-24;33;31;64;SEC_209
2017;420;12-15;43;36;79;SEC_420
2017;201;03-11;74;95;169;SEC_201
2017;618;75 i +;93;83;176;SEC_618
2017;104;65-74;47;32;79;SEC_104
2017;103;18-24;21;22;43;SEC_103
2017;402;65-74;33;25;58;SEC_402
2017;122;50-64;57;56;113;SEC_122
2017;327;12-15;24;26;50;SEC_327
2017;422;65-74;51;32;83;SEC_422
2017;418;03-11;76;51;127;SEC_418
2017;602;16-17;12;20;32;SEC_602
2017;615;03-11;30;32;62;SEC_615
2017;236;00-02;11;13;24;SEC_236
2017;216;65-74;76;61;137;SEC_216
2017;530;12-15;23;25;48;SEC_530
2017;107;12-15;26;39;65;SEC_107
2017;427;75 i +;90;47;137;SEC_427
2017;234;75 i +;64;38;102;SEC_234
2017;122;00-02;19;16;35;SEC_122
2017;207;35-49;245;237;482;SEC_207
2017;248;18-24;37;54;91;SEC_248
2017;231;75 i +;87;37;124;SEC_231
2017;140;75 i +;62;51;113;SEC_140
2017;320;03-11;13;4;17;SEC_320
2017;420;35-49;224;279;503;SEC_420
2017;621;65-74;142;133;275;SEC_621
2017;314;03-11;92;103;195;SEC_314
2017;508;35-49;182;188;370;SEC_508
2017;249;75 i +;67;38;105;SEC_249
2017;605;18-24;51;49;100;SEC_605
2017;320;35-49;38;49;87;SEC_320
2017;242;12-15;13;18;31;SEC_242
2017;116;12-15;24;22;46;SEC_116
2017;204;65-74;68;52;120;SEC_204
2017;534;75 i +;67;52;119;SEC_534
2017;204;75 i +;110;62;172;SEC_204
2017;611;50-64;143;150;293;SEC_611
2017;416;00-02;21;26;47;SEC_416
2017;106;12-15;31;27;58;SEC_106
2017;305;25-34;139;103;242;SEC_305
2017;236;50-64;85;80;165;SEC_236
2017;441;50-64;245;199;444;SEC_441
2017;111;25-34;49;31;80;SEC_111
2017;224;25-34;123;99;222;SEC_224
2017;533;18-24;77;74;151;SEC_533
2017;531;03-11;37;45;82;SEC_531
2017;518;75 i +;88;55;143;SEC_518
2017;307;65-74;128;115;243;SEC_307
2017;116;75 i +;104;88;192;SEC_116
2017;601;75 i +;142;121;263;SEC_601
2017;510;18-24;46;29;75;SEC_510
2017;110;35-49;125;121;246;SEC_110
2017;440;16-17;5;11;16;SEC_440
2017;616;65-74;124;102;226;SEC_616
2017;319;35-49;255;258;513;SEC_319
2017;529;16-17;12;23;35;SEC_529
2017;435;65-74;37;30;67;SEC_435
2017;212;65-74;64;47;111;SEC_212
2017;127;12-15;14;16;30;SEC_127
2017;247;00-02;15;19;34;SEC_247
2017;301;18-24;87;90;177;SEC_301
2017;530;35-49;250;251;501;SEC_530
2017;501;18-24;31;29;60;SEC_501
2017;114;03-11;52;61;113;SEC_114
2017;320;50-64;118;119;237;SEC_320
2017;135;12-15;14;26;40;SEC_135
2017;618;12-15;35;27;62;SEC_618
2017;137;16-17;15;17;32;SEC_137
2017;614;18-24;23;35;58;SEC_614
2017;302;25-34;101;89;190;SEC_302
2017;518;25-34;66;64;130;SEC_518
2017;423;00-02;17;25;42;SEC_423
2017;606;12-15;19;19;38;SEC_606
2017;505;65-74;153;92;245;SEC_505
2017;534;18-24;33;39;72;SEC_534
2017;314;65-74;137;127;264;SEC_314
2017;432;75 i +;85;56;141;SEC_432
2017;533;12-15;37;32;69;SEC_533
2017;610;00-02;11;12;23;SEC_610
2017;204;50-64;145;135;280;SEC_204
2017;537;65-74;83;60;143;SEC_537
2017;135;50-64;161;141;302;SEC_135
2017;623;50-64;111;114;225;SEC_623
2017;310;00-02;14;14;28;SEC_310
2017;207;16-17;10;19;29;SEC_207
2017;514;03-11;52;74;126;SEC_514
2017;418;25-34;89;101;190;SEC_418
2017;105;03-11;48;57;105;SEC_105
2017;612;03-11;44;34;78;SEC_612
2017;416;75 i +;96;50;146;SEC_416
2017;502;35-49;180;190;370;SEC_502
2017;304;03-11;194;234;428;SEC_304
2017;237;18-24;43;55;98;SEC_237
2017;245;16-17;16;11;27;SEC_245
2017;416;18-24;62;62;124;SEC_416
2017;202;12-15;30;29;59;SEC_202
2017;432;03-11;52;53;105;SEC_432
2017;404;12-15;26;21;47;SEC_404
2017;245;50-64;96;98;194;SEC_245
2017;409;65-74;85;75;160;SEC_409
2017;123;03-11;44;50;94;SEC_123
2017;412;03-11;44;66;110;SEC_412
2017;131;12-15;11;23;34;SEC_131
2017;243;75 i +;109;68;177;SEC_243
2017;209;00-02;9;20;29;SEC_209
2017;530;65-74;67;34;101;SEC_530
2017;304;65-74;88;72;160;SEC_304
2017;504;18-24;25;28;53;SEC_504
2017;401;03-11;38;57;95;SEC_401
2017;612;16-17;7;13;20;SEC_612
2017;112;35-49;210;201;411;SEC_112
2017;301;35-49;423;418;841;SEC_301
2017;529;12-15;22;23;45;SEC_529
2017;121;18-24;40;29;69;SEC_121
2017;614;16-17;10;4;14;SEC_614
2017;140;18-24;31;44;75;SEC_140
2017;221;12-15;33;37;70;SEC_221
2017;210;18-24;34;30;64;SEC_210
2017;207;18-24;71;74;145;SEC_207
2017;245;18-24;47;52;99;SEC_245
2017;120;35-49;187;182;369;SEC_120
2017;507;00-02;9;14;23;SEC_507
2017;118;03-11;69;76;145;SEC_118
2017;437;35-49;210;195;405;SEC_437
2017;531;65-74;44;25;69;SEC_531
2017;529;75 i +;96;61;157;SEC_529
2017;528;16-17;12;17;29;SEC_528
2017;135;75 i +;92;54;146;SEC_135
2017;101;75 i +;68;44;112;SEC_101
2017;535;35-49;91;88;179;SEC_535
2017;507;65-74;56;44;100;SEC_507
2017;132;50-64;243;218;461;SEC_132
2017;213;03-11;44;49;93;SEC_213
2017;216;16-17;15;13;28;SEC_216
2017;233;25-34;79;78;157;SEC_233
2017;601;03-11;73;90;163;SEC_601
2017;406;03-11;57;56;113;SEC_406
2017;305;75 i +;82;46;128;SEC_305
2017;621;00-02;20;24;44;SEC_621
2017;503;18-24;27;27;54;SEC_503
2017;526;35-49;280;275;555;SEC_526
2017;401;35-49;121;110;231;SEC_401
2017;422;00-02;12;20;32;SEC_422
2017;109;12-15;19;13;32;SEC_109
2017;106;16-17;11;14;25;SEC_106
2017;212;03-11;62;62;124;SEC_212
2017;441;75 i +;118;80;198;SEC_441
2017;427;00-02;29;30;59;SEC_427
2017;223;65-74;60;36;96;SEC_223
2017;108;00-02;16;17;33;SEC_108
2017;119;12-15;15;20;35;SEC_119
2017;211;65-74;43;37;80;SEC_211
2017;410;00-02;25;21;46;SEC_410
2017;530;18-24;70;75;145;SEC_530
2017;630;75 i +;41;32;73;SEC_630
2017;208;18-24;45;54;99;SEC_208
2017;534;65-74;57;47;104;SEC_534
2017;617;12-15;17;19;36;SEC_617
2017;524;16-17;8;13;21;SEC_524
2017;127;75 i +;41;33;74;SEC_127
2017;517;75 i +;97;61;158;SEC_517
2017;137;12-15;42;24;66;SEC_137
2017;426;65-74;42;34;76;SEC_426
2017;319;25-34;92;91;183;SEC_319
2017;111;75 i +;68;47;115;SEC_111
2017;407;18-24;43;32;75;SEC_407
2017;627;65-74;97;87;184;SEC_627
2017;510;75 i +;77;42;119;SEC_510
2017;433;35-49;229;222;451;SEC_433
2017;619;18-24;33;42;75;SEC_619
2017;518;03-11;51;48;99;SEC_518
2017;101;03-11;181;200;381;SEC_101
2017;625;65-74;109;96;205;SEC_625
2017;533;16-17;24;15;39;SEC_533
2017;130;25-34;56;73;129;SEC_130
2017;433;16-17;19;15;34;SEC_433
2017;249;65-74;47;35;82;SEC_249
2017;411;25-34;70;66;136;SEC_411
2017;505;03-11;38;45;83;SEC_505
2017;507;16-17;9;14;23;SEC_507
2017;221;16-17;15;16;31;SEC_221
2017;103;12-15;12;12;24;SEC_103
2017;321;75 i +;128;88;216;SEC_321
2017;313;75 i +;91;73;164;SEC_313
2017;510;16-17;11;6;17;SEC_510
2017;441;16-17;16;23;39;SEC_441
2017;630;00-02;18;10;28;SEC_630
2017;232;03-11;43;52;95;SEC_232
2017;208;00-02;15;28;43;SEC_208
2017;226;50-64;193;148;341;SEC_226
2017;309;75 i +;48;27;75;SEC_309
2017;630;12-15;13;8;21;SEC_630
2017;133;03-11;41;39;80;SEC_133
2017;521;12-15;8;21;29;SEC_521
2017;533;75 i +;130;78;208;SEC_533
2017;237;12-15;19;30;49;SEC_237
2017;310;12-15;16;18;34;SEC_310
2017;416;65-74;55;54;109;SEC_416
2017;243;03-11;61;73;134;SEC_243
2017;421;65-74;67;44;111;SEC_421
2017;612;18-24;28;46;74;SEC_612
2017;320;00-02;6;19;25;SEC_320
2017;622;16-17;3;10;13;SEC_622
2017;131;50-64;126;123;249;SEC_131
2017;327;18-24;43;47;90;SEC_327
2017;507;35-49;107;109;216;SEC_507
2017;416;35-49;187;180;367;SEC_416
2017;317;03-11;58;58;116;SEC_317
2017;409;25-34;141;157;298;SEC_409
2017;422;16-17;9;10;19;SEC_422
2017;109;35-49;129;132;261;SEC_109
2017;609;12-15;12;15;27;SEC_609
2017;208;25-34;129;115;244;SEC_208
2017;212;25-34;108;110;218;SEC_212
2017;128;75 i +;60;42;102;SEC_128
2017;432;35-49;139;152;291;SEC_432
2017;537;03-11;49;53;102;SEC_537
2017;129;35-49;126;135;261;SEC_129
2017;632;35-49;107;132;239;SEC_632
2017;621;16-17;9;15;24;SEC_621
2017;441;12-15;38;35;73;SEC_441
2017;421;03-11;41;57;98;SEC_421
2017;502;18-24;49;57;106;SEC_502
2017;228;50-64;174;174;348;SEC_228
2017;611;65-74;98;64;162;SEC_611
2017;110;75 i +;81;57;138;SEC_110
2017;210;03-11;27;29;56;SEC_210
2017;302;00-02;16;18;34;SEC_302
2017;323;16-17;18;22;40;SEC_323
2017;616;50-64;227;213;440;SEC_616
2017;105;75 i +;59;45;104;SEC_105
2017;305;12-15;30;24;54;SEC_305
2017;301;25-34;142;171;313;SEC_301
2017;104;00-02;17;17;34;SEC_104
2017;327;65-74;73;67;140;SEC_327
2017;124;35-49;94;93;187;SEC_124
2017;122;03-11;33;46;79;SEC_122
2017;314;00-02;32;33;65;SEC_314
2017;601;00-02;18;27;45;SEC_601
2017;228;16-17;19;29;48;SEC_228
2017;115;25-34;63;85;148;SEC_115
2017;133;18-24;17;22;39;SEC_133
2017;138;00-02;6;7;13;SEC_138
2017;414;03-11;101;81;182;SEC_414
2017;124;65-74;46;29;75;SEC_124
2017;513;35-49;195;200;395;SEC_513
2017;502;12-15;18;34;52;SEC_502
2017;202;50-64;140;144;284;SEC_202
2017;113;00-02;19;19;38;SEC_113
2017;435;18-24;47;63;110;SEC_435
2017;531;25-34;74;75;149;SEC_531
2017;433;25-34;149;145;294;SEC_433
2017;205;65-74;58;37;95;SEC_205
2017;116;18-24;51;39;90;SEC_116
2017;405;00-02;24;32;56;SEC_405
2017;211;18-24;51;77;128;SEC_211
2017;103;50-64;75;71;146;SEC_103
2017;106;03-11;58;66;124;SEC_106
2017;523;35-49;197;181;378;SEC_523
2017;128;25-34;69;77;146;SEC_128
2017;431;18-24;81;56;137;SEC_431
2017;326;12-15;20;14;34;SEC_326
2017;229;00-02;24;33;57;SEC_229
2017;524;00-02;25;17;42;SEC_524
2017;440;12-15;20;13;33;SEC_440
2017;518;35-49;148;146;294;SEC_518
2017;404;50-64;120;114;234;SEC_404
2017;112;12-15;40;32;72;SEC_112
2017;431;25-34;132;134;266;SEC_431
2017;609;18-24;30;30;60;SEC_609
2017;436;00-02;27;20;47;SEC_436
2017;441;35-49;223;236;459;SEC_441
2017;504;03-11;28;44;72;SEC_504
2017;520;00-02;11;20;31;SEC_520
2017;224;35-49;161;143;304;SEC_224
2017;234;00-02;15;20;35;SEC_234
2017;118;50-64;179;132;311;SEC_118
2017;533;50-64;165;149;314;SEC_533
2017;246;00-02;16;10;26;SEC_246
2017;201;16-17;15;13;28;SEC_201
2017;538;12-15;26;33;59;SEC_538
2017;210;75 i +;81;43;124;SEC_210
2017;130;16-17;9;9;18;SEC_130
2017;131;25-34;76;72;148;SEC_131
2017;220;25-34;152;172;324;SEC_220
2017;407;75 i +;84;44;128;SEC_407
2017;106;00-02;21;21;42;SEC_106
2017;619;75 i +;117;90;207;SEC_619
2017;107;25-34;100;108;208;SEC_107
2017;518;50-64;94;92;186;SEC_518
2017;425;25-34;82;69;151;SEC_425
2017;612;75 i +;88;66;154;SEC_612
2017;609;16-17;6;6;12;SEC_609
2017;618;00-02;7;7;14;SEC_618
2017;422;35-49;160;167;327;SEC_422
2017;246;35-49;181;193;374;SEC_246
2017;133;12-15;12;13;25;SEC_133
2017;112;50-64;177;148;325;SEC_112
2017;418;12-15;20;27;47;SEC_418
2017;217;65-74;65;59;124;SEC_217
2017;506;65-74;180;137;317;SEC_506
2017;139;03-11;28;33;61;SEC_139
2017;420;25-34;153;132;285;SEC_420
2017;421;16-17;17;14;31;SEC_421
2017;616;25-34;102;125;227;SEC_616
2017;320;65-74;3;3;6;SEC_320
2017;210;12-15;20;18;38;SEC_210
2017;625;35-49;111;110;221;SEC_625
2017;503;50-64;111;72;183;SEC_503
2017;140;16-17;9;5;14;SEC_140
2017;316;03-11;57;74;131;SEC_316
2017;414;18-24;78;73;151;SEC_414
2017;526;25-34;157;154;311;SEC_526
2017;318;75 i +;51;28;79;SEC_318
2017;201;25-34;169;138;307;SEC_201
2017;601;18-24;72;68;140;SEC_601
2017;312;16-17;11;15;26;SEC_312
2017;216;75 i +;85;53;138;SEC_216
2017;435;00-02;30;20;50;SEC_435
2017;205;03-11;37;35;72;SEC_205
2017;529;35-49;190;170;360;SEC_529
2017;127;25-34;56;54;110;SEC_127
2017;602;03-11;59;67;126;SEC_602
2017;111;35-49;87;87;174;SEC_111
2017;625;18-24;26;35;61;SEC_625
2017;129;12-15;18;24;42;SEC_129
2017;420;16-17;16;27;43;SEC_420
2017;538;65-74;72;33;105;SEC_538
2017;239;65-74;57;28;85;SEC_239
2017;313;00-02;33;17;50;SEC_313
2017;418;16-17;13;13;26;SEC_418
2017;108;16-17;13;14;27;SEC_108
2017;532;03-11;74;70;144;SEC_532
2017;414;25-34;165;158;323;SEC_414
2017;316;18-24;72;62;134;SEC_316
2017;630;16-17;13;7;20;SEC_630
2017;506;18-24;57;60;117;SEC_506
2017;213;75 i +;51;43;94;SEC_213
2017;502;03-11;71;74;145;SEC_502
2017;317;25-34;82;89;171;SEC_317
2017;130;35-49;142;123;265;SEC_130
2017;608;35-49;133;172;305;SEC_608
2017;213;25-34;84;75;159;SEC_213
2017;245;75 i +;64;44;108;SEC_245
2017;113;65-74;106;105;211;SEC_113
2017;308;03-11;87;70;157;SEC_308
2017;102;00-02;16;16;32;SEC_102
2017;116;35-49;161;154;315;SEC_116
2017;226;75 i +;122;71;193;SEC_226
2017;502;16-17;18;14;32;SEC_502
2017;242;50-64;102;99;201;SEC_242
2017;416;12-15;29;32;61;SEC_416
2017;209;35-49;132;110;242;SEC_209
2017;140;03-11;54;54;108;SEC_140
2017;623;18-24;41;46;87;SEC_623
2017;314;18-24;74;81;155;SEC_314
2017;511;65-74;100;65;165;SEC_511
2017;220;12-15;36;30;66;SEC_220
2017;111;50-64;93;70;163;SEC_111
2017;611;00-02;17;20;37;SEC_611
2017;321;12-15;40;35;75;SEC_321
2017;606;35-49;137;121;258;SEC_606
2017;303;35-49;202;212;414;SEC_303
2017;130;75 i +;100;55;155;SEC_130
2017;249;18-24;46;47;93;SEC_249
2017;414;00-02;34;38;72;SEC_414
2017;407;65-74;45;29;74;SEC_407
2017;307;16-17;7;10;17;SEC_307
2017;136;12-15;25;25;50;SEC_136
2017;137;25-34;94;81;175;SEC_137
2017;532;12-15;27;26;53;SEC_532
2017;204;00-02;25;19;44;SEC_204
2017;303;25-34;103;99;202;SEC_303
2017;622;65-74;64;46;110;SEC_622
2017;249;16-17;15;8;23;SEC_249
2017;605;03-11;80;71;151;SEC_605
2017;234;12-15;18;13;31;SEC_234
2017;204;12-15;28;22;50;SEC_204
2017;249;35-49;132;123;255;SEC_249
2017;214;00-02;46;40;86;SEC_214
2017;133;65-74;58;44;102;SEC_133
2017;437;65-74;77;58;135;SEC_437
2017;431;16-17;15;16;31;SEC_431
2017;407;12-15;15;22;37;SEC_407
2017;101;25-34;159;162;321;SEC_101
2017;421;35-49;155;165;320;SEC_421
2017;325;65-74;136;111;247;SEC_325
2017;523;16-17;12;11;23;SEC_523
2017;605;35-49;187;191;378;SEC_605
2017;403;18-24;37;47;84;SEC_403
2017;624;16-17;9;6;15;SEC_624
2017;615;25-34;33;36;69;SEC_615
2017;627;12-15;11;13;24;SEC_627
2017;305;35-49;165;187;352;SEC_305
2017;114;65-74;115;85;200;SEC_114
2017;524;12-15;30;21;51;SEC_524
2017;532;35-49;187;191;378;SEC_532
2017;523;75 i +;90;68;158;SEC_523
2017;503;35-49;85;68;153;SEC_503
2017;112;00-02;21;17;38;SEC_112
2017;248;65-74;43;41;84;SEC_248
2017;223;03-11;62;55;117;SEC_223
2017;514;65-74;54;30;84;SEC_514
2017;224;65-74;48;34;82;SEC_224
2017;214;50-64;187;172;359;SEC_214
2017;214;65-74;77;53;130;SEC_214
2017;613;00-02;16;8;24;SEC_613
2017;422;03-11;59;52;111;SEC_422
2017;217;12-15;25;26;51;SEC_217
2017;108;65-74;65;59;124;SEC_108
2017;437;03-11;68;81;149;SEC_437
2017;233;12-15;7;14;21;SEC_233
2017;234;65-74;41;23;64;SEC_234
2017;208;03-11;34;36;70;SEC_208
2017;201;75 i +;60;45;105;SEC_201
2017;501;03-11;24;33;57;SEC_501
2017;521;50-64;81;66;147;SEC_521
2017;622;18-24;18;37;55;SEC_622
2017;315;00-02;24;25;49;SEC_315
2017;137;75 i +;56;48;104;SEC_137
2017;531;35-49;122;128;250;SEC_531
2017;118;16-17;17;10;27;SEC_118
2017;410;25-34;96;113;209;SEC_410
2017;608;00-02;12;10;22;SEC_608
2017;416;03-11;62;78;140;SEC_416
2017;501;35-49;105;128;233;SEC_501
2017;538;00-02;20;14;34;SEC_538
2017;436;65-74;56;54;110;SEC_436
2017;614;12-15;19;19;38;SEC_614
2017;236;12-15;17;23;40;SEC_236
2017;613;12-15;16;17;33;SEC_613
2017;425;03-11;42;44;86;SEC_425
2017;432;18-24;47;52;99;SEC_432
2017;431;12-15;35;44;79;SEC_431
2017;103;35-49;105;113;218;SEC_103
2017;419;16-17;24;18;42;SEC_419
2017;503;65-74;59;68;127;SEC_503
2017;419;75 i +;110;75;185;SEC_419
2017;508;50-64;133;134;267;SEC_508
2017;132;00-02;22;20;42;SEC_132
2017;421;00-02;16;15;31;SEC_421
2017;405;03-11;75;73;148;SEC_405
2017;224;03-11;62;68;130;SEC_224
2017;506;35-49;174;182;356;SEC_506
2017;112;03-11;62;59;121;SEC_112
2017;523;18-24;48;52;100;SEC_523
2017;313;35-49;233;212;445;SEC_313
2017;323;12-15;38;41;79;SEC_323
2017;128;50-64;85;87;172;SEC_128
2017;412;35-49;163;183;346;SEC_412
2017;431;00-02;23;30;53;SEC_431
2017;314;35-49;271;280;551;SEC_314
2017;611;16-17;18;15;33;SEC_611
2017;607;75 i +;104;91;195;SEC_607
2017;411;18-24;36;32;68;SEC_411
2017;514;00-02;14;21;35;SEC_514
2017;617;18-24;24;35;59;SEC_617
2017;520;03-11;42;26;68;SEC_520
2017;209;12-15;17;20;37;SEC_209
2017;605;00-02;29;18;47;SEC_605
2017;631;16-17;8;13;21;SEC_631
2017;530;25-34;138;110;248;SEC_530
2017;432;50-64;122;102;224;SEC_432
2017;405;25-34;139;107;246;SEC_405
2017;431;75 i +;85;39;124;SEC_431
2017;116;00-02;15;12;27;SEC_116
2017;430;65-74;34;28;62;SEC_430
2017;110;16-17;1;7;8;SEC_110
2017;136;16-17;10;9;19;SEC_136
2017;631;35-49;133;124;257;SEC_631
2017;508;03-11;65;71;136;SEC_508
2017;308;00-02;23;29;52;SEC_308
2017;537;50-64;132;106;238;SEC_537
2017;622;75 i +;36;21;57;SEC_622
2017;502;75 i +;141;85;226;SEC_502
2017;513;65-74;48;40;88;SEC_513
2017;311;65-74;63;43;106;SEC_311
2017;126;25-34;64;51;115;SEC_126
2017;626;65-74;74;54;128;SEC_626
2017;213;12-15;19;24;43;SEC_213
2017;618;25-34;53;44;97;SEC_618
2017;423;50-64;89;77;166;SEC_423
2017;403;35-49;138;141;279;SEC_403
2017;622;25-34;47;35;82;SEC_622
2017;433;00-02;28;37;65;SEC_433
2017;137;03-11;72;58;130;SEC_137
2017;236;75 i +;97;48;145;SEC_236
2017;303;50-64;123;128;251;SEC_303
2017;630;50-64;82;64;146;SEC_630
2017;617;50-64;84;79;163;SEC_617
2017;613;75 i +;95;89;184;SEC_613
2017;306;65-74;88;72;160;SEC_306
2017;619;00-02;9;10;19;SEC_619
2017;518;00-02;17;13;30;SEC_518
2017;126;03-11;31;35;66;SEC_126
2017;501;65-74;117;116;233;SEC_501
2017;108;12-15;22;18;40;SEC_108
2017;127;16-17;6;4;10;SEC_127
2017;322;75 i +;79;41;120;SEC_322
2017;514;18-24;72;66;138;SEC_514
2017;601;12-15;34;37;71;SEC_601
2017;423;25-34;64;59;123;SEC_423
2017;605;16-17;15;13;28;SEC_605
2017;514;25-34;106;87;193;SEC_514
2017;426;35-49;115;165;280;SEC_426
2017;104;03-11;33;26;59;SEC_104
2017;611;35-49;233;243;476;SEC_611
2017;216;18-24;52;45;97;SEC_216
2017;107;16-17;16;11;27;SEC_107
2017;511;00-02;37;50;87;SEC_511
2017;212;35-49;206;199;405;SEC_212
2017;305;16-17;14;16;30;SEC_305
2017;531;75 i +;53;35;88;SEC_531
2017;406;12-15;27;34;61;SEC_406
2017;621;12-15;22;26;48;SEC_621
2017;517;16-17;17;29;46;SEC_517
2017;538;03-11;51;53;104;SEC_538
2017;324;16-17;14;12;26;SEC_324
2017;510;35-49;117;127;244;SEC_510
2017;103;03-11;34;34;68;SEC_103
2017;435;16-17;8;8;16;SEC_435
2017;124;25-34;66;65;131;SEC_124
2017;312;00-02;31;29;60;SEC_312
2017;528;03-11;53;53;106;SEC_528
2017;132;75 i +;115;78;193;SEC_132
2017;534;12-15;16;21;37;SEC_534
2017;420;00-02;24;35;59;SEC_420
2017;120;75 i +;68;45;113;SEC_120
2017;120;12-15;19;42;61;SEC_120
2017;418;65-74;56;40;96;SEC_418
2017;110;03-11;41;31;72;SEC_110
2017;319;00-02;25;32;57;SEC_319
2017;242;18-24;53;39;92;SEC_242
2017;401;00-02;20;13;33;SEC_401
2017;529;50-64;101;97;198;SEC_529
2017;510;03-11;52;40;92;SEC_510
2017;135;25-34;95;110;205;SEC_135
2017;537;18-24;58;51;109;SEC_537
2017;325;35-49;191;185;376;SEC_325
2017;307;03-11;54;40;94;SEC_307
2017;524;18-24;46;54;100;SEC_524
2017;307;25-34;56;79;135;SEC_307
2017;525;50-64;62;65;127;SEC_525
2017;140;65-74;54;46;100;SEC_140
2017;221;75 i +;113;78;191;SEC_221
2017;303;16-17;14;12;26;SEC_303
2017;616;16-17;28;25;53;SEC_616
2017;131;35-49;152;172;324;SEC_131
2017;427;25-34;156;128;284;SEC_427
2017;507;18-24;24;48;72;SEC_507
2017;106;65-74;137;139;276;SEC_106
2017;612;00-02;10;8;18;SEC_612
2017;303;00-02;23;19;42;SEC_303
2017;117;00-02;18;25;43;SEC_117
2017;136;65-74;64;68;132;SEC_136
2017;423;18-24;47;30;77;SEC_423
2017;129;50-64;95;85;180;SEC_129
2017;136;35-49;161;161;322;SEC_136
2017;610;65-74;127;71;198;SEC_610
2017;632;65-74;50;38;88;SEC_632
2017;535;50-64;103;85;188;SEC_535
2017;312;12-15;18;24;42;SEC_312
2017;538;25-34;95;81;176;SEC_538
2017;517;50-64;196;154;350;SEC_517
2017;632;75 i +;53;37;90;SEC_632
2017;630;35-49;97;105;202;SEC_630
2017;323;00-02;23;20;43;SEC_323
2017;409;16-17;13;12;25;SEC_409
2017;514;75 i +;95;59;154;SEC_514
2017;118;75 i +;64;62;126;SEC_118
2017;201;00-02;32;43;75;SEC_201
2017;606;18-24;29;31;60;SEC_606
2017;626;03-11;38;40;78;SEC_626
2017;537;35-49;154;134;288;SEC_537
2017;232;65-74;51;36;87;SEC_232
2017;130;00-02;15;17;32;SEC_130
2017;232;18-24;48;54;102;SEC_232
2017;327;00-02;12;24;36;SEC_327
2017;317;75 i +;47;24;71;SEC_317
2017;508;16-17;16;9;25;SEC_508
2017;508;25-34;118;107;225;SEC_508
2017;231;50-64;98;102;200;SEC_231
2017;313;18-24;64;59;123;SEC_313
2017;205;50-64;101;104;205;SEC_205
2017;406;35-49;162;158;320;SEC_406
2017;114;75 i +;114;79;193;SEC_114
2017;503;03-11;18;22;40;SEC_503
2017;310;50-64;99;72;171;SEC_310
2017;243;12-15;20;33;53;SEC_243
2017;324;00-02;20;10;30;SEC_324
2017;521;25-34;45;38;83;SEC_521
2017;525;75 i +;78;36;114;SEC_525
2017;425;35-49;135;143;278;SEC_425
2017;247;25-34;99;90;189;SEC_247
2017;321;03-11;58;75;133;SEC_321
2017;301;16-17;21;18;39;SEC_301
2017;426;03-11;48;40;88;SEC_426
2017;318;12-15;7;16;23;SEC_318
2017;504;12-15;14;10;24;SEC_504
2017;237;75 i +;88;47;135;SEC_237
2017;435;75 i +;66;25;91;SEC_435
2017;128;12-15;16;15;31;SEC_128
2017;236;03-11;43;51;94;SEC_236
2017;317;16-17;10;13;23;SEC_317
2017;311;75 i +;94;62;156;SEC_311
2017;109;65-74;81;66;147;SEC_109
2017;617;65-74;60;42;102;SEC_617
2017;246;25-34;98;93;191;SEC_246
2017;610;18-24;31;42;73;SEC_610
2017;538;16-17;11;15;26;SEC_538
2017;618;35-49;127;114;241;SEC_618
2017;137;00-02;19;23;42;SEC_137
2017;212;16-17;15;16;31;SEC_212
2017;308;65-74;122;103;225;SEC_308
2017;107;03-11;67;64;131;SEC_107
2017;327;50-64;163;129;292;SEC_327
2017;521;18-24;20;24;44;SEC_521
2017;624;75 i +;58;63;121;SEC_624
2017;405;16-17;26;15;41;SEC_405
2017;248;16-17;7;11;18;SEC_248
2017;120;65-74;100;97;197;SEC_120
2017;611;75 i +;112;97;209;SEC_611
2017;110;65-74;120;93;213;SEC_110
2017;535;03-11;33;31;64;SEC_535
2017;511;25-34;175;162;337;SEC_511
2017;308;16-17;26;20;46;SEC_308
2017;419;35-49;235;302;537;SEC_419
2017;301;65-74;133;117;250;SEC_301
2017;601;65-74;143;98;241;SEC_601
2017;226;12-15;39;34;73;SEC_226
2017;433;75 i +;65;39;104;SEC_433
2017;621;18-24;44;48;92;SEC_621
2017;513;03-11;73;74;147;SEC_513
2017;412;75 i +;117;85;202;SEC_412
2017;126;16-17;13;11;24;SEC_126
2017;322;18-24;49;44;93;SEC_322
2017;402;12-15;18;16;34;SEC_402
2017;103;25-34;49;39;88;SEC_103
2017;312;18-24;67;53;120;SEC_312
2017;535;18-24;30;29;59;SEC_535
2017;534;00-02;18;24;42;SEC_534
2017;324;12-15;27;21;48;SEC_324
2017;119;35-49;122;143;265;SEC_119
2017;216;12-15;34;27;61;SEC_216
2017;537;25-34;99;95;194;SEC_537
2017;246;65-74;40;33;73;SEC_246
2017;401;16-17;8;13;21;SEC_401
2017;528;25-34;72;66;138;SEC_528
2017;106;18-24;41;53;94;SEC_106
2017;323;03-11;65;101;166;SEC_323
2017;302;65-74;121;114;235;SEC_302
2017;116;65-74;117;81;198;SEC_116
2017;105;35-49;141;140;281;SEC_105
2017;421;75 i +;90;73;163;SEC_421
2017;125;65-74;108;88;196;SEC_125
2017;126;12-15;22;16;38;SEC_126
2017;430;00-02;20;13;33;SEC_430
2017;615;75 i +;58;58;116;SEC_615
2017;135;00-02;12;22;34;SEC_135
2017;202;75 i +;79;65;144;SEC_202
2017;133;75 i +;67;31;98;SEC_133
2017;312;50-64;156;165;321;SEC_312
2017;508;00-02;18;19;37;SEC_508
2017;205;16-17;8;13;21;SEC_205
2017;213;65-74;55;34;89;SEC_213
2017;615;50-64;50;45;95;SEC_615
2017;505;25-34;55;54;109;SEC_505
2017;321;65-74;180;162;342;SEC_321
2017;245;35-49;147;153;300;SEC_245
2017;431;03-11;102;92;194;SEC_431
2017;405;50-64;158;156;314;SEC_405
2017;305;50-64;210;177;387;SEC_305
2017;506;03-11;50;55;105;SEC_506
2017;410;65-74;101;85;186;SEC_410
2017;609;65-74;83;58;141;SEC_609
2017;537;16-17;14;9;23;SEC_537
2017;236;16-17;5;13;18;SEC_236
2017;623;12-15;23;37;60;SEC_623
2017;313;65-74;126;101;227;SEC_313
2017;514;35-49;188;186;374;SEC_514
2017;614;03-11;37;48;85;SEC_614
2017;613;16-17;11;13;24;SEC_613
2017;229;12-15;38;26;64;SEC_229
2017;209;65-74;34;36;70;SEC_209
2017;414;16-17;19;14;33;SEC_414
2017;134;12-15;22;29;51;SEC_134
2017;113;16-17;8;13;21;SEC_113
2017;504;50-64;72;73;145;SEC_504
2017;630;65-74;74;64;138;SEC_630
2017;132;65-74;121;126;247;SEC_132
2017;308;35-49;251;222;473;SEC_308
2017;231;00-02;25;21;46;SEC_231
2017;238;18-24;39;48;87;SEC_238
2017;228;75 i +;137;89;226;SEC_228
2017;118;00-02;15;20;35;SEC_118
2017;249;00-02;16;13;29;SEC_249
2017;223;00-02;22;14;36;SEC_223
2017;405;75 i +;150;93;243;SEC_405
2017;242;00-02;19;17;36;SEC_242
2017;507;25-34;52;59;111;SEC_507
2017;315;03-11;84;79;163;SEC_315
2017;420;65-74;89;70;159;SEC_420
2017;517;00-02;35;38;73;SEC_517
2017;127;03-11;37;32;69;SEC_127
2017;247;65-74;57;37;94;SEC_247
2017;201;35-49;236;247;483;SEC_201
2017;109;03-11;46;47;93;SEC_109
2017;221;50-64;171;161;332;SEC_221
2017;409;18-24;87;69;156;SEC_409
2017;106;35-49;180;207;387;SEC_106
2017;436;75 i +;71;49;120;SEC_436
2017;315;25-34;117;116;233;SEC_315
2017;217;50-64;130;143;273;SEC_217
2017;121;65-74;24;24;48;SEC_121
2017;611;18-24;46;54;100;SEC_611
2017;127;35-49;95;89;184;SEC_127
2017;324;50-64;75;81;156;SEC_324
2017;513;50-64;126;138;264;SEC_513
2017;521;00-02;6;4;10;SEC_521
2017;507;03-11;34;27;61;SEC_507
2017;202;18-24;62;83;145;SEC_202
2017;632;16-17;13;6;19;SEC_632
2017;221;00-02;28;31;59;SEC_221
2017;320;12-15;38;36;74;SEC_320
2017;119;50-64;135;94;229;SEC_119
2017;132;16-17;16;21;37;SEC_132
2017;406;65-74;77;65;142;SEC_406
2017;226;35-49;238;229;467;SEC_226
2017;538;75 i +;104;62;166;SEC_538
2017;326;16-17;7;7;14;SEC_326
2017;107;50-64;152;125;277;SEC_107
2017;327;16-17;13;12;25;SEC_327
2017;609;25-34;37;41;78;SEC_609
2017;112;16-17;16;20;36;SEC_112
2017;431;50-64;130;109;239;SEC_431
2017;307;35-49;144;143;287;SEC_307
2017;130;12-15;19;13;32;SEC_130
2017;608;75 i +;102;69;171;SEC_608
2017;104;12-15;12;18;30;SEC_104
2017;121;03-11;32;53;85;SEC_121
2017;504;00-02;9;18;27;SEC_504
2017;104;16-17;8;10;18;SEC_104
2017;122;16-17;6;13;19;SEC_122
2017;504;25-34;72;60;132;SEC_504
2017;228;18-24;100;87;187;SEC_228
2017;410;18-24;58;73;131;SEC_410
2017;412;16-17;9;13;22;SEC_412
2017;130;03-11;56;45;101;SEC_130
2017;525;16-17;6;7;13;SEC_525
2017;134;18-24;51;45;96;SEC_134
2017;129;16-17;7;13;20;SEC_129
2017;531;00-02;7;12;19;SEC_531
2017;221;65-74;83;69;152;SEC_221
2017;627;16-17;7;2;9;SEC_627
2017;537;00-02;19;12;31;SEC_537
2017;504;65-74;93;65;158;SEC_504
2017;238;75 i +;55;38;93;SEC_238
2017;433;65-74;70;60;130;SEC_433
2017;316;65-74;167;159;326;SEC_316
2017;625;25-34;55;64;119;SEC_625
2017;319;75 i +;43;37;80;SEC_319
2017;626;75 i +;69;45;114;SEC_626
2017;216;00-02;20;13;33;SEC_216
2017;113;12-15;20;37;57;SEC_113
2017;401;18-24;59;59;118;SEC_401
2017;323;18-24;75;54;129;SEC_323
2017;246;18-24;48;44;92;SEC_246
2017;309;12-15;19;32;51;SEC_309
2017;229;65-74;52;32;84;SEC_229
2017;403;75 i +;101;82;183;SEC_403
2017;228;00-02;33;29;62;SEC_228
2017;308;25-34;97;98;195;SEC_308
2017;524;25-34;118;103;221;SEC_524
2017;528;12-15;23;21;44;SEC_528
2017;316;25-34;156;154;310;SEC_316
2017;125;18-24;43;56;99;SEC_125
2017;430;25-34;80;87;167;SEC_430
2017;122;18-24;27;22;49;SEC_122
2017;133;00-02;9;11;20;SEC_133
2017;409;12-15;29;36;65;SEC_409
2017;116;50-64;146;124;270;SEC_116
2017;213;16-17;4;12;16;SEC_213
2017;605;25-34;89;78;167;SEC_605
2017;249;03-11;33;42;75;SEC_249
2017;211;35-49;195;196;391;SEC_211
2017;311;12-15;32;27;59;SEC_311
2017;412;12-15;32;24;56;SEC_412
2017;427;03-11;84;117;201;SEC_427
2017;402;50-64;88;74;162;SEC_402
2017;124;03-11;40;39;79;SEC_124
2017;320;03-11;68;71;139;SEC_320
2017;610;16-17;11;19;30;SEC_610
2017;249;12-15;15;16;31;SEC_249
2017;213;18-24;31;41;72;SEC_213
2017;416;16-17;18;19;37;SEC_416
2017;116;16-17;12;13;25;SEC_116
2017;121;12-15;16;10;26;SEC_121
2017;210;65-74;60;48;108;SEC_210
2017;601;25-34;107;115;222;SEC_601
2017;123;65-74;66;57;123;SEC_123
2017;520;65-74;43;41;84;SEC_520
2017;131;18-24;41;32;73;SEC_131
2017;211;75 i +;74;37;111;SEC_211
2017;617;75 i +;70;42;112;SEC_617
2017;320;18-24;49;42;91;SEC_320
2017;501;12-15;17;23;40;SEC_501
2017;523;12-15;26;19;45;SEC_523
2017;322;16-17;14;19;33;SEC_322
2017;402;25-34;74;53;127;SEC_402
2017;319;16-17;14;15;29;SEC_319
2017;243;65-74;57;49;106;SEC_243
2017;245;03-11;51;57;108;SEC_245
2017;525;65-74;38;36;74;SEC_525
2017;418;75 i +;87;67;154;SEC_418
2017;112;65-74;100;88;188;SEC_112
2017;237;50-64;133;110;243;SEC_237
2017;247;75 i +;75;46;121;SEC_247
2017;308;75 i +;105;91;196;SEC_308
2017;437;25-34;95;121;216;SEC_437
2017;322;50-64;119;95;214;SEC_322
2017;108;03-11;65;64;129;SEC_108
2017;113;50-64;198;154;352;SEC_113
2017;412;65-74;112;92;204;SEC_412
2017;433;12-15;30;35;65;SEC_433
2017;306;03-11;64;60;124;SEC_306
2017;613;03-11;35;49;84;SEC_613
2017;138;18-24;27;19;46;SEC_138
2017;307;18-24;32;38;70;SEC_307
2017;131;00-02;12;18;30;SEC_131
2017;432;12-15;18;16;34;SEC_432
2017;425;12-15;17;20;37;SEC_425
2017;136;03-11;55;54;109;SEC_136
2017;506;00-02;16;19;35;SEC_506
2017;506;12-15;26;35;61;SEC_506
2017;324;35-49;162;185;347;SEC_324
2017;210;25-34;42;47;89;SEC_210
2017;136;18-24;45;40;85;SEC_136
2017;612;65-74;85;58;143;SEC_612
2017;214;16-17;18;22;40;SEC_214
2017;234;50-64;89;84;173;SEC_234
2017;233;16-17;3;16;19;SEC_233
2017;505;18-24;26;18;44;SEC_505
2017;440;75 i +;84;72;156;SEC_440
2017;309;25-34;83;74;157;SEC_309
2017;526;00-02;30;24;54;SEC_526
2017;123;35-49;152;136;288;SEC_123
2017;537;75 i +;88;63;151;SEC_537
2017;514;50-64;121;125;246;SEC_514
2017;411;75 i +;97;77;174;SEC_411
2017;316;75 i +;85;55;140;SEC_316
2017;615;00-02;13;5;18;SEC_615
2017;630;03-11;22;43;65;SEC_630
2017;205;35-49;111;107;218;SEC_205
2017;403;03-11;52;54;106;SEC_403
2017;419;12-15;31;42;73;SEC_419
2017;631;75 i +;75;52;127;SEC_631
2017;312;65-74;131;73;204;SEC_312
2017;211;03-11;60;69;129;SEC_211
2017;126;00-02;14;15;29;SEC_126
2017;513;12-15;20;30;50;SEC_513
2017;631;50-64;74;76;150;SEC_631
2017;238;16-17;5;4;9;SEC_238
2017;632;18-24;39;34;73;SEC_632
2017;220;65-74;64;34;98;SEC_220
2017;306;00-02;22;34;56;SEC_306
2017;535;65-74;101;71;172;SEC_535
2017;622;03-11;33;33;66;SEC_622
2017;114;35-49;183;199;382;SEC_114
2017;239;03-11;41;34;75;SEC_239
2017;418;35-49;152;191;343;SEC_418
2017;105;25-34;61;76;137;SEC_105
2017;107;75 i +;115;66;181;SEC_107
2017;312;35-49;233;257;490;SEC_312
2017;114;18-24;53;45;98;SEC_114
2017;202;25-34;147;170;317;SEC_202
2017;608;18-24;33;33;66;SEC_608
2017;208;16-17;7;15;22;SEC_208
2017;130;50-64;93;95;188;SEC_130
2017;410;35-49;188;158;346;SEC_410
2017;248;12-15;24;14;38;SEC_248
2017;217;16-17;5;12;17;SEC_217
2017;317;65-74;28;31;59;SEC_317
2017;226;00-02;31;28;59;SEC_226
2017;125;12-15;31;29;60;SEC_125
2017;233;35-49;133;143;276;SEC_233
2017;625;03-11;28;32;60;SEC_625
2017;402;75 i +;59;42;101;SEC_402
2017;423;16-17;9;11;20;SEC_423
2017;624;18-24;25;31;56;SEC_624
2017;625;16-17;9;14;23;SEC_625
2017;612;12-15;15;19;34;SEC_612
2017;232;00-02;19;19;38;SEC_232
2017;529;65-74;46;33;79;SEC_529
2017;435;50-64;84;97;181;SEC_435
2017;623;65-74;138;104;242;SEC_623
2017;122;75 i +;74;63;137;SEC_122
2017;407;03-11;48;40;88;SEC_407
2017;315;18-24;64;61;125;SEC_315
2017;216;35-49;154;154;308;SEC_216
2017;526;75 i +;92;60;152;SEC_526
2017;407;35-49;122;148;270;SEC_407
2017;518;16-17;8;12;20;SEC_518
2017;202;16-17;21;15;36;SEC_202
2017;129;25-34;56;67;123;SEC_129
2017;320;18-24;4;4;8;SEC_320
2017;108;35-49;162;175;337;SEC_108
2017;411;12-15;19;18;37;SEC_411
2017;517;03-11;102;100;202;SEC_517
2017;119;65-74;123;110;233;SEC_119
2017;116;25-34;64;68;132;SEC_116
2017;325;25-34;83;78;161;SEC_325
2017;326;18-24;22;23;45;SEC_326
2017;538;35-49;168;168;336;SEC_538
2017;239;25-34;84;102;186;SEC_239
2017;223;50-64;117;104;221;SEC_223
2017;602;75 i +;86;93;179;SEC_602
2017;321;35-49;231;204;435;SEC_321
2017;140;12-15;11;22;33;SEC_140
2017;410;50-64;157;145;302;SEC_410
2017;323;75 i +;68;38;106;SEC_323
2017;608;50-64;145;119;264;SEC_608
2017;306;16-17;20;19;39;SEC_306
2017;411;03-11;32;28;60;SEC_411
2017;128;18-24;28;22;50;SEC_128
2017;132;35-49;216;259;475;SEC_132
2017;136;25-34;72;62;134;SEC_136
2017;302;75 i +;72;48;120;SEC_302
2017;414;12-15;23;28;51;SEC_414
2017;430;03-11;56;58;114;SEC_430
2017;321;50-64;280;239;519;SEC_321
2017;130;18-24;30;29;59;SEC_130
2017;419;03-11;74;118;192;SEC_419
2017;310;65-74;54;59;113;SEC_310
2017;626;35-49;106;96;202;SEC_626
2017;607;12-15;20;11;31;SEC_607
2017;131;75 i +;80;55;135;SEC_131
2017;402;18-24;43;26;69;SEC_402
2017;217;25-34;96;121;217;SEC_217
2017;631;25-34;52;46;98;SEC_631
2017;135;16-17;14;14;28;SEC_135
2017;317;50-64;84;74;158;SEC_317
2017;138;50-64;90;73;163;SEC_138
2017;135;03-11;45;56;101;SEC_135
2017;538;50-64;126;114;240;SEC_538
2017;309;50-64;105;86;191;SEC_309
2017;523;00-02;18;24;42;SEC_523
2017;521;75 i +;78;60;138;SEC_521
2017;614;75 i +;81;54;135;SEC_614
2017;602;25-34;59;62;121;SEC_602
2017;314;75 i +;89;59;148;SEC_314
2017;632;03-11;35;51;86;SEC_632
2017;535;00-02;8;4;12;SEC_535
2017;426;00-02;19;16;35;SEC_426
2017;311;16-17;10;20;30;SEC_311
2017;212;12-15;22;27;49;SEC_212
2017;207;00-02;26;24;50;SEC_207
2017;322;00-02;16;25;41;SEC_322
2017;135;18-24;48;38;86;SEC_135
2017;326;03-11;80;77;157;SEC_326
2017;121;16-17;5;10;15;SEC_121
2017;137;50-64;163;142;305;SEC_137
2017;117;75 i +;97;58;155;SEC_117
2017;243;25-34;127;130;257;SEC_243
2017;520;50-64;84;69;153;SEC_520
2017;214;03-11;96;101;197;SEC_214
2017;430;18-24;42;62;104;SEC_430
2017;503;12-15;4;7;11;SEC_503
2017;221;03-11;90;90;180;SEC_221
2017;529;00-02;18;21;39;SEC_529
2017;122;65-74;47;26;73;SEC_122
2017;236;65-74;57;35;92;SEC_236
2017;107;18-24;43;54;97;SEC_107
2017;315;16-17;9;15;24;SEC_315
2017;249;50-64;99;91;190;SEC_249
2017;407;50-64;94;72;166;SEC_407
2017;436;03-11;72;58;130;SEC_436
2017;319;12-15;39;37;76;SEC_319
2017;120;16-17;13;22;35;SEC_120
2017;436;12-15;31;35;66;SEC_436
2017;115;35-49;160;155;315;SEC_115
2017;532;00-02;20;21;41;SEC_532
2017;525;12-15;20;16;36;SEC_525
2017;317;35-49;141;185;326;SEC_317
2017;306;25-34;114;119;233;SEC_306
2017;617;25-34;54;48;102;SEC_617
2017;538;18-24;44;52;96;SEC_538
2017;612;50-64;71;71;142;SEC_612
2017;325;03-11;64;62;126;SEC_325
2017;529;25-34;104;82;186;SEC_529
2017;238;03-11;48;42;90;SEC_238
2017;323;50-64;201;169;370;SEC_323
2017;521;03-11;41;32;73;SEC_521
2017;518;65-74;59;37;96;SEC_518
2017;315;50-64;182;156;338;SEC_315
2017;231;12-15;19;29;48;SEC_231
2017;419;25-34;151;161;312;SEC_419
2017;409;75 i +;122;80;202;SEC_409
2017;233;65-74;32;20;52;SEC_233
2017;138;65-74;59;51;110;SEC_138
2017;431;35-49;197;232;429;SEC_431
2017;406;16-17;11;13;24;SEC_406
2017;631;00-02;4;14;18;SEC_631
2017;118;25-34;89;69;158;SEC_118
2017;419;50-64;155;158;313;SEC_419
2017;232;12-15;8;17;25;SEC_232
2017;420;50-64;206;181;387;SEC_420
2017;320;12-15;3;3;6;SEC_320
2017;220;03-11;77;72;149;SEC_220
2017;441;18-24;99;58;157;SEC_441
2017;531;12-15;19;12;31;SEC_531
2017;437;50-64;152;147;299;SEC_437
2017;306;18-24;68;56;124;SEC_306
2017;140;00-02;11;15;26;SEC_140
2017;501;16-17;12;11;23;SEC_501
2017;325;00-02;11;23;34;SEC_325
2017;631;65-74;114;84;198;SEC_631
2017;213;50-64;97;81;178;SEC_213
2017;435;35-49;129;180;309;SEC_435
2017;402;03-11;43;49;92;SEC_402
2017;106;25-34;99;106;205;SEC_106
2017;622;00-02;6;7;13;SEC_622
2017;427;35-49;231;230;461;SEC_427
2017;245;25-34;102;89;191;SEC_245
2017;305;00-02;22;18;40;SEC_305
2017;217;03-11;58;58;116;SEC_217
2017;212;00-02;20;24;44;SEC_212
2017;414;50-64;165;145;310;SEC_414
2017;624;12-15;18;21;39;SEC_624
2017;204;18-24;76;71;147;SEC_204
2017;407;00-02;14;19;33;SEC_407
2017;501;25-34;40;40;80;SEC_501
2017;505;50-64;91;93;184;SEC_505
2017;229;50-64;170;149;319;SEC_229
2017;619;65-74;93;72;165;SEC_619
2017;233;00-02;12;11;23;SEC_233
2017;246;75 i +;66;51;117;SEC_246
2017;201;18-24;30;50;80;SEC_201
2017;134;65-74;71;64;135;SEC_134
2017;115;65-74;80;72;152;SEC_115
2017;322;25-34;98;96;194;SEC_322
2017;430;35-49;147;180;327;SEC_430
2017;115;03-11;57;55;112;SEC_115
2017;310;35-49;97;118;215;SEC_310
2017;430;16-17;9;11;20;SEC_430
2017;240;16-17;14;12;26;SEC_240
2017;322;12-15;23;28;51;SEC_322
2017;419;18-24;77;90;167;SEC_419
2017;534;35-49;126;122;248;SEC_534
2017;126;65-74;90;67;157;SEC_126
2017;422;12-15;14;28;42;SEC_422
2017;502;65-74;92;85;177;SEC_502
2017;304;00-02;81;93;174;SEC_304
2017;211;50-64;127;96;223;SEC_211
2017;621;25-34;74;76;150;SEC_621
2017;132;18-24;52;64;116;SEC_132
2017;129;00-02;10;14;24;SEC_129
2017;401;12-15;21;21;42;SEC_401
2017;630;25-34;53;42;95;SEC_630
2017;231;25-34;104;91;195;SEC_231
2017;529;03-11;53;62;115;SEC_529
2017;310;16-17;6;8;14;SEC_310
2017;239;18-24;39;40;79;SEC_239
2017;114;00-02;19;11;30;SEC_114
2017;436;35-49;204;218;422;SEC_436
2017;240;03-11;87;61;148;SEC_240
2017;530;50-64;144;131;275;SEC_530
2017;430;75 i +;55;35;90;SEC_430
2017;506;75 i +;113;94;207;SEC_506
2017;134;50-64;151;121;272;SEC_134
2017;301;12-15;66;60;126;SEC_301
2017;505;00-02;8;17;25;SEC_505
2017;302;03-11;53;48;101;SEC_302
2017;607;50-64;98;88;186;SEC_607
2017;128;00-02;17;22;39;SEC_128
2017;133;50-64;80;79;159;SEC_133
2017;117;03-11;65;67;132;SEC_117
2017;534;50-64;83;74;157;SEC_534
2017;209;25-34;75;80;155;SEC_209
2017;401;75 i +;94;53;147;SEC_401
2017;521;65-74;111;99;210;SEC_521
2017;427;50-64;139;135;274;SEC_427
2017;123;16-17;10;6;16;SEC_123
2017;525;25-34;68;56;124;SEC_525
2017;220;16-17;11;8;19;SEC_220
2017;611;25-34;105;104;209;SEC_611
2017;238;35-49;135;111;246;SEC_238
2017;513;16-17;14;14;28;SEC_513
2017;224;18-24;39;46;85;SEC_224
2017;520;75 i +;63;37;100;SEC_520
2017;610;03-11;42;40;82;SEC_610
2017;125;16-17;12;14;26;SEC_125
2017;228;03-11;102;107;209;SEC_228
2017;128;16-17;9;6;15;SEC_128
2017;139;00-02;8;12;20;SEC_139
2017;412;18-24;62;63;125;SEC_412
2017;231;35-49;183;182;365;SEC_231
2017;322;35-49;184;187;371;SEC_322
2017;433;50-64;173;158;331;SEC_433
2017;520;18-24;27;33;60;SEC_520
2017;240;35-49;229;208;437;SEC_240
2017;223;12-15;24;24;48;SEC_223
2017;517;65-74;77;56;133;SEC_517
2017;506;16-17;17;24;41;SEC_506
2017;405;12-15;26;29;55;SEC_405
2017;421;50-64;107;94;201;SEC_421
2017;117;18-24;66;59;125;SEC_117
2017;139;35-49;106;120;226;SEC_139
2017;237;16-17;13;13;26;SEC_237
2017;404;00-02;12;22;34;SEC_404
2017;124;18-24;27;22;49;SEC_124
2017;245;12-15;15;33;48;SEC_245
2017;118;12-15;33;24;57;SEC_118
2017;223;25-34;97;108;205;SEC_223
2017;216;03-11;57;66;123;SEC_216
2017;216;50-64;116;102;218;SEC_216
2017;508;12-15;27;27;54;SEC_508
2017;303;12-15;25;25;50;SEC_303
2017;435;25-34;105;101;206;SEC_435
2017;319;50-64;153;141;294;SEC_319
2017;205;12-15;22;21;43;SEC_205
2017;426;50-64;81;85;166;SEC_426
2017;426;25-34;105;85;190;SEC_426
2017;602;12-15;20;25;45;SEC_602
2017;436;16-17;24;19;43;SEC_436
2017;242;16-17;11;9;20;SEC_242
2017;327;25-34;88;84;172;SEC_327
2017;601;35-49;198;275;473;SEC_601
2017;311;18-24;55;48;103;SEC_311
2017;249;25-34;72;92;164;SEC_249
2017;607;25-34;59;69;128;SEC_607
2017;304;25-34;289;252;541;SEC_304
2017;632;25-34;43;53;96;SEC_632
2017;301;00-02;44;48;92;SEC_301
2017;248;03-11;59;66;125;SEC_248
2017;120;18-24;69;59;128;SEC_120
2017;535;16-17;5;13;18;SEC_535
2017;208;12-15;23;28;51;SEC_208
2017;233;75 i +;60;31;91;SEC_233
2017;414;75 i +;89;62;151;SEC_414
2017;406;50-64;129;124;253;SEC_406
2017;607;00-02;10;9;19;SEC_607
2017;226;03-11;83;87;170;SEC_226
2017;321;16-17;14;21;35;SEC_321
2017;526;18-24;88;79;167;SEC_526
2017;608;16-17;9;11;20;SEC_608
2017;214;18-24;114;95;209;SEC_214
2017;205;75 i +;73;51;124;SEC_205
2017;623;75 i +;82;62;144;SEC_623
2017;510;65-74;59;47;106;SEC_510
2017;220;35-49;245;208;453;SEC_220
2017;508;65-74;58;36;94;SEC_508
2017;406;00-02;20;14;34;SEC_406
2017;205;25-34;79;69;148;SEC_205
2017;111;18-24;22;25;47;SEC_111
2017;534;25-34;89;64;153;SEC_534
2017;303;03-11;70;59;129;SEC_303
2017;501;50-64;107;84;191;SEC_501
2017;210;00-02;7;7;14;SEC_210
2017;409;00-02;26;29;55;SEC_409
2017;117;50-64;241;212;453;SEC_117
2017;306;12-15;29;30;59;SEC_306
2017;613;65-74;123;60;183;SEC_613
2017;130;65-74;41;29;70;SEC_130
2017;233;50-64;88;77;165;SEC_233
2017;101;00-02;70;51;121;SEC_101
2017;318;18-24;23;29;52;SEC_318
2017;310;25-34;70;62;132;SEC_310
2017;610;35-49;141;108;249;SEC_610
2017;401;50-64;137;116;253;SEC_401
2017;624;65-74;120;88;208;SEC_624
2017;231;65-74;40;27;67;SEC_231
2017;105;00-02;10;17;27;SEC_105
2017;107;00-02;24;13;37;SEC_107
2017;207;65-74;84;66;150;SEC_207
2017;607;35-49;103;121;224;SEC_607
2017;626;12-15;15;16;31;SEC_626
2017;510;12-15;19;16;35;SEC_510
2017;309;35-49;168;173;341;SEC_309
2017;105;12-15;28;23;51;SEC_105
2017;624;00-02;15;7;22;SEC_624
2017;404;65-74;65;49;114;SEC_404
2017;533;03-11;99;90;189;SEC_533
2017;220;75 i +;102;50;152;SEC_220
2017;242;75 i +;73;59;132;SEC_242
2017;507;12-15;16;19;35;SEC_507
2017;318;25-34;40;47;87;SEC_318
2017;102;16-17;20;17;37;SEC_102
2017;134;03-11;59;58;117;SEC_134
2017;435;03-11;53;77;130;SEC_435
2017;513;25-34;96;114;210;SEC_513
2017;239;35-49;142;156;298;SEC_239
2017;120;25-34;100;112;212;SEC_120
2017;323;25-34;91;107;198;SEC_323
2017;625;50-64;163;128;291;SEC_625
2017;132;12-15;36;27;63;SEC_132
2017;623;00-02;10;15;25;SEC_623
2017;134;16-17;18;14;32;SEC_134
2017;220;18-24;69;78;147;SEC_220
2017;202;65-74;70;46;116;SEC_202
2017;523;03-11;58;55;113;SEC_523
2017;530;75 i +;88;75;163;SEC_530
2017;523;25-34;85;97;182;SEC_523
2017;532;75 i +;102;68;170;SEC_532
2017;306;50-64;149;154;303;SEC_306
2017;401;65-74;53;47;100;SEC_401
2017;615;12-15;16;12;28;SEC_615
2017;312;25-34;156;155;311;SEC_312
2017;133;35-49;102;118;220;SEC_133
2017;411;50-64;99;73;172;SEC_411
2017;311;03-11;49;76;125;SEC_311
2017;318;16-17;8;8;16;SEC_318
2017;526;16-17;10;22;32;SEC_526
2017;320;50-64;17;16;33;SEC_320
2017;411;35-49;93;102;195;SEC_411
2017;411;16-17;7;9;16;SEC_411
2017;532;65-74;78;51;129;SEC_532
2017;118;18-24;66;54;120;SEC_118
2017;427;12-15;28;26;54;SEC_427
2017;435;12-15;23;19;42;SEC_435
2017;605;75 i +;125;125;250;SEC_605
2017;313;25-34;111;113;224;SEC_313
2017;247;03-11;78;79;157;SEC_247
2017;610;25-34;46;55;101;SEC_610
2017;301;50-64;234;225;459;SEC_301
2017;115;12-15;16;18;34;SEC_115
2017;125;50-64;135;135;270;SEC_125
2017;506;50-64;182;149;331;SEC_506
2017;240;00-02;25;19;44;SEC_240
2017;209;50-64;109;85;194;SEC_209
2017;306;75 i +;97;59;156;SEC_306
2017;418;00-02;12;17;29;SEC_418
2017;511;35-49;267;306;573;SEC_511
2017;614;35-49;109;106;215;SEC_614
2017;137;65-74;94;77;171;SEC_137
2017;322;03-11;63;62;125;SEC_322
2017;433;03-11;106;111;217;SEC_433
2017;619;12-15;19;18;37;SEC_619
2017;240;18-24;78;68;146;SEC_240
2017;440;50-64;82;83;165;SEC_440
2017;308;12-15;43;53;96;SEC_308
2017;221;18-24;88;92;180;SEC_221
2017;204;03-11;63;69;132;SEC_204
2017;326;25-34;131;91;222;SEC_326
2017;221;25-34;145;173;318;SEC_221
2017;132;03-11;90;72;162;SEC_132
2017;422;75 i +;78;38;116;SEC_422
2017;117;35-49;206;212;418;SEC_117
2017;529;18-24;46;64;110;SEC_529
2017;632;12-15;21;20;41;SEC_632
2017;115;75 i +;71;40;111;SEC_115
2017;606;00-02;15;20;35;SEC_606
2017;311;25-34;101;115;216;SEC_311
2017;517;25-34;158;173;331;SEC_517
2017;247;12-15;32;25;57;SEC_247
2017;404;75 i +;84;58;142;SEC_404
2017;125;25-34;90;83;173;SEC_125
2017;214;75 i +;119;64;183;SEC_214
2017;440;25-34;65;70;135;SEC_440
2017;238;00-02;11;16;27;SEC_238
2017;226;25-34;144;159;303;SEC_226
2017;305;18-24;60;59;119;SEC_305
2017;410;16-17;14;24;38;SEC_410
2017;207;50-64;177;139;316;SEC_207
2017;504;16-17;8;5;13;SEC_504
2017;524;75 i +;77;32;109;SEC_524
2017;137;35-49;184;156;340;SEC_137
2017;437;75 i +;113;79;192;SEC_437
2017;401;25-34;85;92;177;SEC_401
2017;136;75 i +;76;40;116;SEC_136
2017;503;25-34;39;44;83;SEC_503
2017;433;18-24;100;65;165;SEC_433
2017;240;65-74;58;40;98;SEC_240
2017;602;65-74;81;43;124;SEC_602
2017;623;35-49;155;160;315;SEC_623
2017;131;03-11;57;52;109;SEC_131
2017;214;25-34;186;194;380;SEC_214
2017;232;16-17;12;5;17;SEC_232
2017;405;35-49;233;226;459;SEC_405
2017;248;00-02;18;21;39;SEC_248
2017;528;35-49;167;169;336;SEC_528
2017;327;75 i +;37;21;58;SEC_327
2017;119;25-34;76;57;133;SEC_119
2017;320;35-49;182;194;376;SEC_320
2017;201;65-74;49;27;76;SEC_201
2017;204;35-49;195;193;388;SEC_204
2017;531;16-17;7;5;12;SEC_531
2017;108;18-24;56;52;108;SEC_108
2017;110;12-15;20;17;37;SEC_110
2017;427;16-17;14;19;33;SEC_427
2017;440;35-49;126;119;245;SEC_440
2017;101;18-24;72;70;142;SEC_101
2017;409;03-11;83;81;164;SEC_409
2017;102;12-15;27;28;55;SEC_102
2017;607;16-17;4;5;9;SEC_607
2017;618;65-74;102;67;169;SEC_618
2017;105;65-74;80;71;151;SEC_105
2017;113;35-49;219;213;432;SEC_113
2017;533;25-34;160;137;297;SEC_533
2017;109;18-24;38;33;71;SEC_109
2017;526;65-74;62;47;109;SEC_526
2017;526;50-64;146;138;284;SEC_526
2017;129;75 i +;104;70;174;SEC_129
2017;316;16-17;11;18;29;SEC_316
2017;208;50-64;168;145;313;SEC_208
2017;403;65-74;82;54;136;SEC_403
2017;502;00-02;19;19;38;SEC_502
2017;109;00-02;9;11;20;SEC_109
2017;109;75 i +;66;43;109;SEC_109
2017;425;50-64;84;91;175;SEC_425
2017;406;18-24;68;58;126;SEC_406
2017;116;03-11;54;52;106;SEC_116
2017;524;03-11;54;67;121;SEC_524
2017;525;35-49;126;120;246;SEC_525
2017;402;35-49;121;117;238;SEC_402
2017;622;35-49;101;106;207;SEC_622
2017;101;16-17;22;19;41;SEC_101
2017;121;75 i +;69;40;109;SEC_121
2017;201;12-15;28;32;60;SEC_201
2017;224;50-64;116;100;216;SEC_224
2017;520;25-34;63;65;128;SEC_520
2017;615;35-49;103;103;206;SEC_615
2017;619;50-64;138;131;269;SEC_619
2017;610;12-15;23;25;48;SEC_610
2017;631;12-15;11;12;23;SEC_631
2017;602;50-64;97;103;200;SEC_602
2017;422;25-34;77;86;163;SEC_422
2017;608;65-74;72;55;127;SEC_608
2017;601;50-64;184;164;348;SEC_601
2017;139;25-34;59;58;117;SEC_139
2017;621;03-11;56;51;107;SEC_621
2017;326;75 i +;4;6;10;SEC_326
2017;223;35-49;144;154;298;SEC_223
2017;217;18-24;57;58;115;SEC_217
2017;213;00-02;15;9;24;SEC_213
2017;131;16-17;8;13;21;SEC_131
2017;606;03-11;43;53;96;SEC_606
2017;608;25-34;60;69;129;SEC_608
2017;311;00-02;21;22;43;SEC_311
2017;240;75 i +;114;73;187;SEC_240
2017;304;16-17;62;27;89;SEC_304
2017;441;03-11;82;91;173;SEC_441
2017;440;65-74;73;55;128;SEC_440
2017;440;00-02;16;10;26;SEC_440
2017;441;65-74;134;116;250;SEC_441
2017;304;18-24;90;79;169;SEC_304
2017;530;00-02;41;37;78;SEC_530
2017;240;25-34;155;133;288;SEC_240
2017;619;16-17;12;9;21;SEC_619
2017;533;00-02;22;31;53;SEC_533
2017;426;18-24;57;41;98;SEC_426
2017;231;03-11;62;68;130;SEC_231
2017;309;03-11;66;65;131;SEC_309
2017;602;00-02;10;14;24;SEC_602
2017;138;75 i +;48;39;87;SEC_138
2017;609;03-11;37;41;78;SEC_609
2017;608;03-11;54;45;99;SEC_608
2017;232;25-34;89;83;172;SEC_232
2017;113;03-11;79;95;174;SEC_113
2017;414;65-74;52;52;104;SEC_414
2017;432;16-17;10;9;19;SEC_432
2017;418;18-24;53;56;109;SEC_418
2017;239;16-17;6;10;16;SEC_239
2017;617;00-02;12;18;30;SEC_617
2017;623;16-17;12;11;23;SEC_623
2017;537;12-15;23;17;40;SEC_537
2017;323;35-49;227;224;451;SEC_323
2017;135;35-49;159;179;338;SEC_135
2017;318;50-64;107;99;206;SEC_318
2017;528;50-64;118;86;204;SEC_528
2017;217;00-02;17;19;36;SEC_217
2017;621;50-64;146;92;238;SEC_621
2017;418;50-64;116;119;235;SEC_418
2017;520;12-15;16;22;38;SEC_520
2017;106;50-64;223;156;379;SEC_106
2017;412;50-64;170;130;300;SEC_412
2017;421;25-34;84;66;150;SEC_421
2017;528;75 i +;77;55;132;SEC_528
2017;103;16-17;9;12;21;SEC_103
2017;623;25-34;45;53;98;SEC_623
2017;233;18-24;31;48;79;SEC_233
2017;220;00-02;36;29;65;SEC_220
2017;240;50-64;159;138;297;SEC_240
2017;124;00-02;11;9;20;SEC_124
2017;531;18-24;50;47;97;SEC_531
2017;239;00-02;13;10;23;SEC_239
2017;410;12-15;24;38;62;SEC_410
2017;234;25-34;91;77;168;SEC_234
2017;123;75 i +;87;71;158;SEC_123
2017;518;12-15;20;16;36;SEC_518
2017;246;03-11;65;62;127;SEC_246
2017;531;50-64;80;84;164;SEC_531
2017;426;16-17;8;9;17;SEC_426
2017;631;03-11;42;49;91;SEC_631
2017;416;25-34;118;110;228;SEC_416
2017;202;00-02;31;30;61;SEC_202
2017;526;12-15;35;34;69;SEC_526
2017;316;12-15;25;30;55;SEC_316
2017;122;25-34;51;44;95;SEC_122
2017;214;12-15;40;58;98;SEC_214
2017;117;16-17;21;21;42;SEC_117
2017;327;35-49;145;155;300;SEC_327
2017;234;16-17;6;5;11;SEC_234
2017;318;03-11;24;26;50;SEC_318
2017;404;25-34;110;100;210;SEC_404
2017;102;18-24;40;46;86;SEC_102
2017;229;25-34;157;152;309;SEC_229
2017;618;03-11;36;45;81;SEC_618
2017;419;00-02;37;38;75;SEC_419
2017;247;35-49;172;176;348;SEC_247
2017;606;25-34;55;69;124;SEC_606
2017;226;18-24;71;80;151;SEC_226
2017;107;65-74;99;77;176;SEC_107
2017;231;18-24;55;56;111;SEC_231
2017;307;50-64;157;112;269;SEC_307
2017;305;03-11;61;66;127;SEC_305
2017;616;12-15;42;44;86;SEC_616
2017;245;00-02;14;18;32;SEC_245
2017;414;35-49;258;249;507;SEC_414
2017;112;75 i +;79;42;121;SEC_112
2017;510;50-64;102;86;188;SEC_510
2017;314;16-17;15;10;25;SEC_314
2017;110;25-34;66;57;123;SEC_110
2017;614;25-34;40;53;93;SEC_614
2017;236;35-49;126;135;261;SEC_236
2017;407;25-34;70;65;135;SEC_407
2017;304;35-49;523;508;1031;SEC_304
2017;420;75 i +;127;84;211;SEC_420
2017;605;65-74;140;91;231;SEC_605
2017;129;18-24;33;34;67;SEC_129
2017;113;18-24;50;62;112;SEC_113
2017;115;18-24;38;44;82;SEC_115
2017;533;35-49;231;257;488;SEC_533
2017;510;00-02;18;14;32;SEC_510
2017;103;65-74;39;32;71;SEC_103
2017;115;16-17;11;16;27;SEC_115
2017;307;00-02;12;10;22;SEC_307
2017;138;35-49;83;69;152;SEC_138
2017;242;25-34;92;83;175;SEC_242
2017;320;16-17;3;2;5;SEC_320
2017;133;16-17;5;10;15;SEC_133
2017;617;16-17;9;6;15;SEC_617
2017;126;50-64;82;68;150;SEC_126
2017;232;50-64;92;91;183;SEC_232
2017;319;18-24;61;60;121;SEC_319
2017;121;35-49;119;120;239;SEC_121
2017;310;03-11;50;42;92;SEC_310
2017;616;35-49;287;269;556;SEC_616
2017;325;18-24;62;56;118;SEC_325
2017;106;75 i +;72;44;116;SEC_106
2017;420;03-11;95;73;168;SEC_420
2017;403;25-34;80;74;154;SEC_403
2017;315;75 i +;65;50;115;SEC_315
2017;614;65-74;90;68;158;SEC_614
2017;523;65-74;69;53;122;SEC_523
2017;125;75 i +;72;67;139;SEC_125
2017;421;18-24;36;52;88;SEC_421
2017;126;18-24;30;32;62;SEC_126
2017;503;75 i +;43;21;64;SEC_503
2017;117;25-34;106;98;204;SEC_117
2017;104;18-24;35;26;61;SEC_104
2017;120;03-11;61;64;125;SEC_120
2017;101;35-49;470;468;938;SEC_101
2017;224;16-17;6;8;14;SEC_224
2017;316;50-64;326;253;579;SEC_316
2017;409;50-64;171;151;322;SEC_409
2017;437;00-02;14;27;41;SEC_437
2017;625;00-02;11;12;23;SEC_625
2017;313;16-17;19;19;38;SEC_313
2017;437;16-17;15;14;29;SEC_437
2017;127;50-64;95;77;172;SEC_127
2017;121;00-02;7;14;21;SEC_121
2017;139;50-64;85;90;175;SEC_139
2017;432;65-74;96;89;185;SEC_432
2017;520;16-17;7;8;15;SEC_520
2017;308;18-24;82;96;178;SEC_308
2017;110;00-02;10;14;24;SEC_110
2017;611;03-11;81;94;175;SEC_611
2017;616;75 i +;66;35;101;SEC_616
2017;616;18-24;69;99;168;SEC_616
2017;627;18-24;21;23;44;SEC_627
2017;624;50-64;70;72;142;SEC_624
2017;612;25-34;47;36;83;SEC_612
2017;303;65-74;109;77;186;SEC_303
2017;210;50-64;85;86;171;SEC_210
2017;518;18-24;45;50;95;SEC_518
2017;318;65-74;49;45;94;SEC_318
2017;511;50-64;202;157;359;SEC_511
2017;114;12-15;24;29;53;SEC_114
2017;430;50-64;92;83;175;SEC_430
2017;405;18-24;71;86;157;SEC_405
2017;226;16-17;23;14;37;SEC_226
2017;102;75 i +;125;96;221;SEC_102
2017;212;50-64;106;104;210;SEC_212
2017;503;16-17;3;4;7;SEC_503
2017;247;16-17;17;8;25;SEC_247
2017;114;16-17;8;16;24;SEC_114
2017;626;00-02;13;12;25;SEC_626
2017;310;18-24;30;28;58;SEC_310
2017;317;12-15;21;28;49;SEC_317
2017;319;65-74;92;71;163;SEC_319
