AnyPadro;Seccio;GrupEdat;Dones;Homes;Total;IdSeccio
2003;212;50-64;125;115;240;SEC_212
2003;107;75 i +;73;29;102;SEC_107
2003;509;12-15;8;12;20;SEC_509
2003;214;65-74;40;36;76;SEC_214
2003;222;25-34;87;112;199;SEC_222
2003;227;65-74;45;38;83;SEC_227
2003;407;35-49;109;103;212;SEC_407
2003;623;12-15;15;22;37;SEC_623
2003;528;18-24;52;65;117;SEC_528
2003;434;03-11;25;21;46;SEC_434
2003;101;12-15;22;22;44;SEC_101
2003;122;75 i +;44;20;64;SEC_122
2003;101;00-02;31;18;49;SEC_101
2003;244;12-15;10;10;20;SEC_244
2003;435;00-02;14;16;30;SEC_435
2003;314;75 i +;81;39;120;SEC_314
2003;622;00-02;9;8;17;SEC_622
2003;206;75 i +;66;32;98;SEC_206
2003;139;35-49;77;99;176;SEC_139
2003;101;75 i +;29;22;51;SEC_101
2003;603;18-24;20;24;44;SEC_603
2003;239;35-49;117;123;240;SEC_239
2003;615;65-74;47;59;106;SEC_615
2003;531;50-64;79;71;150;SEC_531
2003;107;00-02;17;29;46;SEC_107
2003;424;50-64;63;51;114;SEC_424
2003;420;50-64;108;81;189;SEC_420
2003;631;12-15;20;9;29;SEC_631
2003;242;65-74;91;59;150;SEC_242
2003;415;25-34;64;89;153;SEC_415
2003;122;03-11;30;31;61;SEC_122
2003;426;03-11;28;42;70;SEC_426
2003;621;50-64;213;235;448;SEC_621
2003;509;16-17;8;9;17;SEC_509
2003;235;65-74;93;73;166;SEC_235
2003;527;18-24;56;59;115;SEC_527
2003;219;25-34;99;117;216;SEC_219
2003;442;75 i +;28;21;49;SEC_442
2003;440;65-74;58;58;116;SEC_440
2003;115;16-17;7;13;20;SEC_115
2003;236;03-11;44;25;69;SEC_236
2003;515;00-02;7;5;12;SEC_515
2003;213;12-15;24;15;39;SEC_213
2003;609;35-49;71;63;134;SEC_609
2003;130;50-64;74;60;134;SEC_130
2003;630;12-15;17;19;36;SEC_630
2003;530;03-11;40;47;87;SEC_530
2003;307;65-74;67;56;123;SEC_307
2003;136;18-24;71;57;128;SEC_136
2003;302;18-24;59;65;124;SEC_302
2003;419;65-74;42;42;84;SEC_419
2003;207;16-17;3;4;7;SEC_207
2003;319;35-49;157;152;309;SEC_319
2003;232;00-02;14;17;31;SEC_232
2003;406;03-11;40;43;83;SEC_406
2003;226;12-15;15;20;35;SEC_226
2003;501;12-15;15;14;29;SEC_501
2003;222;12-15;20;15;35;SEC_222
2003;517;75 i +;47;26;73;SEC_517
2003;407;00-02;14;15;29;SEC_407
2003;514;12-15;15;8;23;SEC_514
2003;301;00-02;36;36;72;SEC_301
2003;607;12-15;17;12;29;SEC_607
2003;104;18-24;21;28;49;SEC_104
2003;211;12-15;21;16;37;SEC_211
2003;216;25-34;106;113;219;SEC_216
2003;226;65-74;74;52;126;SEC_226
2003;202;75 i +;32;23;55;SEC_202
2003;402;75 i +;39;27;66;SEC_402
2003;608;65-74;66;53;119;SEC_608
2003;313;65-74;85;77;162;SEC_313
2003;203;35-49;92;112;204;SEC_203
2003;303;50-64;182;130;312;SEC_303
2003;307;12-15;18;36;54;SEC_307
2003;434;75 i +;60;25;85;SEC_434
2003;205;25-34;59;79;138;SEC_205
2003;232;75 i +;64;36;100;SEC_232
2003;533;65-74;71;63;134;SEC_533
2003;309;35-49;104;85;189;SEC_309
2003;538;16-17;10;8;18;SEC_538
2003;320;18-24;28;31;59;SEC_320
2003;516;25-34;74;64;138;SEC_516
2003;303;25-34;161;182;343;SEC_303
2003;533;18-24;38;49;87;SEC_533
2003;417;25-34;55;71;126;SEC_417
2003;126;00-02;15;12;27;SEC_126
2003;216;50-64;152;129;281;SEC_216
2003;632;50-64;88;81;169;SEC_632
2003;235;12-15;19;18;37;SEC_235
2003;514;00-02;10;14;24;SEC_514
2003;528;50-64;110;94;204;SEC_528
2003;321;00-02;27;30;57;SEC_321
2003;135;00-02;15;18;33;SEC_135
2003;418;25-34;113;142;255;SEC_418
2003;227;50-64;68;55;123;SEC_227
2003;218;00-02;5;6;11;SEC_218
2003;606;35-49;105;114;219;SEC_606
2003;503;03-11;27;32;59;SEC_503
2003;520;35-49;76;65;141;SEC_520
2003;226;75 i +;77;47;124;SEC_226
2003;116;03-11;55;48;103;SEC_116
2003;140;25-34;86;97;183;SEC_140
2003;119;12-15;12;23;35;SEC_119
2003;436;75 i +;30;19;49;SEC_436
2003;110;12-15;15;23;38;SEC_110
2003;439;18-24;26;50;76;SEC_439
2003;519;16-17;5;5;10;SEC_519
2003;220;65-74;69;53;122;SEC_220
2003;504;25-34;117;132;249;SEC_504
2003;242;50-64;92;95;187;SEC_242
2003;209;03-11;28;32;60;SEC_209
2003;229;00-02;7;8;15;SEC_229
2003;128;18-24;44;43;87;SEC_128
2003;122;00-02;9;12;21;SEC_122
2003;422;50-64;85;71;156;SEC_422
2003;422;16-17;8;11;19;SEC_422
2003;309;75 i +;26;17;43;SEC_309
2003;612;75 i +;44;20;64;SEC_612
2003;319;18-24;61;70;131;SEC_319
2003;230;75 i +;50;23;73;SEC_230
2003;212;65-74;83;66;149;SEC_212
2003;440;35-49;81;97;178;SEC_440
2003;231;12-15;17;13;30;SEC_231
2003;219;50-64;99;82;181;SEC_219
2003;441;18-24;113;118;231;SEC_441
2003;419;35-49;72;101;173;SEC_419
2003;304;65-74;86;65;151;SEC_304
2003;602;65-74;39;48;87;SEC_602
2003;101;25-34;187;202;389;SEC_101
2003;415;12-15;7;13;20;SEC_415
2003;302;75 i +;50;31;81;SEC_302
2003;629;50-64;59;46;105;SEC_629
2003;226;00-02;8;9;17;SEC_226
2003;307;50-64;192;182;374;SEC_307
2003;228;65-74;46;42;88;SEC_228
2003;524;35-49;124;131;255;SEC_524
2003;232;12-15;14;15;29;SEC_232
2003;410;03-11;44;68;112;SEC_410
2003;241;03-11;29;21;50;SEC_241
2003;117;35-49;242;245;487;SEC_117
2003;221;16-17;8;11;19;SEC_221
2003;602;35-49;51;51;102;SEC_602
2003;324;00-02;12;15;27;SEC_324
2003;439;65-74;61;63;124;SEC_439
2003;621;25-34;139;165;304;SEC_621
2003;204;25-34;45;55;100;SEC_204
2003;525;12-15;13;19;32;SEC_525
2003;107;25-34;160;211;371;SEC_107
2003;530;50-64;107;91;198;SEC_530
2003;235;25-34;145;144;289;SEC_235
2003;515;65-74;32;29;61;SEC_515
2003;412;00-02;19;12;31;SEC_412
2003;219;75 i +;82;48;130;SEC_219
2003;605;65-74;54;50;104;SEC_605
2003;512;50-64;81;74;155;SEC_512
2003;225;03-11;6;16;22;SEC_225
2003;215;12-15;9;13;22;SEC_215
2003;219;00-02;12;12;24;SEC_219
2003;201;25-34;54;57;111;SEC_201
2003;438;18-24;42;36;78;SEC_438
2003;439;12-15;16;18;34;SEC_439
2003;115;18-24;68;65;133;SEC_115
2003;530;25-34;131;160;291;SEC_530
2003;431;50-64;111;105;216;SEC_431
2003;131;12-15;26;17;43;SEC_131
2003;507;18-24;45;43;88;SEC_507
2003;518;75 i +;51;29;80;SEC_518
2003;216;35-49;140;111;251;SEC_216
2003;105;00-02;13;14;27;SEC_105
2003;427;16-17;4;7;11;SEC_427
2003;435;03-11;37;37;74;SEC_435
2003;435;16-17;11;15;26;SEC_435
2003;409;50-64;59;58;117;SEC_409
2003;623;03-11;48;43;91;SEC_623
2003;629;18-24;22;32;54;SEC_629
2003;105;65-74;50;33;83;SEC_105
2003;432;65-74;64;60;124;SEC_432
2003;234;16-17;6;7;13;SEC_234
2003;138;03-11;29;25;54;SEC_138
2003;529;75 i +;80;43;123;SEC_529
2003;314;12-15;38;66;104;SEC_314
2003;109;03-11;40;41;81;SEC_109
2003;409;03-11;25;16;41;SEC_409
2003;241;50-64;53;47;100;SEC_241
2003;319;16-17;11;9;20;SEC_319
2003;526;65-74;31;32;63;SEC_526
2003;129;35-49;107;115;222;SEC_129
2003;103;16-17;6;4;10;SEC_103
2003;229;16-17;6;8;14;SEC_229
2003;239;65-74;97;67;164;SEC_239
2003;527;16-17;6;10;16;SEC_527
2003;224;03-11;21;27;48;SEC_224
2003;308;12-15;26;28;54;SEC_308
2003;225;12-15;5;6;11;SEC_225
2003;530;75 i +;78;41;119;SEC_530
2003;601;03-11;40;46;86;SEC_601
2003;131;25-34;119;154;273;SEC_131
2003;427;35-49;93;106;199;SEC_427
2003;426;65-74;45;36;81;SEC_426
2003;436;35-49;86;110;196;SEC_436
2003;104;16-17;8;5;13;SEC_104
2003;524;00-02;19;13;32;SEC_524
2003;124;65-74;47;46;93;SEC_124
2003;215;35-49;90;99;189;SEC_215
2003;609;65-74;47;41;88;SEC_609
2003;615;25-34;87;107;194;SEC_615
2003;632;75 i +;30;14;44;SEC_632
2003;530;65-74;111;79;190;SEC_530
2003;219;16-17;19;11;30;SEC_219
2003;233;35-49;95;95;190;SEC_233
2003;233;25-34;77;100;177;SEC_233
2003;434;00-02;8;8;16;SEC_434
2003;531;12-15;15;14;29;SEC_531
2003;535;50-64;142;133;275;SEC_535
2003;440;12-15;5;11;16;SEC_440
2003;201;65-74;47;54;101;SEC_201
2003;609;12-15;15;10;25;SEC_609
2003;313;00-02;34;21;55;SEC_313
2003;531;75 i +;47;28;75;SEC_531
2003;222;75 i +;38;20;58;SEC_222
2003;629;25-34;47;50;97;SEC_629
2003;139;50-64;91;81;172;SEC_139
2003;617;50-64;108;86;194;SEC_617
2003;126;65-74;60;59;119;SEC_126
2003;105;16-17;14;13;27;SEC_105
2003;323;35-49;384;354;738;SEC_323
2003;619;16-17;10;18;28;SEC_619
2003;526;35-49;78;94;172;SEC_526
2003;601;65-74;74;80;154;SEC_601
2003;126;16-17;7;6;13;SEC_126
2003;137;75 i +;51;26;77;SEC_137
2003;617;12-15;19;14;33;SEC_617
2003;501;65-74;29;34;63;SEC_501
2003;508;16-17;9;5;14;SEC_508
2003;310;50-64;76;87;163;SEC_310
2003;205;75 i +;46;26;72;SEC_205
2003;421;75 i +;60;36;96;SEC_421
2003;321;35-49;285;285;570;SEC_321
2003;307;35-49;172;142;314;SEC_307
2003;217;18-24;28;31;59;SEC_217
2003;323;18-24;149;196;345;SEC_323
2003;312;75 i +;61;30;91;SEC_312
2003;627;75 i +;29;15;44;SEC_627
2003;511;03-11;27;27;54;SEC_511
2003;315;03-11;49;55;104;SEC_315
2003;413;65-74;42;36;78;SEC_413
2003;428;03-11;20;23;43;SEC_428
2003;204;75 i +;37;21;58;SEC_204
2003;115;50-64;117;127;244;SEC_115
2003;121;00-02;14;4;18;SEC_121
2003;225;50-64;59;39;98;SEC_225
2003;511;00-02;13;10;23;SEC_511
2003;510;00-02;16;6;22;SEC_510
2003;432;00-02;9;8;17;SEC_432
2003;124;25-34;80;70;150;SEC_124
2003;321;18-24;132;119;251;SEC_321
2003;128;65-74;50;52;102;SEC_128
2003;407;50-64;81;73;154;SEC_407
2003;221;75 i +;42;31;73;SEC_221
2003;231;00-02;13;15;28;SEC_231
2003;111;12-15;16;17;33;SEC_111
2003;137;25-34;139;152;291;SEC_137
2003;438;50-64;91;76;167;SEC_438
2003;623;35-49;118;111;229;SEC_623
2003;224;16-17;2;7;9;SEC_224
2003;109;00-02;11;13;24;SEC_109
2003;124;03-11;20;33;53;SEC_124
2003;136;65-74;61;41;102;SEC_136
2003;521;12-15;13;14;27;SEC_521
2003;410;65-74;136;124;260;SEC_410
2003;433;50-64;65;73;138;SEC_433
2003;210;00-02;2;7;9;SEC_210
2003;246;16-17;5;9;14;SEC_246
2003;514;65-74;56;46;102;SEC_514
2003;232;35-49;107;113;220;SEC_232
2003;317;75 i +;53;30;83;SEC_317
2003;127;18-24;44;39;83;SEC_127
2003;521;50-64;169;171;340;SEC_521
2003;239;75 i +;84;60;144;SEC_239
2003;120;65-74;53;51;104;SEC_120
2003;324;65-74;44;33;77;SEC_324
2003;138;12-15;14;15;29;SEC_138
2003;203;12-15;8;16;24;SEC_203
2003;126;35-49;62;71;133;SEC_126
2003;510;35-49;92;112;204;SEC_510
2003;628;35-49;94;88;182;SEC_628
2003;245;16-17;7;9;16;SEC_245
2003;401;65-74;97;67;164;SEC_401
2003;229;12-15;16;10;26;SEC_229
2003;410;12-15;16;19;35;SEC_410
2003;505;18-24;73;41;114;SEC_505
2003;223;75 i +;75;31;106;SEC_223
2003;533;00-02;9;15;24;SEC_533
2003;123;50-64;105;100;205;SEC_123
2003;418;50-64;116;98;214;SEC_418
2003;102;25-34;143;162;305;SEC_102
2003;515;18-24;21;17;38;SEC_515
2003;247;65-74;79;62;141;SEC_247
2003;527;12-15;26;18;44;SEC_527
2003;613;65-74;71;72;143;SEC_613
2003;213;75 i +;37;23;60;SEC_213
2003;219;18-24;45;58;103;SEC_219
2003;232;03-11;41;22;63;SEC_232
2003;303;65-74;126;140;266;SEC_303
2003;202;12-15;7;9;16;SEC_202
2003;138;35-49;91;84;175;SEC_138
2003;248;35-49;135;148;283;SEC_248
2003;219;03-11;62;44;106;SEC_219
2003;123;03-11;35;58;93;SEC_123
2003;217;03-11;17;17;34;SEC_217
2003;129;03-11;38;26;64;SEC_129
2003;207;25-34;49;52;101;SEC_207
2003;441;25-34;123;159;282;SEC_441
2003;317;25-34;135;141;276;SEC_317
2003;612;12-15;16;11;27;SEC_612
2003;428;65-74;46;31;77;SEC_428
2003;604;50-64;80;63;143;SEC_604
2003;122;25-34;90;98;188;SEC_122
2003;235;18-24;58;72;130;SEC_235
2003;407;12-15;11;21;32;SEC_407
2003;302;03-11;39;47;86;SEC_302
2003;528;03-11;36;35;71;SEC_528
2003;132;50-64;205;215;420;SEC_132
2003;411;12-15;16;11;27;SEC_411
2003;420;18-24;57;82;139;SEC_420
2003;505;50-64;216;176;392;SEC_505
2003;226;50-64;95;88;183;SEC_226
2003;140;18-24;41;50;91;SEC_140
2003;522;12-15;13;12;25;SEC_522
2003;438;75 i +;29;15;44;SEC_438
2003;201;50-64;69;46;115;SEC_201
2003;404;03-11;55;56;111;SEC_404
2003;227;35-49;67;59;126;SEC_227
2003;118;00-02;21;15;36;SEC_118
2003;204;00-02;1;5;6;SEC_204
2003;535;25-34;72;90;162;SEC_535
2003;418;18-24;52;64;116;SEC_418
2003;128;25-34;116;103;219;SEC_128
2003;316;18-24;175;198;373;SEC_316
2003;516;50-64;53;51;104;SEC_516
2003;202;35-49;72;78;150;SEC_202
2003;109;65-74;54;43;97;SEC_109
2003;403;03-11;22;20;42;SEC_403
2003;440;50-64;141;122;263;SEC_440
2003;628;03-11;33;37;70;SEC_628
2003;632;12-15;16;18;34;SEC_632
2003;114;25-34;151;144;295;SEC_114
2003;501;75 i +;17;6;23;SEC_501
2003;324;12-15;16;18;34;SEC_324
2003;121;75 i +;56;40;96;SEC_121
2003;208;25-34;127;127;254;SEC_208
2003;113;16-17;27;24;51;SEC_113
2003;520;16-17;6;8;14;SEC_520
2003;531;25-34;88;105;193;SEC_531
2003;119;03-11;30;38;68;SEC_119
2003;313;25-34;177;161;338;SEC_313
2003;137;03-11;56;64;120;SEC_137
2003;226;16-17;12;8;20;SEC_226
2003;311;00-02;15;25;40;SEC_311
2003;133;65-74;50;34;84;SEC_133
2003;515;12-15;12;14;26;SEC_515
2003;527;03-11;38;22;60;SEC_527
2003;605;35-49;48;45;93;SEC_605
2003;413;16-17;3;6;9;SEC_413
2003;204;03-11;17;11;28;SEC_204
2003;426;18-24;53;59;112;SEC_426
2003;514;50-64;53;41;94;SEC_514
2003;102;03-11;59;68;127;SEC_102
2003;413;35-49;49;67;116;SEC_413
2003;113;25-34;117;138;255;SEC_113
2003;301;35-49;245;221;466;SEC_301
2003;615;00-02;11;3;14;SEC_615
2003;511;25-34;54;70;124;SEC_511
2003;245;03-11;37;34;71;SEC_245
2003;509;35-49;84;80;164;SEC_509
2003;133;25-34;84;104;188;SEC_133
2003;324;03-11;44;39;83;SEC_324
2003;203;16-17;6;3;9;SEC_203
2003;604;12-15;13;18;31;SEC_604
2003;212;00-02;13;20;33;SEC_212
2003;621;75 i +;38;18;56;SEC_621
2003;306;25-34;128;134;262;SEC_306
2003;423;16-17;6;14;20;SEC_423
2003;413;03-11;20;18;38;SEC_413
2003;226;18-24;47;50;97;SEC_226
2003;213;18-24;37;48;85;SEC_213
2003;442;25-34;48;63;111;SEC_442
2003;403;12-15;9;16;25;SEC_403
2003;608;12-15;14;16;30;SEC_608
2003;430;50-64;74;56;130;SEC_430
2003;118;25-34;152;180;332;SEC_118
2003;506;35-49;185;176;361;SEC_506
2003;322;35-49;110;110;220;SEC_322
2003;137;00-02;15;20;35;SEC_137
2003;311;65-74;91;55;146;SEC_311
2003;109;50-64;104;105;209;SEC_109
2003;114;16-17;4;9;13;SEC_114
2003;527;65-74;66;45;111;SEC_527
2003;105;50-64;108;116;224;SEC_105
2003;603;65-74;24;22;46;SEC_603
2003;508;00-02;11;7;18;SEC_508
2003;112;03-11;63;66;129;SEC_112
2003;305;65-74;69;59;128;SEC_305
2003;238;65-74;53;43;96;SEC_238
2003;140;75 i +;53;28;81;SEC_140
2003;513;35-49;71;87;158;SEC_513
2003;133;50-64;91;77;168;SEC_133
2003;604;03-11;25;23;48;SEC_604
2003;536;18-24;30;32;62;SEC_536
2003;406;35-49;125;132;257;SEC_406
2003;302;12-15;21;12;33;SEC_302
2003;413;75 i +;37;17;54;SEC_413
2003;311;50-64;124;104;228;SEC_311
2003;315;65-74;54;45;99;SEC_315
2003;616;03-11;141;157;298;SEC_616
2003;601;35-49;122;130;252;SEC_601
2003;624;12-15;19;13;32;SEC_624
2003;632;03-11;37;38;75;SEC_632
2003;425;18-24;42;37;79;SEC_425
2003;415;75 i +;43;27;70;SEC_415
2003;615;18-24;35;25;60;SEC_615
2003;119;75 i +;58;51;109;SEC_119
2003;415;50-64;51;59;110;SEC_415
2003;245;18-24;40;46;86;SEC_245
2003;631;25-34;109;133;242;SEC_631
2003;404;35-49;124;154;278;SEC_404
2003;532;16-17;15;15;30;SEC_532
2003;525;50-64;83;73;156;SEC_525
2003;317;16-17;8;13;21;SEC_317
2003;110;16-17;16;10;26;SEC_110
2003;537;12-15;25;16;41;SEC_537
2003;529;18-24;51;56;107;SEC_529
2003;520;18-24;36;42;78;SEC_520
2003;205;12-15;12;17;29;SEC_205
2003;222;50-64;79;73;152;SEC_222
2003;212;18-24;59;50;109;SEC_212
2003;610;75 i +;48;36;84;SEC_610
2003;201;03-11;20;33;53;SEC_201
2003;308;50-64;190;178;368;SEC_308
2003;632;18-24;42;60;102;SEC_632
2003;104;00-02;7;6;13;SEC_104
2003;107;65-74;97;76;173;SEC_107
2003;630;18-24;58;63;121;SEC_630
2003;511;16-17;1;8;9;SEC_511
2003;126;12-15;13;11;24;SEC_126
2003;614;18-24;27;39;66;SEC_614
2003;104;75 i +;65;42;107;SEC_104
2003;620;75 i +;15;8;23;SEC_620
2003;135;65-74;66;60;126;SEC_135
2003;303;00-02;14;16;30;SEC_303
2003;248;25-34;100;100;200;SEC_248
2003;305;12-15;29;29;58;SEC_305
2003;237;35-49;135;168;303;SEC_237
2003;423;75 i +;51;28;79;SEC_423
2003;626;50-64;114;96;210;SEC_626
2003;231;25-34;95;99;194;SEC_231
2003;407;03-11;28;28;56;SEC_407
2003;619;00-02;11;13;24;SEC_619
2003;130;25-34;101;98;199;SEC_130
2003;505;16-17;7;6;13;SEC_505
2003;129;25-34;116;117;233;SEC_129
2003;221;35-49;114;129;243;SEC_221
2003;414;03-11;38;38;76;SEC_414
2003;218;75 i +;37;17;54;SEC_218
2003;305;50-64;122;131;253;SEC_305
2003;422;35-49;105;119;224;SEC_422
2003;322;00-02;17;25;42;SEC_322
2003;112;25-34;144;136;280;SEC_112
2003;403;75 i +;54;32;86;SEC_403
2003;248;00-02;14;14;28;SEC_248
2003;138;65-74;36;36;72;SEC_138
2003;240;03-11;21;25;46;SEC_240
2003;609;18-24;37;35;72;SEC_609
2003;512;12-15;9;13;22;SEC_512
2003;324;18-24;52;39;91;SEC_324
2003;533;75 i +;32;19;51;SEC_533
2003;612;03-11;30;40;70;SEC_612
2003;236;50-64;95;83;178;SEC_236
2003;308;00-02;23;36;59;SEC_308
2003;310;35-49;102;106;208;SEC_310
2003;111;75 i +;42;29;71;SEC_111
2003;218;65-74;37;24;61;SEC_218
2003;511;50-64;54;45;99;SEC_511
2003;507;75 i +;36;18;54;SEC_507
2003;532;00-02;16;14;30;SEC_532
2003;230;50-64;53;47;100;SEC_230
2003;424;00-02;5;7;12;SEC_424
2003;420;25-34;133;168;301;SEC_420
2003;223;35-49;122;139;261;SEC_223
2003;249;12-15;14;23;37;SEC_249
2003;620;65-74;32;40;72;SEC_620
2003;433;65-74;53;46;99;SEC_433
2003;321;75 i +;90;54;144;SEC_321
2003;621;18-24;93;109;202;SEC_621
2003;424;75 i +;20;14;34;SEC_424
2003;625;35-49;155;126;281;SEC_625
2003;124;12-15;18;20;38;SEC_124
2003;247;12-15;21;24;45;SEC_247
2003;406;16-17;13;12;25;SEC_406
2003;234;65-74;79;44;123;SEC_234
2003;528;12-15;25;13;38;SEC_528
2003;608;03-11;33;30;63;SEC_608
2003;516;16-17;6;5;11;SEC_516
2003;131;50-64;171;188;359;SEC_131
2003;523;12-15;14;24;38;SEC_523
2003;402;65-74;60;60;120;SEC_402
2003;408;25-34;66;74;140;SEC_408
2003;206;65-74;68;56;124;SEC_206
2003;307;00-02;11;13;24;SEC_307
2003;604;35-49;77;78;155;SEC_604
2003;242;16-17;7;12;19;SEC_242
2003;630;75 i +;29;18;47;SEC_630
2003;508;50-64;51;48;99;SEC_508
2003;116;50-64;185;167;352;SEC_116
2003;624;18-24;53;53;106;SEC_624
2003;209;00-02;10;10;20;SEC_209
2003;527;50-64;65;65;130;SEC_527
2003;632;35-49;91;87;178;SEC_632
2003;631;75 i +;38;19;57;SEC_631
2003;323;25-34;293;301;594;SEC_323
2003;532;65-74;84;74;158;SEC_532
2003;240;50-64;49;37;86;SEC_240
2003;129;65-74;44;52;96;SEC_129
2003;416;03-11;24;32;56;SEC_416
2003;605;00-02;10;6;16;SEC_605
2003;607;35-49;118;107;225;SEC_607
2003;112;75 i +;67;29;96;SEC_112
2003;611;65-74;90;99;189;SEC_611
2003;509;65-74;42;40;82;SEC_509
2003;214;50-64;57;40;97;SEC_214
2003;103;00-02;6;8;14;SEC_103
2003;623;18-24;78;90;168;SEC_623
2003;433;00-02;18;29;47;SEC_433
2003;211;50-64;73;69;142;SEC_211
2003;316;16-17;40;39;79;SEC_316
2003;604;18-24;35;47;82;SEC_604
2003;524;65-74;73;62;135;SEC_524
2003;223;00-02;10;10;20;SEC_223
2003;312;35-49;171;204;375;SEC_312
2003;306;50-64;146;126;272;SEC_306
2003;408;00-02;12;14;26;SEC_408
2003;434;16-17;11;4;15;SEC_434
2003;101;35-49;183;168;351;SEC_101
2003;202;25-34;70;86;156;SEC_202
2003;107;12-15;26;23;49;SEC_107
2003;238;16-17;8;7;15;SEC_238
2003;139;75 i +;24;12;36;SEC_139
2003;439;50-64;79;58;137;SEC_439
2003;515;03-11;20;14;34;SEC_515
2003;441;12-15;47;51;98;SEC_441
2003;246;50-64;71;58;129;SEC_246
2003;536;03-11;26;31;57;SEC_536
2003;114;75 i +;67;30;97;SEC_114
2003;317;65-74;52;29;81;SEC_317
2003;314;16-17;30;35;65;SEC_314
2003;529;03-11;43;37;80;SEC_529
2003;135;03-11;61;36;97;SEC_135
2003;608;75 i +;41;18;59;SEC_608
2003;503;65-74;34;21;55;SEC_503
2003;204;18-24;25;23;48;SEC_204
2003;314;18-24;139;127;266;SEC_314
2003;429;65-74;50;24;74;SEC_429
2003;632;16-17;14;11;25;SEC_632
2003;310;75 i +;37;23;60;SEC_310
2003;125;50-64;171;161;332;SEC_125
2003;504;35-49;76;88;164;SEC_504
2003;206;16-17;6;8;14;SEC_206
2003;426;35-49;107;113;220;SEC_426
2003;324;16-17;10;14;24;SEC_324
2003;603;75 i +;20;17;37;SEC_603
2003;518;35-49;103;113;216;SEC_518
2003;249;00-02;10;14;24;SEC_249
2003;311;18-24;49;52;101;SEC_311
2003;420;12-15;22;25;47;SEC_420
2003;118;12-15;44;23;67;SEC_118
2003;419;12-15;15;11;26;SEC_419
2003;501;03-11;43;37;80;SEC_501
2003;212;25-34;144;143;287;SEC_212
2003;116;00-02;15;19;34;SEC_116
2003;627;65-74;38;32;70;SEC_627
2003;617;25-34;98;114;212;SEC_617
2003;320;50-64;102;102;204;SEC_320
2003;223;65-74;71;59;130;SEC_223
2003;135;16-17;16;13;29;SEC_135
2003;531;00-02;9;11;20;SEC_531
2003;611;18-24;81;66;147;SEC_611
2003;623;65-74;54;63;117;SEC_623
2003;431;25-34;158;195;353;SEC_431
2003;243;50-64;110;94;204;SEC_243
2003;611;03-11;61;60;121;SEC_611
2003;505;12-15;13;8;21;SEC_505
2003;624;35-49;82;109;191;SEC_624
2003;136;00-02;15;21;36;SEC_136
2003;622;18-24;45;45;90;SEC_622
2003;221;25-34;105;104;209;SEC_221
2003;515;25-34;52;67;119;SEC_515
2003;514;25-34;60;72;132;SEC_514
2003;324;35-49;90;95;185;SEC_324
2003;519;75 i +;16;24;40;SEC_519
2003;631;16-17;7;9;16;SEC_631
2003;119;65-74;65;53;118;SEC_119
2003;115;35-49;148;152;300;SEC_115
2003;601;25-34;115;141;256;SEC_601
2003;526;16-17;2;5;7;SEC_526
2003;521;03-11;21;24;45;SEC_521
2003;507;00-02;15;8;23;SEC_507
2003;404;50-64;125;107;232;SEC_404
2003;240;25-34;65;81;146;SEC_240
2003;608;18-24;44;36;80;SEC_608
2003;215;75 i +;72;37;109;SEC_215
2003;417;12-15;13;7;20;SEC_417
2003;413;50-64;41;35;76;SEC_413
2003;139;18-24;39;41;80;SEC_139
2003;213;65-74;54;47;101;SEC_213
2003;402;18-24;38;31;69;SEC_402
2003;114;50-64;189;188;377;SEC_114
2003;508;75 i +;40;26;66;SEC_508
2003;103;12-15;12;5;17;SEC_103
2003;421;35-49;104;110;214;SEC_421
2003;139;16-17;6;8;14;SEC_139
2003;109;18-24;51;48;99;SEC_109
2003;309;50-64;70;68;138;SEC_309
2003;222;65-74;39;37;76;SEC_222
2003;231;16-17;9;4;13;SEC_231
2003;403;35-49;106;102;208;SEC_403
2003;424;35-49;46;58;104;SEC_424
2003;316;03-11;58;78;136;SEC_316
2003;112;00-02;21;15;36;SEC_112
2003;239;00-02;10;7;17;SEC_239
2003;132;16-17;29;17;46;SEC_132
2003;315;35-49;190;182;372;SEC_315
2003;513;75 i +;40;18;58;SEC_513
2003;506;65-74;87;87;174;SEC_506
2003;305;35-49;209;199;408;SEC_305
2003;248;16-17;9;12;21;SEC_248
2003;127;12-15;18;16;34;SEC_127
2003;509;00-02;10;9;19;SEC_509
2003;236;75 i +;68;38;106;SEC_236
2003;527;75 i +;55;28;83;SEC_527
2003;123;16-17;10;7;17;SEC_123
2003;135;75 i +;44;31;75;SEC_135
2003;502;16-17;13;14;27;SEC_502
2003;223;16-17;10;12;22;SEC_223
2003;112;18-24;82;75;157;SEC_112
2003;606;16-17;7;12;19;SEC_606
2003;206;03-11;27;35;62;SEC_206
2003;523;18-24;62;67;129;SEC_523
2003;417;35-49;71;73;144;SEC_417
2003;630;25-34;81;96;177;SEC_630
2003;610;50-64;191;157;348;SEC_610
2003;205;00-02;10;8;18;SEC_205
2003;625;75 i +;22;14;36;SEC_625
2003;201;12-15;9;7;16;SEC_201
2003;320;00-02;25;18;43;SEC_320
2003;423;00-02;15;10;25;SEC_423
2003;318;65-74;26;23;49;SEC_318
2003;522;35-49;83;87;170;SEC_522
2003;316;25-34;132;134;266;SEC_316
2003;127;75 i +;31;21;52;SEC_127
2003;215;50-64;73;57;130;SEC_215
2003;249;16-17;7;11;18;SEC_249
2003;315;12-15;21;38;59;SEC_315
2003;603;12-15;7;17;24;SEC_603
2003;236;00-02;20;17;37;SEC_236
2003;419;00-02;13;24;37;SEC_419
2003;631;18-24;50;36;86;SEC_631
2003;416;75 i +;38;24;62;SEC_416
2003;425;50-64;81;80;161;SEC_425
2003;423;12-15;16;12;28;SEC_423
2003;507;25-34;86;87;173;SEC_507
2003;116;65-74;63;62;125;SEC_116
2003;420;35-49;150;161;311;SEC_420
2003;114;18-24;92;89;181;SEC_114
2003;205;16-17;7;6;13;SEC_205
2003;616;50-64;209;221;430;SEC_616
2003;624;03-11;30;36;66;SEC_624
2003;227;03-11;21;25;46;SEC_227
2003;109;16-17;11;8;19;SEC_109
2003;535;00-02;12;11;23;SEC_535
2003;605;03-11;13;20;33;SEC_605
2003;111;25-34;79;112;191;SEC_111
2003;613;50-64;185;153;338;SEC_613
2003;304;12-15;15;19;34;SEC_304
2003;128;03-11;22;25;47;SEC_128
2003;229;50-64;65;47;112;SEC_229
2003;134;65-74;48;37;85;SEC_134
2003;239;12-15;17;14;31;SEC_239
2003;527;25-34;106;120;226;SEC_527
2003;226;35-49;112;116;228;SEC_226
2003;618;00-02;10;9;19;SEC_618
2003;601;12-15;15;25;40;SEC_601
2003;628;50-64;145;133;278;SEC_628
2003;406;50-64;132;117;249;SEC_406
2003;401;16-17;18;12;30;SEC_401
2003;110;00-02;13;12;25;SEC_110
2003;421;00-02;13;11;24;SEC_421
2003;417;16-17;7;8;15;SEC_417
2003;440;00-02;7;15;22;SEC_440
2003;503;35-49;109;81;190;SEC_503
2003;133;12-15;14;18;32;SEC_133
2003;419;16-17;8;7;15;SEC_419
2003;419;50-64;66;67;133;SEC_419
2003;225;35-49;43;55;98;SEC_225
2003;118;18-24;106;114;220;SEC_118
2003;407;75 i +;50;38;88;SEC_407
2003;507;16-17;14;11;25;SEC_507
2003;424;18-24;26;36;62;SEC_424
2003;430;35-49;98;103;201;SEC_430
2003;503;12-15;15;17;32;SEC_503
2003;117;16-17;23;23;46;SEC_117
2003;312;16-17;12;9;21;SEC_312
2003;140;03-11;21;26;47;SEC_140
2003;211;65-74;80;50;130;SEC_211
2003;136;35-49;119;125;244;SEC_136
2003;308;65-74;86;77;163;SEC_308
2003;536;65-74;69;65;134;SEC_536
2003;245;00-02;17;13;30;SEC_245
2003;203;03-11;21;30;51;SEC_203
2003;528;00-02;16;16;32;SEC_528
2003;508;35-49;54;74;128;SEC_508
2003;425;65-74;68;55;123;SEC_425
2003;218;16-17;4;11;15;SEC_218
2003;619;75 i +;51;39;90;SEC_619
2003;106;75 i +;49;24;73;SEC_106
2003;224;12-15;9;9;18;SEC_224
2003;129;12-15;15;21;36;SEC_129
2003;247;03-11;38;40;78;SEC_247
2003;416;12-15;10;11;21;SEC_416
2003;318;00-02;4;12;16;SEC_318
2003;205;18-24;44;43;87;SEC_205
2003;103;75 i +;43;21;64;SEC_103
2003;408;65-74;60;54;114;SEC_408
2003;407;25-34;75;107;182;SEC_407
2003;626;12-15;22;8;30;SEC_626
2003;535;75 i +;44;29;73;SEC_535
2003;538;12-15;13;18;31;SEC_538
2003;432;75 i +;55;38;93;SEC_432
2003;429;00-02;6;10;16;SEC_429
2003;533;12-15;27;14;41;SEC_533
2003;537;75 i +;67;38;105;SEC_537
2003;317;03-11;53;47;100;SEC_317
2003;112;65-74;67;53;120;SEC_112
2003;440;25-34;80;102;182;SEC_440
2003;428;00-02;10;6;16;SEC_428
2003;240;12-15;9;17;26;SEC_240
2003;218;25-34;58;68;126;SEC_218
2003;516;18-24;29;28;57;SEC_516
2003;627;50-64;135;154;289;SEC_627
2003;237;00-02;18;18;36;SEC_237
2003;304;35-49;124;162;286;SEC_304
2003;516;75 i +;22;11;33;SEC_516
2003;126;18-24;45;32;77;SEC_126
2003;416;65-74;53;57;110;SEC_416
2003;628;75 i +;40;18;58;SEC_628
2003;616;18-24;167;157;324;SEC_616
2003;526;12-15;10;18;28;SEC_526
2003;234;25-34;81;105;186;SEC_234
2003;623;50-64;222;192;414;SEC_623
2003;203;00-02;11;16;27;SEC_203
2003;303;16-17;7;10;17;SEC_303
2003;302;16-17;10;8;18;SEC_302
2003;309;03-11;22;35;57;SEC_309
2003;420;65-74;79;68;147;SEC_420
2003;436;16-17;10;6;16;SEC_436
2003;613;75 i +;43;19;62;SEC_613
2003;608;50-64;84;71;155;SEC_608
2003;222;00-02;8;9;17;SEC_222
2003;430;25-34;85;105;190;SEC_430
2003;139;00-02;14;17;31;SEC_139
2003;241;25-34;74;74;148;SEC_241
2003;401;75 i +;55;33;88;SEC_401
2003;308;25-34;204;179;383;SEC_308
2003;306;16-17;20;23;43;SEC_306
2003;611;75 i +;66;34;100;SEC_611
2003;137;35-49;165;153;318;SEC_137
2003;436;03-11;44;42;86;SEC_436
2003;431;65-74;87;69;156;SEC_431
2003;507;03-11;19;30;49;SEC_507
2003;405;12-15;11;11;22;SEC_405
2003;440;03-11;32;30;62;SEC_440
2003;133;03-11;23;29;52;SEC_133
2003;442;65-74;26;24;50;SEC_442
2003;406;18-24;66;55;121;SEC_406
2003;122;18-24;40;36;76;SEC_122
2003;230;25-34;81;72;153;SEC_230
2003;227;75 i +;45;25;70;SEC_227
2003;404;25-34;126;148;274;SEC_404
2003;626;03-11;29;38;67;SEC_626
2003;515;35-49;67;65;132;SEC_515
2003;128;16-17;7;7;14;SEC_128
2003;322;75 i +;46;32;78;SEC_322
2003;230;16-17;6;6;12;SEC_230
2003;228;03-11;28;22;50;SEC_228
2003;533;03-11;36;25;61;SEC_533
2003;126;03-11;32;27;59;SEC_126
2003;102;35-49;157;155;312;SEC_102
2003;206;25-34;79;101;180;SEC_206
2003;128;00-02;5;8;13;SEC_128
2003;409;16-17;2;6;8;SEC_409
2003;140;50-64;103;88;191;SEC_140
2003;401;03-11;54;45;99;SEC_401
2003;624;25-34;101;149;250;SEC_624
2003;505;35-49;98;97;195;SEC_505
2003;536;50-64;88;71;159;SEC_536
2003;513;65-74;61;50;111;SEC_513
2003;136;75 i +;57;36;93;SEC_136
2003;408;18-24;39;42;81;SEC_408
2003;617;35-49;86;95;181;SEC_617
2003;325;75 i +;154;73;227;SEC_325
2003;408;12-15;19;11;30;SEC_408
2003;421;50-64;119;92;211;SEC_421
2003;622;75 i +;40;12;52;SEC_622
2003;102;12-15;24;24;48;SEC_102
2003;405;50-64;88;65;153;SEC_405
2003;628;12-15;18;17;35;SEC_628
2003;525;18-24;41;50;91;SEC_525
2003;501;16-17;14;10;24;SEC_501
2003;421;16-17;5;7;12;SEC_421
2003;622;03-11;25;39;64;SEC_622
2003;504;18-24;42;48;90;SEC_504
2003;510;18-24;42;52;94;SEC_510
2003;441;65-74;89;78;167;SEC_441
2003;139;65-74;38;27;65;SEC_139
2003;107;35-49;187;161;348;SEC_107
2003;316;65-74;41;39;80;SEC_316
2003;302;35-49;135;126;261;SEC_302
2003;507;35-49;84;86;170;SEC_507
2003;504;16-17;5;10;15;SEC_504
2003;239;50-64;92;76;168;SEC_239
2003;416;25-34;65;81;146;SEC_416
2003;205;35-49;89;89;178;SEC_205
2003;620;35-49;58;64;122;SEC_620
2003;626;16-17;7;10;17;SEC_626
2003;240;65-74;68;50;118;SEC_240
2003;611;00-02;28;24;52;SEC_611
2003;115;12-15;17;26;43;SEC_115
2003;611;50-64;195;156;351;SEC_611
2003;537;65-74;86;60;146;SEC_537
2003;526;03-11;31;25;56;SEC_526
2003;514;35-49;69;91;160;SEC_514
2003;220;00-02;8;10;18;SEC_220
2003;132;35-49;245;236;481;SEC_132
2003;309;25-34;70;99;169;SEC_309
2003;511;12-15;13;9;22;SEC_511
2003;140;12-15;4;12;16;SEC_140
2003;312;12-15;29;25;54;SEC_312
2003;220;25-34;86;82;168;SEC_220
2003;616;35-49;292;297;589;SEC_616
2003;315;75 i +;57;32;89;SEC_315
2003;620;18-24;38;29;67;SEC_620
2003;413;00-02;6;5;11;SEC_413
2003;130;16-17;10;3;13;SEC_130
2003;127;03-11;22;27;49;SEC_127
2003;517;65-74;69;60;129;SEC_517
2003;110;50-64;187;170;357;SEC_110
2003;129;75 i +;37;17;54;SEC_129
2003;621;35-49;145;116;261;SEC_621
2003;128;75 i +;40;26;66;SEC_128
2003;314;35-49;315;296;611;SEC_314
2003;207;12-15;10;11;21;SEC_207
2003;530;12-15;25;27;52;SEC_530
2003;521;35-49;79;80;159;SEC_521
2003;518;65-74;80;83;163;SEC_518
2003;134;35-49;153;127;280;SEC_134
2003;409;35-49;75;73;148;SEC_409
2003;224;65-74;36;26;62;SEC_224
2003;304;75 i +;100;44;144;SEC_304
2003;101;18-24;73;73;146;SEC_101
2003;512;16-17;9;7;16;SEC_512
2003;534;03-11;28;28;56;SEC_534
2003;442;50-64;67;57;124;SEC_442
2003;433;16-17;11;2;13;SEC_433
2003;536;25-34;75;81;156;SEC_536
2003;310;18-24;56;50;106;SEC_310
2003;622;65-74;36;23;59;SEC_622
2003;513;00-02;12;12;24;SEC_513
2003;522;65-74;41;40;81;SEC_522
2003;616;12-15;63;79;142;SEC_616
2003;211;25-34;136;161;297;SEC_211
2003;613;18-24;43;36;79;SEC_613
2003;404;18-24;57;59;116;SEC_404
2003;214;03-11;30;27;57;SEC_214
2003;311;75 i +;84;49;133;SEC_311
2003;532;35-49;127;121;248;SEC_532
2003;422;03-11;32;41;73;SEC_422
2003;534;18-24;49;43;92;SEC_534
2003;538;75 i +;68;34;102;SEC_538
2003;414;75 i +;54;37;91;SEC_414
2003;624;50-64;172;158;330;SEC_624
2003;125;16-17;12;8;20;SEC_125
2003;305;03-11;74;48;122;SEC_305
2003;307;18-24;78;71;149;SEC_307
2003;528;65-74;60;56;116;SEC_528
2003;614;50-64;136;109;245;SEC_614
2003;116;35-49;159;147;306;SEC_116
2003;508;18-24;34;37;71;SEC_508
2003;530;00-02;13;21;34;SEC_530
2003;536;35-49;87;100;187;SEC_536
2003;513;50-64;70;53;123;SEC_513
2003;209;75 i +;87;51;138;SEC_209
2003;227;16-17;2;4;6;SEC_227
2003;402;35-49;89;97;186;SEC_402
2003;211;03-11;42;54;96;SEC_211
2003;406;25-34;102;123;225;SEC_406
2003;423;35-49;98;103;201;SEC_423
2003;404;00-02;14;24;38;SEC_404
2003;211;16-17;11;10;21;SEC_211
2003;438;65-74;51;51;102;SEC_438
2003;110;75 i +;48;28;76;SEC_110
2003;306;12-15;21;27;48;SEC_306
2003;104;50-64;71;62;133;SEC_104
2003;615;75 i +;19;14;33;SEC_615
2003;420;16-17;10;13;23;SEC_420
2003;434;12-15;14;19;33;SEC_434
2003;422;18-24;54;48;102;SEC_422
2003;213;25-34;92;92;184;SEC_213
2003;325;12-15;21;26;47;SEC_325
2003;606;00-02;11;15;26;SEC_606
2003;426;12-15;17;15;32;SEC_426
2003;305;00-02;20;17;37;SEC_305
2003;308;18-24;91;93;184;SEC_308
2003;246;12-15;10;15;25;SEC_246
2003;220;16-17;6;9;15;SEC_220
2003;505;00-02;15;18;33;SEC_505
2003;411;18-24;49;47;96;SEC_411
2003;616;16-17;37;37;74;SEC_616
2003;134;03-11;55;50;105;SEC_134
2003;234;35-49;101;99;200;SEC_234
2003;203;25-34;76;81;157;SEC_203
2003;105;18-24;59;69;128;SEC_105
2003;534;35-49;94;86;180;SEC_534
2003;226;03-11;37;41;78;SEC_226
2003;236;35-49;116;116;232;SEC_236
2003;220;75 i +;41;30;71;SEC_220
2003;103;03-11;30;31;61;SEC_103
2003;140;65-74;69;61;130;SEC_140
2003;242;03-11;25;21;46;SEC_242
2003;613;12-15;15;11;26;SEC_613
2003;419;03-11;42;42;84;SEC_419
2003;305;75 i +;92;45;137;SEC_305
2003;520;25-34;65;78;143;SEC_520
2003;235;75 i +;82;45;127;SEC_235
2003;123;18-24;52;49;101;SEC_123
2003;403;65-74;84;81;165;SEC_403
2003;516;65-74;45;35;80;SEC_516
2003;223;03-11;47;43;90;SEC_223
2003;301;65-74;124;121;245;SEC_301
2003;421;18-24;34;46;80;SEC_421
2003;122;50-64;100;79;179;SEC_122
2003;438;16-17;5;5;10;SEC_438
2003;103;65-74;45;41;86;SEC_103
2003;210;12-15;8;11;19;SEC_210
2003;112;35-49;193;167;360;SEC_112
2003;517;03-11;47;54;101;SEC_517
2003;411;65-74;93;67;160;SEC_411
2003;612;18-24;42;43;85;SEC_612
2003;505;75 i +;42;36;78;SEC_505
2003;225;16-17;3;3;6;SEC_225
2003;610;18-24;49;50;99;SEC_610
2003;310;16-17;12;10;22;SEC_310
2003;130;65-74;93;75;168;SEC_130
2003;318;75 i +;17;15;32;SEC_318
2003;611;25-34;168;203;371;SEC_611
2003;521;18-24;51;54;105;SEC_521
2003;129;16-17;9;9;18;SEC_129
2003;610;65-74;61;72;133;SEC_610
2003;415;18-24;45;36;81;SEC_415
2003;609;03-11;31;36;67;SEC_609
2003;410;50-64;192;169;361;SEC_410
2003;406;00-02;15;15;30;SEC_406
2003;428;18-24;18;22;40;SEC_428
2003;610;03-11;33;39;72;SEC_610
2003;405;00-02;8;8;16;SEC_405
2003;505;03-11;24;22;46;SEC_505
2003;411;16-17;7;5;12;SEC_411
2003;319;12-15;18;19;37;SEC_319
2003;212;75 i +;64;36;100;SEC_212
2003;536;00-02;8;11;19;SEC_536
2003;317;35-49;93;108;201;SEC_317
2003;203;50-64;59;58;117;SEC_203
2003;616;75 i +;34;22;56;SEC_616
2003;204;65-74;50;28;78;SEC_204
2003;111;50-64;108;85;193;SEC_111
2003;522;75 i +;33;19;52;SEC_522
2003;247;50-64;93;91;184;SEC_247
2003;204;16-17;5;5;10;SEC_204
2003;113;03-11;47;64;111;SEC_113
2003;136;25-34;118;135;253;SEC_136
2003;321;12-15;41;52;93;SEC_321
2003;247;25-34;111;126;237;SEC_247
2003;319;65-74;45;27;72;SEC_319
2003;310;00-02;12;16;28;SEC_310
2003;609;75 i +;28;20;48;SEC_609
2003;207;65-74;44;33;77;SEC_207
2003;231;65-74;79;59;138;SEC_231
2003;426;75 i +;56;37;93;SEC_426
2003;318;18-24;54;34;88;SEC_318
2003;618;25-34;50;58;108;SEC_618
2003;522;03-11;23;30;53;SEC_522
2003;422;00-02;12;10;22;SEC_422
2003;224;35-49;80;81;161;SEC_224
2003;437;00-02;19;8;27;SEC_437
2003;620;16-17;9;3;12;SEC_620
2003;314;03-11;87;93;180;SEC_314
2003;312;18-24;53;59;112;SEC_312
2003;532;18-24;61;67;128;SEC_532
2003;532;12-15;22;27;49;SEC_532
2003;510;25-34;82;104;186;SEC_510
2003;204;35-49;47;62;109;SEC_204
2003;427;00-02;19;22;41;SEC_427
2003;104;12-15;9;8;17;SEC_104
2003;523;35-49;137;140;277;SEC_523
2003;243;12-15;27;30;57;SEC_243
2003;214;00-02;7;9;16;SEC_214
2003;536;12-15;11;13;24;SEC_536
2003;236;12-15;18;18;36;SEC_236
2003;612;65-74;55;60;115;SEC_612
2003;617;00-02;8;13;21;SEC_617
2003;428;50-64;32;35;67;SEC_428
2003;411;25-34;69;63;132;SEC_411
2003;625;25-34;104;106;210;SEC_625
2003;418;35-49;118;141;259;SEC_418
2003;136;16-17;13;6;19;SEC_136
2003;602;03-11;16;20;36;SEC_602
2003;316;75 i +;62;34;96;SEC_316
2003;140;00-02;15;15;30;SEC_140
2003;502;25-34;132;157;289;SEC_502
2003;603;03-11;23;20;43;SEC_603
2003;322;16-17;9;7;16;SEC_322
2003;237;16-17;10;13;23;SEC_237
2003;416;35-49;67;82;149;SEC_416
2003;105;12-15;28;34;62;SEC_105
2003;101;03-11;64;59;123;SEC_101
2003;132;65-74;82;89;171;SEC_132
2003;625;16-17;15;22;37;SEC_625
2003;627;03-11;26;30;56;SEC_627
2003;529;00-02;13;17;30;SEC_529
2003;434;25-34;39;42;81;SEC_434
2003;435;18-24;43;52;95;SEC_435
2003;532;03-11;52;40;92;SEC_532
2003;408;03-11;25;32;57;SEC_408
2003;217;65-74;40;31;71;SEC_217
2003;201;00-02;4;9;13;SEC_201
2003;127;50-64;54;46;100;SEC_127
2003;605;75 i +;28;20;48;SEC_605
2003;242;18-24;40;49;89;SEC_242
2003;225;18-24;19;32;51;SEC_225
2003;414;50-64;69;68;137;SEC_414
2003;228;12-15;8;10;18;SEC_228
2003;533;25-34;98;113;211;SEC_533
2003;424;03-11;21;18;39;SEC_424
2003;201;16-17;5;11;16;SEC_201
2003;108;25-34;99;100;199;SEC_108
2003;302;65-74;57;41;98;SEC_302
2003;523;03-11;29;40;69;SEC_523
2003;519;03-11;25;34;59;SEC_519
2003;321;16-17;20;29;49;SEC_321
2003;110;18-24;52;59;111;SEC_110
2003;441;50-64;209;201;410;SEC_441
2003;620;12-15;8;19;27;SEC_620
2003;304;03-11;44;42;86;SEC_304
2003;622;12-15;18;17;35;SEC_622
2003;232;16-17;10;8;18;SEC_232
2003;245;12-15;21;20;41;SEC_245
2003;514;18-24;39;35;74;SEC_514
2003;201;75 i +;45;21;66;SEC_201
2003;130;35-49;95;116;211;SEC_130
2003;308;03-11;81;99;180;SEC_308
2003;608;35-49;95;81;176;SEC_608
2003;513;12-15;11;13;24;SEC_513
2003;117;00-02;27;30;57;SEC_117
2003;121;65-74;86;54;140;SEC_121
2003;308;16-17;14;17;31;SEC_308
2003;438;00-02;4;14;18;SEC_438
2003;618;35-49;57;56;113;SEC_618
2003;104;03-11;36;38;74;SEC_104
2003;414;00-02;13;13;26;SEC_414
2003;225;65-74;35;26;61;SEC_225
2003;537;00-02;17;6;23;SEC_537
2003;521;00-02;6;11;17;SEC_521
2003;133;18-24;43;47;90;SEC_133
2003;432;18-24;59;70;129;SEC_432
2003;432;16-17;13;13;26;SEC_432
2003;628;00-02;15;14;29;SEC_628
2003;431;35-49;142;144;286;SEC_431
2003;538;03-11;33;36;69;SEC_538
2003;526;25-34;77;88;165;SEC_526
2003;406;12-15;20;17;37;SEC_406
2003;626;75 i +;29;27;56;SEC_626
2003;133;00-02;11;13;24;SEC_133
2003;233;50-64;67;59;126;SEC_233
2003;214;25-34;80;88;168;SEC_214
2003;621;12-15;21;26;47;SEC_621
2003;525;35-49;87;85;172;SEC_525
2003;625;03-11;34;39;73;SEC_625
2003;131;18-24;80;64;144;SEC_131
2003;301;50-64;198;185;383;SEC_301
2003;609;25-34;81;110;191;SEC_609
2003;413;12-15;10;7;17;SEC_413
2003;516;00-02;10;4;14;SEC_516
2003;501;50-64;167;178;345;SEC_501
2003;116;12-15;18;27;45;SEC_116
2003;520;50-64;84;79;163;SEC_520
2003;533;35-49;93;124;217;SEC_533
2003;435;75 i +;95;48;143;SEC_435
2003;628;16-17;12;10;22;SEC_628
2003;612;35-49;75;79;154;SEC_612
2003;136;03-11;44;46;90;SEC_136
2003;234;00-02;9;8;17;SEC_234
2003;317;50-64;68;75;143;SEC_317
2003;501;18-24;63;78;141;SEC_501
2003;526;75 i +;39;21;60;SEC_526
2003;441;35-49;232;218;450;SEC_441
2003;206;35-49;99;91;190;SEC_206
2003;436;12-15;18;25;43;SEC_436
2003;431;00-02;20;23;43;SEC_431
2003;506;16-17;14;20;34;SEC_506
2003;102;75 i +;73;37;110;SEC_102
2003;623;16-17;15;15;30;SEC_623
2003;415;16-17;6;7;13;SEC_415
2003;316;12-15;64;52;116;SEC_316
2003;139;12-15;13;14;27;SEC_139
2003;203;75 i +;44;31;75;SEC_203
2003;127;25-34;72;77;149;SEC_127
2003;425;03-11;29;32;61;SEC_425
2003;604;00-02;6;12;18;SEC_604
2003;410;35-49;142;165;307;SEC_410
2003;249;75 i +;57;37;94;SEC_249
2003;228;50-64;54;49;103;SEC_228
2003;427;18-24;40;34;74;SEC_427
2003;510;75 i +;54;26;80;SEC_510
2003;530;35-49;139;154;293;SEC_530
2003;428;16-17;7;3;10;SEC_428
2003;631;35-49;78;87;165;SEC_631
2003;429;12-15;7;16;23;SEC_429
2003;437;75 i +;31;20;51;SEC_437
2003;228;00-02;5;4;9;SEC_228
2003;401;18-24;51;71;122;SEC_401
2003;314;00-02;26;30;56;SEC_314
2003;606;12-15;18;22;40;SEC_606
2003;507;50-64;87;86;173;SEC_507
2003;211;35-49;143;147;290;SEC_211
2003;535;12-15;19;23;42;SEC_535
2003;430;12-15;12;21;33;SEC_430
2003;116;25-34;129;135;264;SEC_116
2003;227;25-34;68;64;132;SEC_227
2003;517;35-49;145;144;289;SEC_517
2003;405;75 i +;41;30;71;SEC_405
2003;311;12-15;17;30;47;SEC_311
2003;404;16-17;13;9;22;SEC_404
2003;114;35-49;151;147;298;SEC_114
2003;523;75 i +;88;38;126;SEC_523
2003;307;03-11;45;43;88;SEC_307
2003;425;16-17;8;4;12;SEC_425
2003;627;16-17;10;17;27;SEC_627
2003;135;25-34;132;137;269;SEC_135
2003;503;16-17;13;10;23;SEC_503
2003;218;35-49;91;87;178;SEC_218
2003;137;50-64;150;148;298;SEC_137
2003;529;16-17;14;3;17;SEC_529
2003;613;35-49;82;88;170;SEC_613
2003;322;03-11;41;37;78;SEC_322
2003;401;25-34;87;97;184;SEC_401
2003;116;18-24;71;68;139;SEC_116
2003;127;65-74;45;41;86;SEC_127
2003;315;00-02;18;23;41;SEC_315
2003;412;12-15;16;20;36;SEC_412
2003;243;65-74;107;87;194;SEC_243
2003;518;16-17;10;10;20;SEC_518
2003;119;50-64;189;173;362;SEC_119
2003;319;03-11;46;62;108;SEC_319
2003;230;18-24;39;34;73;SEC_230
2003;502;50-64;142;149;291;SEC_502
2003;114;12-15;23;15;38;SEC_114
2003;609;50-64;125;108;233;SEC_609
2003;309;12-15;18;18;36;SEC_309
2003;423;25-34;76;101;177;SEC_423
2003;617;75 i +;27;23;50;SEC_617
2003;519;00-02;10;8;18;SEC_519
2003;111;65-74;56;45;101;SEC_111
2003;240;35-49;76;72;148;SEC_240
2003;436;50-64;61;58;119;SEC_436
2003;318;35-49;123;114;237;SEC_318
2003;519;50-64;44;37;81;SEC_519
2003;106;65-74;60;38;98;SEC_106
2003;243;75 i +;84;56;140;SEC_243
2003;404;12-15;24;23;47;SEC_404
2003;243;16-17;8;11;19;SEC_243
2003;621;65-74;53;45;98;SEC_621
2003;503;18-24;49;52;101;SEC_503
2003;222;16-17;8;13;21;SEC_222
2003;310;12-15;14;18;32;SEC_310
2003;624;16-17;6;11;17;SEC_624
2003;418;00-02;9;13;22;SEC_418
2003;236;18-24;51;47;98;SEC_236
2003;415;35-49;80;86;166;SEC_415
2003;607;18-24;39;44;83;SEC_607
2003;505;25-34;127;149;276;SEC_505
2003;621;03-11;51;52;103;SEC_621
2003;610;35-49;101;86;187;SEC_610
2003;504;65-74;89;83;172;SEC_504
2003;312;03-11;46;63;109;SEC_312
2003;627;18-24;65;70;135;SEC_627
2003;224;50-64;35;43;78;SEC_224
2003;214;16-17;6;7;13;SEC_214
2003;113;65-74;55;30;85;SEC_113
2003;537;35-49;127;128;255;SEC_537
2003;229;65-74;46;40;86;SEC_229
2003;231;75 i +;91;47;138;SEC_231
2003;625;00-02;8;12;20;SEC_625
2003;120;12-15;42;39;81;SEC_120
2003;423;18-24;41;35;76;SEC_423
2003;442;18-24;38;27;65;SEC_442
2003;434;35-49;67;61;128;SEC_434
2003;133;16-17;8;10;18;SEC_133
2003;244;18-24;25;26;51;SEC_244
2003;522;00-02;14;14;28;SEC_522
2003;305;25-34;121;123;244;SEC_305
2003;405;35-49;74;83;157;SEC_405
2003;536;75 i +;47;35;82;SEC_536
2003;516;12-15;11;11;22;SEC_516
2003;430;65-74;56;53;109;SEC_430
2003;109;25-34;85;70;155;SEC_109
2003;436;00-02;9;16;25;SEC_436
2003;117;75 i +;60;33;93;SEC_117
2003;216;16-17;15;12;27;SEC_216
2003;325;50-64;191;186;377;SEC_325
2003;210;75 i +;80;41;121;SEC_210
2003;508;25-34;58;52;110;SEC_508
2003;534;12-15;8;13;21;SEC_534
2003;506;18-24;102;104;206;SEC_506
2003;405;65-74;94;84;178;SEC_405
2003;223;25-34;98;120;218;SEC_223
2003;440;18-24;53;37;90;SEC_440
2003;522;50-64;60;53;113;SEC_522
2003;202;00-02;9;9;18;SEC_202
2003;613;00-02;19;18;37;SEC_613
2003;303;35-49;111;137;248;SEC_303
2003;603;25-34;65;79;144;SEC_603
2003;504;75 i +;50;43;93;SEC_504
2003;304;16-17;6;13;19;SEC_304
2003;108;18-24;56;48;104;SEC_108
2003;247;18-24;56;49;105;SEC_247
2003;610;00-02;17;16;33;SEC_610
2003;307;25-34;117;110;227;SEC_307
2003;411;35-49;91;91;182;SEC_411
2003;102;18-24;65;62;127;SEC_102
2003;509;50-64;67;65;132;SEC_509
2003;306;18-24;86;69;155;SEC_306
2003;209;12-15;18;22;40;SEC_209
2003;626;65-74;60;61;121;SEC_626
2003;523;16-17;8;12;20;SEC_523
2003;528;25-34;96;125;221;SEC_528
2003;121;35-49;80;107;187;SEC_121
2003;241;35-49;87;75;162;SEC_241
2003;618;50-64;70;58;128;SEC_618
2003;208;65-74;142;124;266;SEC_208
2003;535;35-49;115;106;221;SEC_535
2003;307;16-17;15;14;29;SEC_307
2003;106;50-64;209;236;445;SEC_106
2003;431;75 i +;77;39;116;SEC_431
2003;234;50-64;67;59;126;SEC_234
2003;111;03-11;24;24;48;SEC_111
2003;312;65-74;66;62;128;SEC_312
2003;301;03-11;80;91;171;SEC_301
2003;631;00-02;9;8;17;SEC_631
2003;134;12-15;22;24;46;SEC_134
2003;323;12-15;63;54;117;SEC_323
2003;234;18-24;30;41;71;SEC_234
2003;325;03-11;76;62;138;SEC_325
2003;631;65-74;49;56;105;SEC_631
2003;209;18-24;34;28;62;SEC_209
2003;433;35-49;115;106;221;SEC_433
2003;312;25-34;195;216;411;SEC_312
2003;514;03-11;29;29;58;SEC_514
2003;320;35-49;95;98;193;SEC_320
2003;113;18-24;95;84;179;SEC_113
2003;619;65-74;93;77;170;SEC_619
2003;212;16-17;11;18;29;SEC_212
2003;610;12-15;17;15;32;SEC_610
2003;224;18-24;27;28;55;SEC_224
2003;420;03-11;51;58;109;SEC_420
2003;219;35-49;130;137;267;SEC_219
2003;241;00-02;7;7;14;SEC_241
2003;442;12-15;15;15;30;SEC_442
2003;439;35-49;92;105;197;SEC_439
2003;603;50-64;79;64;143;SEC_603
2003;433;18-24;50;43;93;SEC_433
2003;243;35-49;173;185;358;SEC_243
2003;614;00-02;13;14;27;SEC_614
2003;607;03-11;33;35;68;SEC_607
2003;421;12-15;15;18;33;SEC_421
2003;440;16-17;2;5;7;SEC_440
2003;248;50-64;77;78;155;SEC_248
2003;424;16-17;7;3;10;SEC_424
2003;228;35-49;53;75;128;SEC_228
2003;119;18-24;60;74;134;SEC_119
2003;104;65-74;68;44;112;SEC_104
2003;619;18-24;66;73;139;SEC_619
2003;244;65-74;42;28;70;SEC_244
2003;402;12-15;11;10;21;SEC_402
2003;130;75 i +;65;38;103;SEC_130
2003;320;12-15;15;12;27;SEC_320
2003;323;75 i +;44;23;67;SEC_323
2003;402;25-34;84;86;170;SEC_402
2003;511;35-49;73;66;139;SEC_511
2003;217;16-17;7;4;11;SEC_217
2003;138;16-17;7;17;24;SEC_138
2003;210;50-64;85;76;161;SEC_210
2003;522;25-34;89;94;183;SEC_522
2003;606;50-64;97;62;159;SEC_606
2003;433;12-15;20;19;39;SEC_433
2003;416;16-17;5;6;11;SEC_416
2003;107;50-64;184;170;354;SEC_107
2003;522;18-24;57;46;103;SEC_522
2003;217;35-49;71;75;146;SEC_217
2003;620;25-34;46;38;84;SEC_620
2003;427;75 i +;33;36;69;SEC_427
2003;507;65-74;38;38;76;SEC_507
2003;513;16-17;4;6;10;SEC_513
2003;517;16-17;8;10;18;SEC_517
2003;140;35-49;84;89;173;SEC_140
2003;506;03-11;67;76;143;SEC_506
2003;422;75 i +;69;47;116;SEC_422
2003;244;03-11;21;21;42;SEC_244
2003;130;18-24;30;25;55;SEC_130
2003;223;12-15;15;19;34;SEC_223
2003;203;65-74;50;35;85;SEC_203
2003;243;18-24;66;51;117;SEC_243
2003;615;35-49;53;66;119;SEC_615
2003;216;18-24;61;50;111;SEC_216
2003;511;75 i +;52;31;83;SEC_511
2003;120;00-02;20;23;43;SEC_120
2003;137;65-74;51;32;83;SEC_137
2003;322;18-24;64;59;123;SEC_322
2003;519;25-34;60;73;133;SEC_519
2003;415;65-74;35;27;62;SEC_415
2003;437;25-34;79;94;173;SEC_437
2003;535;03-11;23;31;54;SEC_535
2003;233;03-11;22;31;53;SEC_233
2003;604;16-17;7;5;12;SEC_604
2003;414;12-15;12;14;26;SEC_414
2003;107;18-24;83;96;179;SEC_107
2003;105;75 i +;49;22;71;SEC_105
2003;124;75 i +;32;21;53;SEC_124
2003;108;50-64;114;111;225;SEC_108
2003;607;16-17;9;14;23;SEC_607
2003;605;50-64;93;68;161;SEC_605
2003;412;35-49;165;169;334;SEC_412
2003;623;00-02;16;27;43;SEC_623
2003;228;75 i +;44;24;68;SEC_228
2003;245;65-74;65;59;124;SEC_245
2003;604;65-74;42;34;76;SEC_604
2003;434;18-24;26;24;50;SEC_434
2003;106;35-49;222;200;422;SEC_106
2003;423;50-64;86;81;167;SEC_423
2003;120;50-64;139;142;281;SEC_120
2003;215;00-02;11;12;23;SEC_215
2003;411;00-02;5;5;10;SEC_411
2003;531;18-24;35;46;81;SEC_531
2003;202;18-24;34;31;65;SEC_202
2003;124;50-64;72;65;137;SEC_124
2003;119;16-17;18;11;29;SEC_119
2003;229;18-24;28;24;52;SEC_229
2003;427;03-11;39;38;77;SEC_427
2003;629;16-17;9;6;15;SEC_629
2003;504;00-02;9;11;20;SEC_504
2003;418;03-11;49;39;88;SEC_418
2003;626;18-24;34;34;68;SEC_626
2003;118;16-17;14;20;34;SEC_118
2003;238;25-34;82;81;163;SEC_238
2003;120;25-34;155;148;303;SEC_120
2003;628;18-24;54;51;105;SEC_628
2003;109;35-49;131;125;256;SEC_109
2003;303;18-24;54;55;109;SEC_303
2003;510;12-15;16;17;33;SEC_510
2003;246;18-24;48;35;83;SEC_246
2003;605;16-17;5;2;7;SEC_605
2003;424;65-74;36;37;73;SEC_424
2003;524;25-34;151;153;304;SEC_524
2003;518;18-24;39;39;78;SEC_518
2003;602;75 i +;19;10;29;SEC_602
2003;306;03-11;66;54;120;SEC_306
2003;535;65-74;41;48;89;SEC_535
2003;315;25-34;167;155;322;SEC_315
2003;614;25-34;85;100;185;SEC_614
2003;437;50-64;83;54;137;SEC_437
2003;538;35-49;125;116;241;SEC_538
2003;215;18-24;34;39;73;SEC_215
2003;531;03-11;25;34;59;SEC_531
2003;317;00-02;14;13;27;SEC_317
2003;311;25-34;123;147;270;SEC_311
2003;124;18-24;45;39;84;SEC_124
2003;219;65-74;74;54;128;SEC_219
2003;432;50-64;152;151;303;SEC_432
2003;521;16-17;16;7;23;SEC_521
2003;529;35-49;127;127;254;SEC_529
2003;131;16-17;8;15;23;SEC_131
2003;538;65-74;86;88;174;SEC_538
2003;320;75 i +;34;13;47;SEC_320
2003;426;25-34;90;123;213;SEC_426
2003;532;75 i +;81;46;127;SEC_532
2003;632;65-74;61;54;115;SEC_632
2003;230;65-74;47;42;89;SEC_230
2003;526;50-64;54;56;110;SEC_526
2003;138;50-64;91;88;179;SEC_138
2003;125;00-02;13;20;33;SEC_125
2003;528;16-17;7;11;18;SEC_528
2003;434;50-64;42;44;86;SEC_434
2003;213;50-64;90;84;174;SEC_213
2003;245;75 i +;63;34;97;SEC_245
2003;525;00-02;9;6;15;SEC_525
2003;512;00-02;6;13;19;SEC_512
2003;201;18-24;26;27;53;SEC_201
2003;617;03-11;29;41;70;SEC_617
2003;436;18-24;39;57;96;SEC_436
2003;630;65-74;31;29;60;SEC_630
2003;403;18-24;48;43;91;SEC_403
2003;306;35-49;157;178;335;SEC_306
2003;313;18-24;105;89;194;SEC_313
2003;113;12-15;33;33;66;SEC_113
2003;430;75 i +;60;33;93;SEC_430
2003;314;25-34;202;210;412;SEC_314
2003;439;16-17;4;9;13;SEC_439
2003;126;50-64;151;134;285;SEC_126
2003;526;00-02;5;5;10;SEC_526
2003;512;75 i +;50;26;76;SEC_512
2003;627;25-34;88;92;180;SEC_627
2003;308;75 i +;71;43;114;SEC_308
2003;427;25-34;100;109;209;SEC_427
2003;302;25-34;140;169;309;SEC_302
2003;420;00-02;19;20;39;SEC_420
2003;237;25-34;120;134;254;SEC_237
2003;208;50-64;196;156;352;SEC_208
2003;629;00-02;12;7;19;SEC_629
2003;510;65-74;63;55;118;SEC_510
2003;524;50-64;103;84;187;SEC_524
2003;432;03-11;31;38;69;SEC_432
2003;429;35-49;56;63;119;SEC_429
2003;414;35-49;97;104;201;SEC_414
2003;117;03-11;85;71;156;SEC_117
2003;418;65-74;71;54;125;SEC_418
2003;614;65-74;56;53;109;SEC_614
2003;619;35-49;147;149;296;SEC_619
2003;238;75 i +;67;30;97;SEC_238
2003;248;18-24;55;60;115;SEC_248
2003;242;00-02;11;9;20;SEC_242
2003;131;65-74;56;52;108;SEC_131
2003;627;00-02;14;10;24;SEC_627
2003;608;25-34;66;98;164;SEC_608
2003;102;50-64;189;183;372;SEC_102
2003;241;65-74;56;45;101;SEC_241
2003;247;35-49;152;164;316;SEC_247
2003;106;18-24;129;119;248;SEC_106
2003;311;16-17;7;6;13;SEC_311
2003;630;35-49;83;74;157;SEC_630
2003;123;65-74;70;76;146;SEC_123
2003;623;25-34;157;155;312;SEC_623
2003;512;03-11;28;30;58;SEC_512
2003;417;65-74;37;31;68;SEC_417
2003;615;16-17;7;8;15;SEC_615
2003;437;35-49;86;98;184;SEC_437
2003;441;16-17;32;28;60;SEC_441
2003;437;65-74;52;53;105;SEC_437
2003;304;25-34;123;139;262;SEC_304
2003;416;00-02;16;12;28;SEC_416
2003;512;25-34;64;96;160;SEC_512
2003;320;65-74;31;20;51;SEC_320
2003;215;16-17;10;8;18;SEC_215
2003;127;16-17;14;11;25;SEC_127
2003;237;50-64;116;109;225;SEC_237
2003;432;12-15;17;23;40;SEC_432
2003;416;50-64;64;49;113;SEC_416
2003;408;50-64;71;58;129;SEC_408
2003;430;00-02;16;13;29;SEC_430
2003;242;12-15;12;15;27;SEC_242
2003;216;65-74;77;65;142;SEC_216
2003;115;75 i +;54;42;96;SEC_115
2003;117;12-15;37;23;60;SEC_117
2003;606;75 i +;51;27;78;SEC_606
2003;122;12-15;18;6;24;SEC_122
2003;603;35-49;51;51;102;SEC_603
2003;232;25-34;98;99;197;SEC_232
2003;624;00-02;12;13;25;SEC_624
2003;605;18-24;24;24;48;SEC_605
2003;412;65-74;96;99;195;SEC_412
2003;123;75 i +;77;42;119;SEC_123
2003;524;03-11;58;59;117;SEC_524
2003;617;16-17;9;12;21;SEC_617
2003;423;65-74;73;68;141;SEC_423
2003;424;12-15;5;7;12;SEC_424
2003;112;12-15;26;35;61;SEC_112
2003;238;18-24;25;38;63;SEC_238
2003;632;25-34;91;111;202;SEC_632
2003;127;00-02;17;11;28;SEC_127
2003;241;12-15;20;11;31;SEC_241
2003;520;65-74;52;50;102;SEC_520
2003;220;50-64;61;45;106;SEC_220
2003;129;00-02;10;17;27;SEC_129
2003;218;18-24;26;38;64;SEC_218
2003;310;65-74;36;28;64;SEC_310
2003;502;35-49;151;148;299;SEC_502
2003;111;35-49;101;84;185;SEC_111
2003;441;03-11;61;54;115;SEC_441
2003;217;00-02;6;6;12;SEC_217
2003;513;25-34;70;68;138;SEC_513
2003;602;16-17;4;8;12;SEC_602
2003;435;50-64;79;74;153;SEC_435
2003;221;18-24;44;58;102;SEC_221
2003;114;00-02;12;21;33;SEC_114
2003;629;35-49;64;61;125;SEC_629
2003;602;12-15;9;4;13;SEC_602
2003;222;35-49;90;85;175;SEC_222
2003;235;03-11;46;41;87;SEC_235
2003;524;18-24;67;69;136;SEC_524
2003;625;12-15;35;30;65;SEC_625
2003;108;35-49;166;127;293;SEC_108
2003;321;25-34;180;177;357;SEC_321
2003;234;12-15;10;21;31;SEC_234
2003;502;65-74;73;62;135;SEC_502
2003;321;03-11;91;100;191;SEC_321
2003;202;65-74;46;42;88;SEC_202
2003;603;00-02;6;9;15;SEC_603
2003;239;16-17;3;11;14;SEC_239
2003;626;25-34;74;102;176;SEC_626
2003;233;18-24;37;30;67;SEC_233
2003;433;75 i +;42;20;62;SEC_433
2003;410;00-02;16;27;43;SEC_410
2003;435;35-49;82;113;195;SEC_435
2003;125;03-11;39;49;88;SEC_125
2003;312;00-02;11;18;29;SEC_312
2003;231;50-64;88;63;151;SEC_231
2003;208;12-15;23;20;43;SEC_208
2003;501;25-34;104;130;234;SEC_501
2003;237;65-74;89;66;155;SEC_237
2003;205;03-11;33;26;59;SEC_205
2003;229;03-11;32;32;64;SEC_229
2003;244;25-34;76;58;134;SEC_244
2003;116;75 i +;62;41;103;SEC_116
2003;419;18-24;35;35;70;SEC_419
2003;610;25-34;113;124;237;SEC_610
2003;614;16-17;6;12;18;SEC_614
2003;412;75 i +;72;46;118;SEC_412
2003;401;00-02;19;8;27;SEC_401
2003;629;65-74;40;40;80;SEC_629
2003;138;00-02;4;7;11;SEC_138
2003;603;16-17;4;3;7;SEC_603
2003;132;03-11;72;86;158;SEC_132
2003;517;00-02;13;23;36;SEC_517
2003;110;35-49;112;97;209;SEC_110
2003;242;75 i +;67;58;125;SEC_242
2003;210;18-24;40;30;70;SEC_210
2003;107;16-17;16;19;35;SEC_107
2003;517;12-15;17;22;39;SEC_517
2003;232;50-64;96;79;175;SEC_232
2003;135;50-64;154;157;311;SEC_135
2003;531;65-74;49;50;99;SEC_531
2003;230;00-02;15;13;28;SEC_230
2003;113;50-64;141;161;302;SEC_113
2003;103;25-34;71;65;136;SEC_103
2003;121;25-34;82;68;150;SEC_121
2003;225;00-02;2;4;6;SEC_225
2003;510;50-64;112;92;204;SEC_510
2003;613;25-34;131;156;287;SEC_613
2003;625;65-74;47;51;98;SEC_625
2003;227;18-24;27;23;50;SEC_227
2003;515;50-64;49;44;93;SEC_515
2003;417;75 i +;34;19;53;SEC_417
2003;307;75 i +;80;44;124;SEC_307
2003;618;03-11;19;26;45;SEC_618
2003;320;25-34;116;125;241;SEC_320
2003;305;18-24;80;75;155;SEC_305
2003;401;50-64;96;92;188;SEC_401
2003;428;35-49;67;70;137;SEC_428
2003;246;00-02;18;18;36;SEC_246
2003;534;16-17;7;9;16;SEC_534
2003;113;00-02;8;23;31;SEC_113
2003;534;00-02;8;14;22;SEC_534
2003;104;25-34;79;89;168;SEC_104
2003;522;16-17;6;8;14;SEC_522
2003;313;75 i +;71;35;106;SEC_313
2003;414;16-17;6;9;15;SEC_414
2003;220;35-49;105;106;211;SEC_220
2003;409;75 i +;22;20;42;SEC_409
2003;520;75 i +;48;33;81;SEC_520
2003;106;25-34;167;187;354;SEC_106
2003;401;12-15;20;32;52;SEC_401
2003;523;65-74;92;84;176;SEC_523
2003;323;00-02;50;38;88;SEC_323
2003;248;75 i +;70;35;105;SEC_248
2003;136;50-64;108;116;224;SEC_136
2003;322;12-15;18;20;38;SEC_322
2003;422;12-15;14;20;34;SEC_422
2003;432;35-49;112;119;231;SEC_432
2003;310;03-11;31;33;64;SEC_310
2003;509;75 i +;29;17;46;SEC_509
2003;207;18-24;32;23;55;SEC_207
2003;414;18-24;28;47;75;SEC_414
2003;429;25-34;31;52;83;SEC_429
2003;537;03-11;39;43;82;SEC_537
2003;205;50-64;84;71;155;SEC_205
2003;227;00-02;11;7;18;SEC_227
2003;619;50-64;150;131;281;SEC_619
2003;532;25-34;141;148;289;SEC_532
2003;249;35-49;129;129;258;SEC_249
2003;238;03-11;22;26;48;SEC_238
2003;134;50-64;115;113;228;SEC_134
2003;438;35-49;95;93;188;SEC_438
2003;602;50-64;64;58;122;SEC_602
2003;437;16-17;7;9;16;SEC_437
2003;245;50-64;79;65;144;SEC_245
2003;117;25-34;182;192;374;SEC_117
2003;601;16-17;8;10;18;SEC_601
2003;439;25-34;109;142;251;SEC_439
2003;527;35-49;131;132;263;SEC_527
2003;622;25-34;78;97;175;SEC_622
2003;222;03-11;43;37;80;SEC_222
2003;208;00-02;15;14;29;SEC_208
2003;240;16-17;3;4;7;SEC_240
2003;131;00-02;8;23;31;SEC_131
2003;410;75 i +;83;66;149;SEC_410
2003;115;00-02;14;14;28;SEC_115
2003;131;75 i +;51;34;85;SEC_131
2003;431;16-17;6;9;15;SEC_431
2003;601;50-64;164;150;314;SEC_601
2003;108;03-11;40;48;88;SEC_108
2003;412;50-64;189;173;362;SEC_412
2003;138;18-24;40;52;92;SEC_138
2003;214;75 i +;29;15;44;SEC_214
2003;224;00-02;9;7;16;SEC_224
2003;130;00-02;16;15;31;SEC_130
2003;413;18-24;28;17;45;SEC_413
2003;313;50-64;181;167;348;SEC_313
2003;419;75 i +;40;21;61;SEC_419
2003;111;18-24;42;40;82;SEC_111
2003;509;18-24;36;27;63;SEC_509
2003;209;16-17;4;7;11;SEC_209
2003;325;00-02;17;24;41;SEC_325
2003;623;75 i +;54;30;84;SEC_623
2003;137;16-17;11;14;25;SEC_137
2003;315;18-24;74;86;160;SEC_315
2003;207;35-49;70;64;134;SEC_207
2003;249;50-64;86;70;156;SEC_249
2003;243;00-02;16;22;38;SEC_243
2003;244;35-49;80;87;167;SEC_244
2003;218;12-15;8;15;23;SEC_218
2003;442;35-49;71;57;128;SEC_442
2003;325;18-24;77;76;153;SEC_325
2003;529;25-34;108;135;243;SEC_529
2003;203;18-24;30;36;66;SEC_203
2003;301;25-34;261;256;517;SEC_301
2003;248;12-15;16;23;39;SEC_248
2003;402;03-11;29;29;58;SEC_402
2003;240;00-02;9;14;23;SEC_240
2003;516;35-49;69;89;158;SEC_516
2003;311;03-11;38;47;85;SEC_311
2003;237;12-15;20;21;41;SEC_237
2003;120;16-17;19;22;41;SEC_120
2003;219;12-15;14;20;34;SEC_219
2003;503;50-64;98;109;207;SEC_503
2003;322;65-74;54;58;112;SEC_322
2003;430;16-17;6;7;13;SEC_430
2003;233;12-15;9;15;24;SEC_233
2003;504;12-15;10;15;25;SEC_504
2003;239;03-11;31;42;73;SEC_239
2003;314;65-74;69;66;135;SEC_314
2003;405;16-17;8;3;11;SEC_405
2003;404;75 i +;63;27;90;SEC_404
2003;323;65-74;82;52;134;SEC_323
2003;242;35-49;114;112;226;SEC_242
2003;308;35-49;213;240;453;SEC_308
2003;417;00-02;5;12;17;SEC_417
2003;430;18-24;55;39;94;SEC_430
2003;134;25-34;104;96;200;SEC_134
2003;116;16-17;18;7;25;SEC_116
2003;430;03-11;29;50;79;SEC_430
2003;113;35-49;188;149;337;SEC_113
2003;502;18-24;85;73;158;SEC_502
2003;506;75 i +;65;40;105;SEC_506
2003;110;65-74;64;42;106;SEC_110
2003;425;00-02;13;7;20;SEC_425
2003;109;75 i +;57;35;92;SEC_109
2003;231;35-49;118;109;227;SEC_231
2003;126;25-34;118;127;245;SEC_126
2003;316;00-02;4;21;25;SEC_316
2003;213;03-11;19;35;54;SEC_213
2003;420;75 i +;71;38;109;SEC_420
2003;243;25-34;146;124;270;SEC_243
2003;613;16-17;8;7;15;SEC_613
2003;523;00-02;21;11;32;SEC_523
2003;229;25-34;66;90;156;SEC_229
2003;518;12-15;19;17;36;SEC_518
2003;137;18-24;82;57;139;SEC_137
2003;208;03-11;39;50;89;SEC_208
2003;324;50-64;70;72;142;SEC_324
2003;249;25-34;100;123;223;SEC_249
2003;628;65-74;46;56;102;SEC_628
2003;609;16-17;11;5;16;SEC_609
2003;530;18-24;49;67;116;SEC_530
2003;429;50-64;53;63;116;SEC_429
2003;123;12-15;25;25;50;SEC_123
2003;113;75 i +;42;24;66;SEC_113
2003;435;65-74;85;43;128;SEC_435
2003;525;75 i +;40;27;67;SEC_525
2003;102;16-17;18;15;33;SEC_102
2003;418;12-15;17;21;38;SEC_418
2003;436;25-34;105;128;233;SEC_436
2003;626;35-49;90;89;179;SEC_626
2003;247;16-17;17;15;32;SEC_247
2003;111;00-02;10;12;22;SEC_111
2003;134;00-02;7;13;20;SEC_134
2003;139;03-11;36;41;77;SEC_139
2003;133;35-49;87;90;177;SEC_133
2003;225;25-34;33;45;78;SEC_225
2003;511;65-74;58;46;104;SEC_511
2003;130;12-15;13;18;31;SEC_130
2003;217;25-34;47;50;97;SEC_217
2003;612;50-64;151;121;272;SEC_612
2003;319;75 i +;33;22;55;SEC_319
2003;128;50-64;99;78;177;SEC_128
2003;524;16-17;10;15;25;SEC_524
2003;206;12-15;14;14;28;SEC_206
2003;509;03-11;25;42;67;SEC_509
2003;618;12-15;10;12;22;SEC_618
2003;214;18-24;32;30;62;SEC_214
2003;629;12-15;12;6;18;SEC_629
2003;125;25-34;158;181;339;SEC_125
2003;132;18-24;118;128;246;SEC_132
2003;619;12-15;18;25;43;SEC_619
2003;431;18-24;90;80;170;SEC_431
2003;217;75 i +;42;15;57;SEC_217
2003;309;18-24;32;33;65;SEC_309
2003;306;65-74;100;73;173;SEC_306
2003;209;50-64;70;73;143;SEC_209
2003;507;12-15;18;16;34;SEC_507
2003;519;18-24;37;36;73;SEC_519
2003;114;65-74;79;70;149;SEC_114
2003;426;16-17;9;12;21;SEC_426
2003;427;65-74;73;40;113;SEC_427
2003;301;16-17;23;26;49;SEC_301
2003;428;25-34;48;58;106;SEC_428
2003;221;00-02;7;12;19;SEC_221
2003;431;03-11;46;63;109;SEC_431
2003;501;00-02;14;17;31;SEC_501
2003;506;00-02;17;16;33;SEC_506
2003;614;35-49;87;84;171;SEC_614
2003;125;18-24;51;77;128;SEC_125
2003;529;65-74;82;84;166;SEC_529
2003;609;00-02;7;8;15;SEC_609
2003;215;03-11;31;28;59;SEC_215
2003;301;18-24;90;108;198;SEC_301
2003;309;16-17;4;4;8;SEC_309
2003;213;00-02;6;15;21;SEC_213
2003;309;65-74;32;22;54;SEC_309
2003;234;03-11;32;26;58;SEC_234
2003;236;65-74;79;60;139;SEC_236
2003;414;25-34;87;89;176;SEC_414
2003;412;03-11;47;42;89;SEC_412
2003;208;18-24;69;81;150;SEC_208
2003;619;03-11;40;46;86;SEC_619
2003;301;75 i +;76;45;121;SEC_301
2003;244;16-17;5;4;9;SEC_244
2003;409;65-74;42;32;74;SEC_409
2003;202;16-17;4;7;11;SEC_202
2003;620;00-02;5;7;12;SEC_620
2003;520;12-15;14;14;28;SEC_520
2003;238;00-02;7;9;16;SEC_238
2003;323;03-11;137;131;268;SEC_323
2003;129;18-24;60;52;112;SEC_129
2003;630;03-11;16;29;45;SEC_630
2003;123;25-34;107;111;218;SEC_123
2003;209;25-34;72;82;154;SEC_209
2003;408;75 i +;39;23;62;SEC_408
2003;439;00-02;19;19;38;SEC_439
2003;117;50-64;198;199;397;SEC_117
2003;125;75 i +;45;32;77;SEC_125
2003;135;12-15;27;29;56;SEC_135
2003;624;75 i +;36;17;53;SEC_624
2003;425;75 i +;63;31;94;SEC_425
2003;121;16-17;4;3;7;SEC_121
2003;240;75 i +;46;32;78;SEC_240
2003;440;75 i +;59;41;100;SEC_440
2003;246;35-49;99;126;225;SEC_246
2003;534;50-64;94;84;178;SEC_534
2003;215;25-34;84;74;158;SEC_215
2003;105;35-49;153;125;278;SEC_105
2003;120;03-11;73;73;146;SEC_120
2003;505;65-74;68;68;136;SEC_505
2003;325;16-17;15;10;25;SEC_325
2003;437;03-11;29;36;65;SEC_437
2003;408;35-49;101;116;217;SEC_408
2003;210;16-17;5;6;11;SEC_210
2003;528;75 i +;51;35;86;SEC_528
2003;202;50-64;69;65;134;SEC_202
2003;306;75 i +;82;59;141;SEC_306
2003;516;03-11;25;37;62;SEC_516
2003;132;12-15;33;39;72;SEC_132
2003;103;18-24;36;30;66;SEC_103
2003;514;16-17;12;5;17;SEC_514
2003;235;35-49;135;142;277;SEC_235
2003;409;12-15;8;14;22;SEC_409
2003;601;75 i +;65;30;95;SEC_601
2003;611;35-49;153;180;333;SEC_611
2003;521;25-34;91;113;204;SEC_521
2003;517;25-34;116;131;247;SEC_517
2003;510;16-17;10;8;18;SEC_510
2003;606;25-34;96;95;191;SEC_606
2003;520;00-02;7;10;17;SEC_520
2003;602;25-34;52;68;120;SEC_602
2003;616;65-74;52;58;110;SEC_616
2003;212;35-49;131;146;277;SEC_212
2003;103;35-49;84;79;163;SEC_103
2003;138;25-34;63;57;120;SEC_138
2003;535;18-24;62;64;126;SEC_535
2003;610;16-17;7;13;20;SEC_610
2003;618;16-17;10;4;14;SEC_618
2003;202;03-11;17;26;43;SEC_202
2003;533;50-64;79;61;140;SEC_533
2003;602;00-02;7;8;15;SEC_602
2003;245;25-34;112;116;228;SEC_245
2003;315;16-17;12;16;28;SEC_315
2003;502;12-15;27;23;50;SEC_502
2003;437;18-24;38;32;70;SEC_437
2003;212;12-15;23;15;38;SEC_212
2003;120;35-49;234;223;457;SEC_120
2003;525;25-34;73;94;167;SEC_525
2003;140;16-17;3;9;12;SEC_140
2003;601;00-02;13;14;27;SEC_601
2003;223;50-64;98;92;190;SEC_223
2003;115;03-11;52;61;113;SEC_115
2003;515;75 i +;25;12;37;SEC_515
2003;628;25-34;85;104;189;SEC_628
2003;249;65-74;77;52;129;SEC_249
2003;222;18-24;49;51;100;SEC_222
2003;614;75 i +;28;20;48;SEC_614
2003;119;35-49;127;118;245;SEC_119
2003;612;25-34;104;127;231;SEC_612
2003;216;75 i +;60;39;99;SEC_216
2003;405;18-24;37;32;69;SEC_405
2003;442;16-17;6;8;14;SEC_442
2003;233;75 i +;64;23;87;SEC_233
2003;124;35-49;101;82;183;SEC_124
2003;214;35-49;74;72;146;SEC_214
2003;118;50-64;189;210;399;SEC_118
2003;418;75 i +;69;40;109;SEC_418
2003;229;75 i +;53;23;76;SEC_229
2003;210;65-74;87;62;149;SEC_210
2003;249;18-24;43;43;86;SEC_249
2003;517;18-24;59;53;112;SEC_517
2003;209;65-74;69;54;123;SEC_209
2003;125;12-15;30;24;54;SEC_125
2003;220;03-11;27;23;50;SEC_220
2003;435;12-15;26;16;42;SEC_435
2003;411;75 i +;63;50;113;SEC_411
2003;237;75 i +;61;27;88;SEC_237
2003;233;65-74;45;46;91;SEC_233
2003;125;35-49;150;144;294;SEC_125
2003;112;50-64;158;155;313;SEC_112
2003;538;00-02;7;27;34;SEC_538
2003;319;00-02;25;27;52;SEC_319
2003;502;03-11;48;48;96;SEC_502
2003;127;35-49;103;103;206;SEC_127
2003;118;75 i +;52;25;77;SEC_118
2003;207;03-11;14;26;40;SEC_207
2003;411;50-64;114;92;206;SEC_411
2003;525;03-11;26;28;54;SEC_525
2003;246;65-74;69;56;125;SEC_246
2003;121;18-24;30;20;50;SEC_121
2003;429;03-11;14;20;34;SEC_429
2003;519;35-49;54;57;111;SEC_519
2003;624;65-74;46;43;89;SEC_624
2003;616;25-34;234;272;506;SEC_616
2003;112;16-17;17;15;32;SEC_112
2003;612;00-02;14;16;30;SEC_612
2003;439;75 i +;44;23;67;SEC_439
2003;617;18-24;41;48;89;SEC_617
2003;318;25-34;64;76;140;SEC_318
2003;230;35-49;82;114;196;SEC_230
2003;530;16-17;10;11;21;SEC_530
2003;417;50-64;59;42;101;SEC_417
2003;210;35-49;79;84;163;SEC_210
2003;622;16-17;10;11;21;SEC_622
2003;419;25-34;84;95;179;SEC_419
2003;122;65-74;48;55;103;SEC_122
2003;403;25-34;70;91;161;SEC_403
2003;537;16-17;8;11;19;SEC_537
2003;224;75 i +;30;12;42;SEC_224
2003;528;35-49;129;120;249;SEC_528
2003;410;18-24;84;84;168;SEC_410
2003;425;12-15;18;26;44;SEC_425
2003;442;00-02;7;6;13;SEC_442
2003;606;03-11;36;45;81;SEC_606
2003;207;00-02;4;5;9;SEC_207
2003;521;65-74;60;51;111;SEC_521
2003;128;12-15;15;24;39;SEC_128
2003;512;18-24;22;40;62;SEC_512
2003;615;03-11;22;22;44;SEC_615
2003;602;18-24;26;20;46;SEC_602
2003;406;75 i +;44;39;83;SEC_406
2003;629;03-11;17;23;40;SEC_629
2003;429;16-17;4;8;12;SEC_429
2003;408;16-17;10;6;16;SEC_408
2003;233;00-02;12;6;18;SEC_233
2003;413;25-34;55;62;117;SEC_413
2003;526;18-24;29;39;68;SEC_526
2003;138;75 i +;26;14;40;SEC_138
2003;246;75 i +;71;39;110;SEC_246
2003;536;16-17;8;8;16;SEC_536
2003;125;65-74;53;57;110;SEC_125
2003;513;18-24;41;20;61;SEC_513
2003;320;16-17;9;13;22;SEC_320
2003;210;25-34;72;74;146;SEC_210
2003;304;18-24;46;45;91;SEC_304
2003;221;50-64;89;82;171;SEC_221
2003;206;50-64;65;65;130;SEC_206
2003;312;50-64;199;146;345;SEC_312
2003;107;03-11;45;56;101;SEC_107
2003;532;50-64;137;118;255;SEC_532
2003;529;50-64;102;85;187;SEC_529
2003;403;16-17;17;8;25;SEC_403
2003;425;35-49;97;107;204;SEC_425
2003;615;50-64;152;111;263;SEC_615
2003;428;12-15;8;10;18;SEC_428
2003;302;00-02;13;18;31;SEC_302
2003;405;03-11;27;34;61;SEC_405
2003;221;03-11;48;38;86;SEC_221
2003;533;16-17;12;10;22;SEC_533
2003;131;35-49;148;139;287;SEC_131
2003;228;18-24;35;35;70;SEC_228
2003;538;50-64;113;85;198;SEC_538
2003;137;12-15;30;18;48;SEC_137
2003;121;03-11;37;46;83;SEC_121
2003;223;18-24;41;52;93;SEC_223
2003;325;25-34;120;136;256;SEC_325
2003;120;75 i +;52;24;76;SEC_120
2003;220;18-24;39;38;77;SEC_220
2003;318;50-64;71;78;149;SEC_318
2003;617;65-74;63;53;116;SEC_617
2003;108;00-02;17;12;29;SEC_108
2003;402;00-02;10;9;19;SEC_402
2003;606;65-74;77;69;146;SEC_606
2003;432;25-34;98;114;212;SEC_432
2003;106;12-15;32;31;63;SEC_106
2003;242;25-34;76;101;177;SEC_242
2003;631;50-64;172;140;312;SEC_631
2003;415;00-02;10;8;18;SEC_415
2003;611;12-15;28;24;52;SEC_611
2003;423;03-11;29;36;65;SEC_423
2003;527;00-02;24;9;33;SEC_527
2003;303;75 i +;79;52;131;SEC_303
2003;403;00-02;11;9;20;SEC_403
2003;115;25-34;107;132;239;SEC_115
2003;324;25-34;92;97;189;SEC_324
2003;231;03-11;37;35;72;SEC_231
2003;441;75 i +;74;63;137;SEC_441
2003;105;03-11;29;47;76;SEC_105
2003;518;03-11;33;31;64;SEC_518
2003;601;18-24;58;69;127;SEC_601
2003;235;50-64;114;98;212;SEC_235
2003;421;03-11;26;32;58;SEC_421
2003;124;00-02;9;10;19;SEC_124
2003;418;16-17;10;16;26;SEC_418
2003;612;16-17;6;8;14;SEC_612
2003;238;50-64;63;62;125;SEC_238
2003;301;12-15;33;38;71;SEC_301
2003;218;03-11;28;26;54;SEC_218
2003;315;50-64;122;140;262;SEC_315
2003;318;16-17;9;18;27;SEC_318
2003;305;16-17;26;18;44;SEC_305
2003;614;03-11;27;35;62;SEC_614
2003;604;25-34;55;86;141;SEC_604
2003;311;35-49;129;139;268;SEC_311
2003;248;65-74;64;57;121;SEC_248
2003;525;16-17;9;7;16;SEC_525
2003;139;25-34;92;93;185;SEC_139
2003;206;18-24;38;32;70;SEC_206
2003;523;50-64;120;107;227;SEC_523
2003;239;18-24;46;35;81;SEC_239
2003;410;16-17;7;10;17;SEC_410
2003;538;18-24;35;54;89;SEC_538
2003;102;65-74;95;85;180;SEC_102
2003;206;00-02;6;8;14;SEC_206
2003;108;12-15;22;26;48;SEC_108
2003;228;25-34;88;97;185;SEC_228
2003;417;03-11;24;18;42;SEC_417
2003;427;12-15;13;23;36;SEC_427
2003;515;16-17;7;10;17;SEC_515
2003;118;35-49;196;149;345;SEC_118
2003;438;25-34;90;90;180;SEC_438
2003;241;16-17;6;3;9;SEC_241
2003;303;12-15;17;15;32;SEC_303
2003;119;25-34;109;118;227;SEC_119
2003;105;25-34;117;104;221;SEC_105
2003;247;75 i +;65;34;99;SEC_247
2003;207;75 i +;69;28;97;SEC_207
2003;618;65-74;24;23;47;SEC_618
2003;325;35-49;207;169;376;SEC_325
2003;306;00-02;16;20;36;SEC_306
2003;426;00-02;10;9;19;SEC_426
2003;417;18-24;29;23;52;SEC_417
2003;108;16-17;14;6;20;SEC_108
2003;409;18-24;34;35;69;SEC_409
2003;220;12-15;10;15;25;SEC_220
2003;433;03-11;44;47;91;SEC_433
2003;213;35-49;91;97;188;SEC_213
2003;120;18-24;69;86;155;SEC_120
2003;211;18-24;47;59;106;SEC_211
2003;320;03-11;34;34;68;SEC_320
2003;531;35-49;80;96;176;SEC_531
2003;134;75 i +;64;30;94;SEC_134
2003;237;03-11;45;33;78;SEC_237
2003;407;16-17;2;11;13;SEC_407
2003;434;65-74;43;27;70;SEC_434
2003;512;65-74;44;51;95;SEC_512
2003;501;35-49;114;94;208;SEC_501
2003;608;16-17;8;13;21;SEC_608
2003;506;25-34;153;168;321;SEC_506
2003;128;35-49;95;100;195;SEC_128
2003;117;65-74;69;65;134;SEC_117
2003;134;18-24;49;59;108;SEC_134
2003;518;00-02;18;24;42;SEC_518
2003;136;12-15;14;20;34;SEC_136
2003;209;35-49;107;107;214;SEC_209
2003;241;75 i +;54;30;84;SEC_241
2003;325;65-74;126;101;227;SEC_325
2003;523;25-34;113;117;230;SEC_523
2003;132;00-02;34;26;60;SEC_132
2003;519;65-74;45;36;81;SEC_519
2003;229;35-49;73;76;149;SEC_229
2003;605;25-34;72;70;142;SEC_605
2003;435;25-34;67;80;147;SEC_435
2003;424;25-34;51;73;124;SEC_424
2003;439;03-11;39;41;80;SEC_439
2003;235;16-17;6;8;14;SEC_235
2003;249;03-11;34;42;76;SEC_249
2003;415;03-11;23;32;55;SEC_415
2003;403;50-64;135;111;246;SEC_403
2003;208;16-17;17;11;28;SEC_208
2003;314;50-64;191;215;406;SEC_314
2003;133;75 i +;56;31;87;SEC_133
2003;534;25-34;92;123;215;SEC_534
2003;627;12-15;15;21;36;SEC_627
2003;321;65-74;82;75;157;SEC_321
2003;607;25-34;83;93;176;SEC_607
2003;318;03-11;33;42;75;SEC_318
2003;407;65-74;82;63;145;SEC_407
2003;504;50-64;144;118;262;SEC_504
2003;620;03-11;21;27;48;SEC_620
2003;121;50-64;41;41;82;SEC_121
2003;235;00-02;21;22;43;SEC_235
2003;401;35-49;149;143;292;SEC_401
2003;630;50-64;129;121;250;SEC_630
2003;132;25-34;171;194;365;SEC_132
2003;313;35-49;199;186;385;SEC_313
2003;425;25-34;80;78;158;SEC_425
2003;106;03-11;54;55;109;SEC_106
2003;232;18-24;51;50;101;SEC_232
2003;618;18-24;24;21;45;SEC_618
2003;208;75 i +;126;88;214;SEC_208
2003;205;65-74;62;56;118;SEC_205
2003;243;03-11;55;57;112;SEC_243
2003;119;00-02;7;15;22;SEC_119
2003;230;12-15;14;22;36;SEC_230
2003;233;16-17;8;5;13;SEC_233
2003;211;75 i +;87;48;135;SEC_211
2003;213;16-17;15;11;26;SEC_213
2003;621;16-17;12;13;25;SEC_621
2003;412;18-24;84;88;172;SEC_412
2003;405;25-34;83;77;160;SEC_405
2003;304;50-64;114;96;210;SEC_304
2003;607;75 i +;39;23;62;SEC_607
2003;521;75 i +;43;27;70;SEC_521
2003;207;50-64;64;58;122;SEC_207
2003;618;75 i +;21;15;36;SEC_618
2003;238;35-49;80;88;168;SEC_238
2003;316;50-64;261;278;539;SEC_316
2003;616;00-02;47;53;100;SEC_616
2003;614;12-15;12;21;33;SEC_614
2003;204;12-15;6;8;14;SEC_204
2003;524;75 i +;69;30;99;SEC_524
2003;622;35-49;91;80;171;SEC_622
2003;210;03-11;27;19;46;SEC_210
2003;237;18-24;53;45;98;SEC_237
2003;534;75 i +;55;25;80;SEC_534
2003;427;50-64;65;53;118;SEC_427
2003;607;50-64;121;92;213;SEC_607
2003;534;65-74;59;60;119;SEC_534
2003;231;18-24;36;38;74;SEC_231
2003;406;65-74;79;79;158;SEC_406
2003;503;75 i +;32;14;46;SEC_503
2003;302;50-64;183;184;367;SEC_302
2003;318;12-15;27;17;44;SEC_318
2003;502;75 i +;79;47;126;SEC_502
2003;422;65-74;69;60;129;SEC_422
2003;322;25-34;142;155;297;SEC_322
2003;103;50-64;63;59;122;SEC_103
2003;122;35-49;76;91;167;SEC_122
2003;124;16-17;5;8;13;SEC_124
2003;421;25-34;102;110;212;SEC_421
2003;324;75 i +;50;25;75;SEC_324
2003;304;00-02;17;15;32;SEC_304
2003;111;16-17;6;5;11;SEC_111
2003;411;03-11;27;23;50;SEC_411
2003;619;25-34;101;118;219;SEC_619
2003;630;16-17;13;5;18;SEC_630
2003;101;16-17;16;15;31;SEC_101
2003;537;25-34;106;107;213;SEC_537
2003;224;25-34;66;62;128;SEC_224
2003;402;50-64;68;70;138;SEC_402
2003;517;50-64;91;82;173;SEC_517
2003;110;03-11;27;36;63;SEC_110
2003;626;00-02;8;17;25;SEC_626
2003;607;00-02;13;9;22;SEC_607
2003;214;12-15;13;4;17;SEC_214
2003;404;65-74;82;72;154;SEC_404
2003;134;16-17;11;24;35;SEC_134
2003;228;16-17;5;4;9;SEC_228
2003;215;65-74;60;34;94;SEC_215
2003;313;12-15;32;27;59;SEC_313
2003;518;25-34;104;105;209;SEC_518
2003;529;12-15;17;27;44;SEC_529
2003;101;65-74;44;45;89;SEC_101
2003;227;12-15;5;3;8;SEC_227
2003;208;35-49;192;182;374;SEC_208
2003;414;65-74;59;53;112;SEC_414
2003;323;50-64;280;332;612;SEC_323
2003;221;65-74;80;68;148;SEC_221
2003;422;25-34;93;99;192;SEC_422
2003;218;50-64;77;68;145;SEC_218
2003;317;18-24;44;54;98;SEC_317
2003;321;50-64;267;263;530;SEC_321
2003;524;12-15;21;21;42;SEC_524
2003;226;25-34;118;124;242;SEC_226
2003;131;03-11;41;45;86;SEC_131
2003;409;25-34;73;96;169;SEC_409
2003;513;03-11;26;21;47;SEC_513
2003;232;65-74;63;46;109;SEC_232
2003;101;50-64;116;132;248;SEC_101
2003;115;65-74;75;42;117;SEC_115
2003;126;75 i +;54;23;77;SEC_126
2003;608;00-02;7;7;14;SEC_608
2003;506;50-64;251;223;474;SEC_506
2003;535;16-17;12;15;27;SEC_535
2003;615;12-15;6;10;16;SEC_615
2003;248;03-11;41;40;81;SEC_248
2003;429;75 i +;34;25;59;SEC_429
2003;537;50-64;135;119;254;SEC_537
2003;625;50-64;159;171;330;SEC_625
2003;245;35-49;120;124;244;SEC_245
2003;508;03-11;19;23;42;SEC_508
2003;130;03-11;37;34;71;SEC_130
2003;217;50-64;35;37;72;SEC_217
2003;412;25-34;134;176;310;SEC_412
2003;238;12-15;10;9;19;SEC_238
2003;511;18-24;27;32;59;SEC_511
2003;319;50-64;117;124;241;SEC_319
2003;225;75 i +;49;33;82;SEC_225
2003;135;18-24;87;108;195;SEC_135
2003;429;18-24;34;31;65;SEC_429
2003;102;00-02;25;24;49;SEC_102
2003;221;12-15;27;25;52;SEC_221
2003;441;00-02;18;13;31;SEC_441
2003;303;03-11;37;42;79;SEC_303
2003;426;50-64;81;70;151;SEC_426
2003;247;00-02;20;13;33;SEC_247
2003;605;12-15;7;7;14;SEC_605
2003;109;12-15;20;13;33;SEC_109
2003;627;35-49;119;98;217;SEC_627
2003;117;18-24;120;128;248;SEC_117
2003;246;25-34;128;124;252;SEC_246
2003;428;75 i +;24;19;43;SEC_428
2003;506;12-15;30;41;71;SEC_506
2003;613;03-11;34;34;68;SEC_613
2003;421;65-74;99;73;172;SEC_421
2003;519;12-15;5;10;15;SEC_519
2003;216;00-02;17;15;32;SEC_216
2003;431;12-15;25;18;43;SEC_431
2003;123;00-02;21;14;35;SEC_123
2003;129;50-64;117;103;220;SEC_129
2003;239;25-34;89;126;215;SEC_239
2003;625;18-24;96;97;193;SEC_625
2003;504;03-11;20;28;48;SEC_504
2003;631;03-11;33;40;73;SEC_631
2003;216;03-11;46;40;86;SEC_216
2003;244;00-02;8;8;16;SEC_244
2003;319;25-34;154;160;314;SEC_319
2003;436;65-74;36;25;61;SEC_436
2003;531;16-17;4;8;12;SEC_531
2003;236;25-34;109;129;238;SEC_236
2003;630;00-02;12;9;21;SEC_630
2003;313;16-17;18;14;32;SEC_313
2003;525;65-74;69;49;118;SEC_525
2003;106;00-02;31;19;50;SEC_106
2003;607;65-74;82;84;166;SEC_607
2003;621;00-02;12;19;31;SEC_621
2003;114;03-11;51;46;97;SEC_114
2003;240;18-24;39;40;79;SEC_240
2003;244;50-64;56;41;97;SEC_244
2003;212;03-11;40;61;101;SEC_212
2003;520;03-11;25;31;56;SEC_520
2003;537;18-24;64;73;137;SEC_537
2003;310;25-34;92;115;207;SEC_310
2003;122;16-17;5;8;13;SEC_122
2003;508;65-74;38;32;70;SEC_508
2003;437;12-15;11;21;32;SEC_437
2003;317;12-15;13;19;32;SEC_317
2003;629;75 i +;27;14;41;SEC_629
2003;510;03-11;38;44;82;SEC_510
2003;123;35-49;137;149;286;SEC_123
2003;407;18-24;39;46;85;SEC_407
2003;104;35-49;81;103;184;SEC_104
2003;108;75 i +;89;52;141;SEC_108
2003;632;00-02;19;15;34;SEC_632
2003;211;00-02;18;18;36;SEC_211
2003;438;03-11;28;32;60;SEC_438
2003;217;12-15;9;10;19;SEC_217
2003;118;03-11;65;67;132;SEC_118
2003;316;35-49;312;247;559;SEC_316
2003;416;18-24;35;35;70;SEC_416
2003;433;25-34;117;112;229;SEC_433
2003;438;12-15;18;14;32;SEC_438
2003;234;75 i +;76;38;114;SEC_234
2003;502;00-02;14;18;32;SEC_502
2003;410;25-34;136;171;307;SEC_410
2003;518;50-64;106;71;177;SEC_518
2003;606;18-24;48;40;88;SEC_606
2003;216;12-15;9;18;27;SEC_216
2003;132;75 i +;71;35;106;SEC_132
2003;503;00-02;8;8;16;SEC_503
2003;230;03-11;37;40;77;SEC_230
2003;622;50-64;89;87;176;SEC_622
2003;244;75 i +;45;33;78;SEC_244
2003;402;16-17;5;9;14;SEC_402
2003;620;50-64;81;75;156;SEC_620
2003;204;50-64;35;41;76;SEC_204
2003;323;16-17;38;27;65;SEC_323
2003;503;25-34;75;81;156;SEC_503
2003;509;25-34;67;88;155;SEC_509
2003;309;00-02;11;16;27;SEC_309
2003;514;75 i +;31;14;45;SEC_514
2003;538;25-34;111;110;221;SEC_538
2003;246;03-11;35;45;80;SEC_246
2003;110;25-34;116;118;234;SEC_110
2003;409;00-02;7;5;12;SEC_409
2003;118;65-74;44;43;87;SEC_118
2003;313;03-11;65;63;128;SEC_313
2003;604;75 i +;26;13;39;SEC_604
2003;512;35-49;87;100;187;SEC_512
2003;442;03-11;26;21;47;SEC_442
2003;412;16-17;16;21;37;SEC_412
2003;106;16-17;21;15;36;SEC_106
2003;241;18-24;36;26;62;SEC_241
2003;236;16-17;12;11;23;SEC_236
2003;121;12-15;8;17;25;SEC_121
2003;508;12-15;8;12;20;SEC_508
2003;108;65-74;80;71;151;SEC_108
2003;611;16-17;18;10;28;SEC_611
2003;201;35-49;61;55;116;SEC_201
2003;135;35-49;184;171;355;SEC_135
2003;322;50-64;99;88;187;SEC_322
