AnyPadro;Seccio;GrupEdat;Dones;Homes;Total;IdSeccio
2014;406;75 i +;79;63;142;SEC_406
2014;211;75 i +;82;35;117;SEC_211
2014;306;35-49;195;194;389;SEC_306
2014;127;00-02;20;8;28;SEC_127
2014;210;18-24;27;25;52;SEC_210
2014;238;50-64;66;63;129;SEC_238
2014;409;16-17;12;18;30;SEC_409
2014;507;03-11;38;39;77;SEC_507
2014;319;03-11;95;112;207;SEC_319
2014;533;25-34;142;148;290;SEC_533
2014;323;25-34;99;116;215;SEC_323
2014;409;35-49;216;232;448;SEC_409
2014;612;18-24;26;36;62;SEC_612
2014;312;75 i +;85;50;135;SEC_312
2014;205;18-24;30;43;73;SEC_205
2014;110;35-49;118;112;230;SEC_110
2014;115;75 i +;71;38;109;SEC_115
2014;616;00-02;27;36;63;SEC_616
2014;510;65-74;68;52;120;SEC_510
2014;530;18-24;60;65;125;SEC_530
2014;621;12-15;18;28;46;SEC_621
2014;107;35-49;204;214;418;SEC_107
2014;411;18-24;32;28;60;SEC_411
2014;301;50-64;212;194;406;SEC_301
2014;420;25-34;142;149;291;SEC_420
2014;312;16-17;13;13;26;SEC_312
2014;245;12-15;26;17;43;SEC_245
2014;506;65-74;161;156;317;SEC_506
2014;103;18-24;20;16;36;SEC_103
2014;616;65-74;107;97;204;SEC_616
2014;121;18-24;35;35;70;SEC_121
2014;416;75 i +;89;54;143;SEC_416
2014;111;03-11;33;33;66;SEC_111
2014;405;75 i +;131;99;230;SEC_405
2014;615;75 i +;50;43;93;SEC_615
2014;514;35-49;166;181;347;SEC_514
2014;407;25-34;67;72;139;SEC_407
2014;205;12-15;16;18;34;SEC_205
2014;317;50-64;80;75;155;SEC_317
2014;140;18-24;27;33;60;SEC_140
2014;503;12-15;9;8;17;SEC_503
2014;121;75 i +;78;43;121;SEC_121
2014;526;65-74;76;56;132;SEC_526
2014;404;03-11;80;62;142;SEC_404
2014;115;12-15;16;29;45;SEC_115
2014;525;25-34;78;56;134;SEC_525
2014;121;50-64;55;73;128;SEC_121
2014;403;12-15;19;15;34;SEC_403
2014;534;75 i +;68;49;117;SEC_534
2014;511;12-15;34;37;71;SEC_511
2014;104;16-17;10;8;18;SEC_104
2014;407;18-24;36;34;70;SEC_407
2014;619;65-74;91;74;165;SEC_619
2014;123;16-17;9;16;25;SEC_123
2014;501;12-15;28;23;51;SEC_501
2014;301;25-34;162;166;328;SEC_301
2014;307;18-24;29;39;68;SEC_307
2014;126;65-74;87;82;169;SEC_126
2014;514;65-74;58;34;92;SEC_514
2014;441;00-02;22;21;43;SEC_441
2014;523;00-02;22;16;38;SEC_523
2014;216;50-64;120;100;220;SEC_216
2014;321;25-34;145;135;280;SEC_321
2014;208;16-17;9;12;21;SEC_208
2014;422;12-15;19;20;39;SEC_422
2014;506;03-11;48;70;118;SEC_506
2014;508;75 i +;71;41;112;SEC_508
2014;116;65-74;128;100;228;SEC_116
2014;119;16-17;12;9;21;SEC_119
2014;422;18-24;50;40;90;SEC_422
2014;614;16-17;3;9;12;SEC_614
2014;210;75 i +;96;41;137;SEC_210
2014;110;03-11;45;37;82;SEC_110
2014;433;00-02;40;25;65;SEC_433
2014;323;75 i +;62;22;84;SEC_323
2014;609;18-24;22;28;50;SEC_609
2014;421;00-02;16;20;36;SEC_421
2014;310;65-74;48;48;96;SEC_310
2014;320;18-24;6;2;8;SEC_320
2014;324;65-74;52;44;96;SEC_324
2014;419;65-74;93;61;154;SEC_419
2014;632;75 i +;57;39;96;SEC_632
2014;533;16-17;15;8;23;SEC_533
2014;223;65-74;58;38;96;SEC_223
2014;410;16-17;14;18;32;SEC_410
2014;436;25-34;103;108;211;SEC_436
2014;316;25-34;179;218;397;SEC_316
2014;102;35-49;164;171;335;SEC_102
2014;127;75 i +;45;29;74;SEC_127
2014;535;12-15;4;22;26;SEC_535
2014;315;03-11;82;89;171;SEC_315
2014;425;12-15;15;25;40;SEC_425
2014;607;35-49;100;124;224;SEC_607
2014;534;00-02;5;11;16;SEC_534
2014;221;03-11;86;80;166;SEC_221
2014;224;35-49;154;151;305;SEC_224
2014;134;50-64;131;113;244;SEC_134
2014;511;50-64;192;143;335;SEC_511
2014;238;16-17;9;11;20;SEC_238
2014;124;00-02;10;11;21;SEC_124
2014;104;75 i +;85;37;122;SEC_104
2014;213;65-74;58;42;100;SEC_213
2014;624;16-17;5;4;9;SEC_624
2014;502;75 i +;130;74;204;SEC_502
2014;414;25-34;148;134;282;SEC_414
2014;626;16-17;14;9;23;SEC_626
2014;526;16-17;18;16;34;SEC_526
2014;419;50-64;125;141;266;SEC_419
2014;623;25-34;58;69;127;SEC_623
2014;622;50-64;97;78;175;SEC_622
2014;426;25-34;90;90;180;SEC_426
2014;303;50-64;101;107;208;SEC_303
2014;427;75 i +;92;54;146;SEC_427
2014;201;25-34;169;145;314;SEC_201
2014;504;65-74;89;74;163;SEC_504
2014;426;75 i +;49;28;77;SEC_426
2014;523;03-11;43;48;91;SEC_523
2014;111;25-34;46;35;81;SEC_111
2014;315;65-74;65;69;134;SEC_315
2014;310;00-02;18;11;29;SEC_310
2014;531;00-02;11;14;25;SEC_531
2014;526;12-15;27;34;61;SEC_526
2014;440;65-74;88;64;152;SEC_440
2014;131;50-64;134;127;261;SEC_131
2014;301;65-74;143;113;256;SEC_301
2014;426;35-49;127;137;264;SEC_426
2014;231;35-49;165;180;345;SEC_231
2014;441;25-34;175;170;345;SEC_441
2014;247;16-17;10;10;20;SEC_247
2014;216;25-34;100;88;188;SEC_216
2014;627;12-15;16;12;28;SEC_627
2014;605;35-49;201;197;398;SEC_605
2014;242;00-02;15;15;30;SEC_242
2014;101;65-74;67;54;121;SEC_101
2014;437;50-64;143;111;254;SEC_437
2014;521;35-49;98;105;203;SEC_521
2014;214;00-02;31;31;62;SEC_214
2014;238;75 i +;57;41;98;SEC_238
2014;224;00-02;19;17;36;SEC_224
2014;432;50-64;136;115;251;SEC_432
2014;211;35-49;186;192;378;SEC_211
2014;309;18-24;35;33;68;SEC_309
2014;301;16-17;19;19;38;SEC_301
2014;401;00-02;12;19;31;SEC_401
2014;410;50-64;138;124;262;SEC_410
2014;211;12-15;27;29;56;SEC_211
2014;529;18-24;47;49;96;SEC_529
2014;135;12-15;27;21;48;SEC_135
2014;402;50-64;66;70;136;SEC_402
2014;135;00-02;19;16;35;SEC_135
2014;601;18-24;72;66;138;SEC_601
2014;610;65-74;146;107;253;SEC_610
2014;510;25-34;66;76;142;SEC_510
2014;113;25-34;115;115;230;SEC_113
2014;224;16-17;9;10;19;SEC_224
2014;403;18-24;30;37;67;SEC_403
2014;209;03-11;35;36;71;SEC_209
2014;231;12-15;32;34;66;SEC_231
2014;535;03-11;30;35;65;SEC_535
2014;534;25-34;66;60;126;SEC_534
2014;613;16-17;7;10;17;SEC_613
2014;104;03-11;31;40;71;SEC_104
2014;324;16-17;10;10;20;SEC_324
2014;631;65-74;122;108;230;SEC_631
2014;420;50-64;181;166;347;SEC_420
2014;318;35-49;90;83;173;SEC_318
2014;308;50-64;214;192;406;SEC_308
2014;314;18-24;61;113;174;SEC_314
2014;208;12-15;20;24;44;SEC_208
2014;320;35-49;195;188;383;SEC_320
2014;224;03-11;53;67;120;SEC_224
2014;531;35-49;116;127;243;SEC_531
2014;625;18-24;30;34;64;SEC_625
2014;504;25-34;71;67;138;SEC_504
2014;322;50-64;108;96;204;SEC_322
2014;325;12-15;29;38;67;SEC_325
2014;202;18-24;65;64;129;SEC_202
2014;532;75 i +;95;58;153;SEC_532
2014;411;16-17;6;5;11;SEC_411
2014;421;16-17;9;9;18;SEC_421
2014;228;16-17;20;23;43;SEC_228
2014;501;03-11;23;42;65;SEC_501
2014;624;50-64;88;56;144;SEC_624
2014;410;18-24;54;68;122;SEC_410
2014;622;75 i +;36;14;50;SEC_622
2014;136;35-49;167;173;340;SEC_136
2014;125;65-74;92;89;181;SEC_125
2014;435;35-49;111;163;274;SEC_435
2014;132;12-15;33;30;63;SEC_132
2014;631;25-34;55;31;86;SEC_631
2014;616;18-24;86;90;176;SEC_616
2014;108;16-17;15;11;26;SEC_108
2014;407;16-17;9;6;15;SEC_407
2014;507;65-74;57;50;107;SEC_507
2014;107;50-64;148;130;278;SEC_107
2014;207;75 i +;115;51;166;SEC_207
2014;535;18-24;33;31;64;SEC_535
2014;513;00-02;17;22;39;SEC_513
2014;518;00-02;15;22;37;SEC_518
2014;319;35-49;258;275;533;SEC_319
2014;123;50-64;130;121;251;SEC_123
2014;204;03-11;58;57;115;SEC_204
2014;213;00-02;18;15;33;SEC_213
2014;518;18-24;27;48;75;SEC_518
2014;617;12-15;17;11;28;SEC_617
2014;101;00-02;22;33;55;SEC_101
2014;606;12-15;16;24;40;SEC_606
2014;501;75 i +;37;30;67;SEC_501
2014;113;03-11;71;95;166;SEC_113
2014;306;50-64;162;140;302;SEC_306
2014;243;25-34;120;80;200;SEC_243
2014;318;00-02;6;7;13;SEC_318
2014;626;00-02;9;12;21;SEC_626
2014;131;65-74;104;107;211;SEC_131
2014;423;65-74;49;47;96;SEC_423
2014;532;65-74;76;61;137;SEC_532
2014;210;50-64;79;78;157;SEC_210
2014;513;35-49;194;205;399;SEC_513
2014;502;00-02;22;22;44;SEC_502
2014;623;75 i +;61;47;108;SEC_623
2014;525;18-24;47;39;86;SEC_525
2014;123;12-15;17;22;39;SEC_123
2014;210;00-02;6;6;12;SEC_210
2014;315;18-24;55;59;114;SEC_315
2014;531;03-11;38;34;72;SEC_531
2014;118;03-11;81;70;151;SEC_118
2014;309;03-11;59;70;129;SEC_309
2014;613;25-34;54;60;114;SEC_613
2014;427;50-64;140;123;263;SEC_427
2014;139;12-15;10;19;29;SEC_139
2014;537;18-24;50;44;94;SEC_537
2014;324;75 i +;48;25;73;SEC_324
2014;231;03-11;55;68;123;SEC_231
2014;301;03-11;156;158;314;SEC_301
2014;431;18-24;57;64;121;SEC_431
2014;404;00-02;20;25;45;SEC_404
2014;116;16-17;13;9;22;SEC_116
2014;614;03-11;38;51;89;SEC_614
2014;311;12-15;28;26;54;SEC_311
2014;523;16-17;4;14;18;SEC_523
2014;216;03-11;54;69;123;SEC_216
2014;601;65-74;156;113;269;SEC_601
2014;118;75 i +;54;44;98;SEC_118
2014;214;18-24;96;74;170;SEC_214
2014;412;25-34;101;105;206;SEC_412
2014;521;25-34;49;46;95;SEC_521
2014;137;75 i +;57;41;98;SEC_137
2014;217;50-64;116;122;238;SEC_217
2014;113;50-64;212;165;377;SEC_113
2014;112;03-11;66;66;132;SEC_112
2014;418;16-17;9;19;28;SEC_418
2014;416;18-24;64;62;126;SEC_416
2014;102;12-15;35;29;64;SEC_102
2014;402;75 i +;58;42;100;SEC_402
2014;606;25-34;66;64;130;SEC_606
2014;107;00-02;22;13;35;SEC_107
2014;129;00-02;14;21;35;SEC_129
2014;217;16-17;13;12;25;SEC_217
2014;403;65-74;91;58;149;SEC_403
2014;611;50-64;117;122;239;SEC_611
2014;538;50-64;106;87;193;SEC_538
2014;317;00-02;17;15;32;SEC_317
2014;624;35-49;102;129;231;SEC_624
2014;630;03-11;26;35;61;SEC_630
2014;405;18-24;71;63;134;SEC_405
2014;435;50-64;84;84;168;SEC_435
2014;229;65-74;63;30;93;SEC_229
2014;528;35-49;171;160;331;SEC_528
2014;237;50-64;108;107;215;SEC_237
2014;627;35-49;93;97;190;SEC_627
2014;108;65-74;61;53;114;SEC_108
2014;631;18-24;33;26;59;SEC_631
2014;517;18-24;72;85;157;SEC_517
2014;407;00-02;15;11;26;SEC_407
2014;112;35-49;189;183;372;SEC_112
2014;115;03-11;51;49;100;SEC_115
2014;420;18-24;76;75;151;SEC_420
2014;524;50-64;84;83;167;SEC_524
2014;530;65-74;62;50;112;SEC_530
2014;303;12-15;18;17;35;SEC_303
2014;525;00-02;19;24;43;SEC_525
2014;517;00-02;29;29;58;SEC_517
2014;625;16-17;8;11;19;SEC_625
2014;602;25-34;67;67;134;SEC_602
2014;410;03-11;53;58;111;SEC_410
2014;317;75 i +;51;21;72;SEC_317
2014;518;35-49;140;143;283;SEC_518
2014;132;03-11;94;76;170;SEC_132
2014;105;12-15;14;24;38;SEC_105
2014;405;25-34;123;118;241;SEC_405
2014;123;35-49;158;154;312;SEC_123
2014;327;16-17;16;12;28;SEC_327
2014;632;12-15;30;13;43;SEC_632
2014;122;75 i +;65;48;113;SEC_122
2014;325;75 i +;187;93;280;SEC_325
2014;207;25-34;153;133;286;SEC_207
2014;412;75 i +;101;81;182;SEC_412
2014;307;65-74;120;101;221;SEC_307
2014;320;25-34;29;30;59;SEC_320
2014;217;12-15;13;28;41;SEC_217
2014;412;35-49;157;179;336;SEC_412
2014;605;25-34;83;97;180;SEC_605
2014;202;03-11;65;83;148;SEC_202
2014;119;50-64;140;105;245;SEC_119
2014;437;25-34;115;111;226;SEC_437
2014;205;50-64;104;103;207;SEC_205
2014;432;12-15;23;11;34;SEC_432
2014;601;50-64;177;169;346;SEC_601
2014;121;12-15;8;18;26;SEC_121
2014;221;00-02;26;34;60;SEC_221
2014;138;25-34;48;60;108;SEC_138
2014;301;18-24;77;91;168;SEC_301
2014;505;35-49;138;128;266;SEC_505
2014;113;12-15;13;27;40;SEC_113
2014;533;00-02;29;34;63;SEC_533
2014;221;65-74;90;74;164;SEC_221
2014;213;12-15;4;31;35;SEC_213
2014;528;12-15;25;21;46;SEC_528
2014;608;12-15;25;17;42;SEC_608
2014;432;03-11;50;45;95;SEC_432
2014;104;12-15;12;20;32;SEC_104
2014;236;18-24;55;36;91;SEC_236
2014;619;18-24;33;36;69;SEC_619
2014;315;16-17;16;24;40;SEC_315
2014;221;12-15;34;35;69;SEC_221
2014;518;65-74;62;32;94;SEC_518
2014;129;50-64;85;81;166;SEC_129
2014;440;25-34;59;58;117;SEC_440
2014;109;12-15;26;22;48;SEC_109
2014;107;03-11;74;83;157;SEC_107
2014;138;75 i +;43;32;75;SEC_138
2014;617;50-64;80;63;143;SEC_617
2014;209;16-17;5;7;12;SEC_209
2014;320;65-74;94;83;177;SEC_320
2014;518;25-34;74;56;130;SEC_518
2014;105;03-11;55;57;112;SEC_105
2014;538;18-24;44;49;93;SEC_538
2014;514;75 i +;89;61;150;SEC_514
2014;214;50-64;156;144;300;SEC_214
2014;436;03-11;81;73;154;SEC_436
2014;421;65-74;80;54;134;SEC_421
2014;318;16-17;10;7;17;SEC_318
2014;115;35-49;151;147;298;SEC_115
2014;243;03-11;68;83;151;SEC_243
2014;537;50-64;117;103;220;SEC_537
2014;137;18-24;46;51;97;SEC_137
2014;211;25-34;97;111;208;SEC_211
2014;524;00-02;14;15;29;SEC_524
2014;131;25-34;65;80;145;SEC_131
2014;402;16-17;11;7;18;SEC_402
2014;125;18-24;44;50;94;SEC_125
2014;306;75 i +;101;63;164;SEC_306
2014;532;03-11;64;61;125;SEC_532
2014;136;75 i +;65;34;99;SEC_136
2014;109;16-17;9;8;17;SEC_109
2014;316;03-11;51;65;116;SEC_316
2014;609;03-11;41;40;81;SEC_609
2014;303;00-02;28;23;51;SEC_303
2014;538;25-34;99;92;191;SEC_538
2014;112;00-02;23;18;41;SEC_112
2014;510;75 i +;68;43;111;SEC_510
2014;624;75 i +;52;37;89;SEC_624
2014;403;03-11;52;44;96;SEC_403
2014;615;16-17;6;8;14;SEC_615
2014;111;35-49;103;93;196;SEC_111
2014;201;18-24;42;36;78;SEC_201
2014;625;35-49;114;116;230;SEC_625
2014;111;12-15;13;19;32;SEC_111
2014;605;12-15;26;27;53;SEC_605
2014;229;12-15;39;30;69;SEC_229
2014;412;50-64;166;150;316;SEC_412
2014;422;25-34;90;88;178;SEC_422
2014;135;75 i +;74;47;121;SEC_135
2014;126;75 i +;70;52;122;SEC_126
2014;308;12-15;42;50;92;SEC_308
2014;425;65-74;50;35;85;SEC_425
2014;505;00-02;15;10;25;SEC_505
2014;602;65-74;105;78;183;SEC_602
2014;611;00-02;31;24;55;SEC_611
2014;430;16-17;5;12;17;SEC_430
2014;249;03-11;41;47;88;SEC_249
2014;307;03-11;45;37;82;SEC_307
2014;531;16-17;9;14;23;SEC_531
2014;609;50-64;54;38;92;SEC_609
2014;501;00-02;8;11;19;SEC_501
2014;128;16-17;4;4;8;SEC_128
2014;233;50-64;66;60;126;SEC_233
2014;247;75 i +;83;42;125;SEC_247
2014;425;00-02;14;14;28;SEC_425
2014;530;75 i +;95;71;166;SEC_530
2014;316;35-49;158;134;292;SEC_316
2014;420;65-74;84;69;153;SEC_420
2014;535;65-74;102;87;189;SEC_535
2014;505;12-15;17;8;25;SEC_505
2014;233;18-24;34;29;63;SEC_233
2014;407;03-11;47;48;95;SEC_407
2014;431;00-02;26;29;55;SEC_431
2014;503;16-17;4;6;10;SEC_503
2014;106;16-17;14;13;27;SEC_106
2014;421;18-24;33;46;79;SEC_421
2014;529;00-02;23;15;38;SEC_529
2014;630;18-24;24;20;44;SEC_630
2014;409;25-34;135;164;299;SEC_409
2014;216;65-74;75;49;124;SEC_216
2014;538;00-02;16;20;36;SEC_538
2014;410;35-49;182;156;338;SEC_410
2014;632;25-34;52;56;108;SEC_632
2014;129;12-15;11;28;39;SEC_129
2014;420;75 i +;137;88;225;SEC_420
2014;533;35-49;252;268;520;SEC_533
2014;229;35-49;237;228;465;SEC_229
2014;503;00-02;7;7;14;SEC_503
2014;312;35-49;202;229;431;SEC_312
2014;127;16-17;6;6;12;SEC_127
2014;228;03-11;96;105;201;SEC_228
2014;139;16-17;8;10;18;SEC_139
2014;326;35-49;149;190;339;SEC_326
2014;211;03-11;48;55;103;SEC_211
2014;114;25-34;62;67;129;SEC_114
2014;435;18-24;36;43;79;SEC_435
2014;205;65-74;53;33;86;SEC_205
2014;325;03-11;57;67;124;SEC_325
2014;622;65-74;54;47;101;SEC_622
2014;313;18-24;55;48;103;SEC_313
2014;220;25-34;130;128;258;SEC_220
2014;437;00-02;22;15;37;SEC_437
2014;524;75 i +;75;43;118;SEC_524
2014;213;75 i +;46;35;81;SEC_213
2014;534;03-11;30;38;68;SEC_534
2014;617;18-24;30;31;61;SEC_617
2014;123;25-34;78;60;138;SEC_123
2014;136;18-24;43;31;74;SEC_136
2014;517;16-17;21;21;42;SEC_517
2014;606;00-02;10;21;31;SEC_606
2014;324;25-34;83;72;155;SEC_324
2014;120;18-24;64;67;131;SEC_120
2014;106;50-64;250;196;446;SEC_106
2014;127;03-11;34;33;67;SEC_127
2014;118;65-74;104;113;217;SEC_118
2014;430;35-49;132;144;276;SEC_430
2014;245;75 i +;64;48;112;SEC_245
2014;115;50-64;122;122;244;SEC_115
2014;410;75 i +;155;101;256;SEC_410
2014;131;12-15;12;24;36;SEC_131
2014;502;16-17;20;16;36;SEC_502
2014;533;50-64;131;129;260;SEC_533
2014;607;65-74;84;40;124;SEC_607
2014;232;12-15;17;8;25;SEC_232
2014;122;00-02;10;15;25;SEC_122
2014;403;25-34;77;82;159;SEC_403
2014;242;03-11;46;44;90;SEC_242
2014;626;18-24;26;23;49;SEC_626
2014;236;00-02;13;13;26;SEC_236
2014;514;25-34;112;102;214;SEC_514
2014;501;25-34;50;48;98;SEC_501
2014;240;12-15;28;18;46;SEC_240
2014;403;16-17;8;9;17;SEC_403
2014;324;03-11;62;54;116;SEC_324
2014;534;35-49;112;119;231;SEC_534
2014;307;50-64;182;131;313;SEC_307
2014;249;35-49;126;136;262;SEC_249
2014;537;16-17;6;11;17;SEC_537
2014;319;16-17;13;21;34;SEC_319
2014;427;03-11;85;95;180;SEC_427
2014;323;16-17;17;18;35;SEC_323
2014;120;65-74;84;76;160;SEC_120
2014;139;35-49;97;117;214;SEC_139
2014;508;18-24;55;74;129;SEC_508
2014;528;25-34;88;75;163;SEC_528
2014;406;50-64;117;120;237;SEC_406
2014;430;25-34;79;83;162;SEC_430
2014;140;00-02;10;20;30;SEC_140
2014;510;00-02;19;8;27;SEC_510
2014;320;75 i +;1;2;3;SEC_320
2014;242;35-49;119;144;263;SEC_242
2014;623;12-15;23;22;45;SEC_623
2014;504;50-64;89;70;159;SEC_504
2014;526;50-64;118;127;245;SEC_526
2014;236;25-34;57;78;135;SEC_236
2014;117;16-17;11;20;31;SEC_117
2014;321;35-49;241;194;435;SEC_321
2014;207;18-24;60;66;126;SEC_207
2014;507;18-24;25;30;55;SEC_507
2014;208;35-49;172;156;328;SEC_208
2014;324;00-02;16;28;44;SEC_324
2014;245;03-11;43;54;97;SEC_245
2014;326;50-64;33;47;80;SEC_326
2014;432;65-74;87;71;158;SEC_432
2014;327;25-34;77;67;144;SEC_327
2014;521;18-24;19;27;46;SEC_521
2014;134;18-24;43;51;94;SEC_134
2014;223;25-34;92;81;173;SEC_223
2014;310;35-49;116;119;235;SEC_310
2014;137;12-15;27;28;55;SEC_137
2014;317;16-17;11;13;24;SEC_317
2014;226;16-17;16;17;33;SEC_226
2014;607;12-15;13;10;23;SEC_607
2014;107;75 i +;111;60;171;SEC_107
2014;243;18-24;57;70;127;SEC_243
2014;124;16-17;7;6;13;SEC_124
2014;611;25-34;100;99;199;SEC_611
2014;302;50-64;150;99;249;SEC_302
2014;533;18-24;74;65;139;SEC_533
2014;113;16-17;14;15;29;SEC_113
2014;236;03-11;31;51;82;SEC_236
2014;106;12-15;26;27;53;SEC_106
2014;420;00-02;39;34;73;SEC_420
2014;247;00-02;28;29;57;SEC_247
2014;316;00-02;17;26;43;SEC_316
2014;243;65-74;61;48;109;SEC_243
2014;103;65-74;34;30;64;SEC_103
2014;617;75 i +;64;36;100;SEC_617
2014;610;16-17;8;7;15;SEC_610
2014;521;00-02;11;12;23;SEC_521
2014;324;35-49;159;175;334;SEC_324
2014;526;35-49;236;280;516;SEC_526
2014;216;16-17;10;10;20;SEC_216
2014;228;65-74;115;74;189;SEC_228
2014;316;65-74;116;126;242;SEC_316
2014;311;65-74;69;54;123;SEC_311
2014;432;35-49;124;147;271;SEC_432
2014;602;50-64;83;82;165;SEC_602
2014;229;00-02;28;28;56;SEC_229
2014;129;18-24;43;33;76;SEC_129
2014;135;35-49;166;180;346;SEC_135
2014;501;16-17;6;8;14;SEC_501
2014;133;65-74;58;44;102;SEC_133
2014;210;12-15;12;12;24;SEC_210
2014;312;50-64;152;142;294;SEC_312
2014;605;00-02;20;16;36;SEC_605
2014;423;18-24;37;31;68;SEC_423
2014;435;65-74;39;31;70;SEC_435
2014;427;65-74;55;36;91;SEC_427
2014;505;25-34;51;54;105;SEC_505
2014;205;25-34;69;78;147;SEC_205
2014;240;65-74;64;47;111;SEC_240
2014;431;16-17;12;13;25;SEC_431
2014;625;25-34;67;83;150;SEC_625
2014;326;65-74;11;10;21;SEC_326
2014;531;50-64;81;83;164;SEC_531
2014;321;18-24;71;83;154;SEC_321
2014;109;00-02;13;16;29;SEC_109
2014;237;18-24;36;46;82;SEC_237
2014;418;03-11;62;48;110;SEC_418
2014;213;16-17;4;11;15;SEC_213
2014;245;18-24;46;34;80;SEC_245
2014;323;35-49;230;231;461;SEC_323
2014;211;16-17;9;19;28;SEC_211
2014;518;50-64;83;81;164;SEC_518
2014;137;50-64;152;129;281;SEC_137
2014;123;18-24;38;46;84;SEC_123
2014;205;03-11;30;31;61;SEC_205
2014;614;65-74;90;68;158;SEC_614
2014;223;03-11;53;49;102;SEC_223
2014;220;35-49;222;229;451;SEC_220
2014;418;65-74;62;58;120;SEC_418
2014;315;00-02;26;12;38;SEC_315
2014;318;25-34;46;44;90;SEC_318
2014;129;65-74;81;59;140;SEC_129
2014;323;00-02;16;36;52;SEC_323
2014;414;35-49;254;252;506;SEC_414
2014;524;18-24;43;44;87;SEC_524
2014;108;75 i +;103;58;161;SEC_108
2014;407;12-15;22;18;40;SEC_407
2014;529;35-49;179;155;334;SEC_529
2014;128;00-02;10;19;29;SEC_128
2014;312;00-02;26;34;60;SEC_312
2014;319;18-24;36;44;80;SEC_319
2014;129;35-49;139;148;287;SEC_129
2014;140;03-11;30;49;79;SEC_140
2014;431;75 i +;87;43;130;SEC_431
2014;110;12-15;15;17;32;SEC_110
2014;126;18-24;25;28;53;SEC_126
2014;618;00-02;15;8;23;SEC_618
2014;406;12-15;24;26;50;SEC_406
2014;134;25-34;92;99;191;SEC_134
2014;116;25-34;65;65;130;SEC_116
2014;618;50-64;113;95;208;SEC_618
2014;223;35-49;141;157;298;SEC_223
2014;601;00-02;21;29;50;SEC_601
2014;202;16-17;8;18;26;SEC_202
2014;538;65-74;73;41;114;SEC_538
2014;320;00-02;24;19;43;SEC_320
2014;132;00-02;28;32;60;SEC_132
2014;208;50-64;178;148;326;SEC_208
2014;607;03-11;48;29;77;SEC_607
2014;130;50-64;74;79;153;SEC_130
2014;431;03-11;93;101;194;SEC_431
2014;140;50-64;84;66;150;SEC_140
2014;535;16-17;9;4;13;SEC_535
2014;105;65-74;58;63;121;SEC_105
2014;321;12-15;37;48;85;SEC_321
2014;248;75 i +;70;47;117;SEC_248
2014;303;03-11;69;52;121;SEC_303
2014;520;25-34;66;62;128;SEC_520
2014;302;65-74;102;118;220;SEC_302
2014;245;25-34;99;72;171;SEC_245
2014;521;65-74;105;102;207;SEC_521
2014;117;00-02;17;20;37;SEC_117
2014;421;75 i +;87;65;152;SEC_421
2014;530;25-34;136;141;277;SEC_530
2014;307;12-15;14;19;33;SEC_307
2014;535;35-49;93;86;179;SEC_535
2014;616;75 i +;49;35;84;SEC_616
2014;314;03-11;91;98;189;SEC_314
2014;140;25-34;61;53;114;SEC_140
2014;607;00-02;15;11;26;SEC_607
2014;528;16-17;9;12;21;SEC_528
2014;103;03-11;28;26;54;SEC_103
2014;619;75 i +;103;83;186;SEC_619
2014;120;75 i +;65;41;106;SEC_120
2014;204;16-17;18;10;28;SEC_204
2014;535;00-02;7;6;13;SEC_535
2014;521;12-15;14;17;31;SEC_521
2014;238;03-11;36;42;78;SEC_238
2014;125;75 i +;59;53;112;SEC_125
2014;205;35-49;96;96;192;SEC_205
2014;224;50-64;102;83;185;SEC_224
2014;404;12-15;22;28;50;SEC_404
2014;537;75 i +;80;53;133;SEC_537
2014;534;12-15;11;13;24;SEC_534
2014;115;65-74;79;71;150;SEC_115
2014;614;35-49;110;111;221;SEC_614
2014;325;50-64;194;148;342;SEC_325
2014;117;35-49;207;206;413;SEC_117
2014;217;65-74;64;51;115;SEC_217
2014;220;18-24;73;63;136;SEC_220
2014;508;03-11;61;61;122;SEC_508
2014;437;03-11;70;77;147;SEC_437
2014;105;18-24;36;45;81;SEC_105
2014;535;75 i +;56;50;106;SEC_535
2014;124;35-49;90;86;176;SEC_124
2014;110;00-02;14;10;24;SEC_110
2014;216;12-15;27;13;40;SEC_216
2014;507;12-15;11;22;33;SEC_507
2014;508;35-49;164;208;372;SEC_508
2014;518;12-15;16;23;39;SEC_518
2014;137;16-17;20;11;31;SEC_137
2014;232;75 i +;76;43;119;SEC_232
2014;202;35-49;225;270;495;SEC_202
2014;608;50-64;136;111;247;SEC_608
2014;210;65-74;61;51;112;SEC_210
2014;129;25-34;69;81;150;SEC_129
2014;110;25-34;70;67;137;SEC_110
2014;412;00-02;8;18;26;SEC_412
2014;316;16-17;10;14;24;SEC_316
2014;426;18-24;32;43;75;SEC_426
2014;508;65-74;69;47;116;SEC_508
2014;508;50-64;118;96;214;SEC_508
2014;242;25-34;80;81;161;SEC_242
2014;325;18-24;55;53;108;SEC_325
2014;125;03-11;81;78;159;SEC_125
2014;441;16-17;25;21;46;SEC_441
2014;220;50-64;155;126;281;SEC_220
2014;406;35-49;147;162;309;SEC_406
2014;308;25-34;115;103;218;SEC_308
2014;302;16-17;5;4;9;SEC_302
2014;134;12-15;28;25;53;SEC_134
2014;124;25-34;58;45;103;SEC_124
2014;538;16-17;8;15;23;SEC_538
2014;606;50-64;86;75;161;SEC_606
2014;602;35-49;154;161;315;SEC_602
2014;307;35-49;139;126;265;SEC_307
2014;530;35-49;231;232;463;SEC_530
2014;140;16-17;4;15;19;SEC_140
2014;411;25-34;62;48;110;SEC_411
2014;313;50-64;223;187;410;SEC_313
2014;617;16-17;8;11;19;SEC_617
2014;114;03-11;46;64;110;SEC_114
2014;233;25-34;86;86;172;SEC_233
2014;425;03-11;40;50;90;SEC_425
2014;109;65-74;63;60;123;SEC_109
2014;525;65-74;41;33;74;SEC_525
2014;423;25-34;72;82;154;SEC_423
2014;242;75 i +;77;57;134;SEC_242
2014;406;25-34;99;85;184;SEC_406
2014;534;65-74;57;48;105;SEC_534
2014;532;50-64;117;85;202;SEC_532
2014;106;03-11;58;64;122;SEC_106
2014;505;75 i +;82;66;148;SEC_505
2014;627;16-17;12;7;19;SEC_627
2014;321;16-17;22;13;35;SEC_321
2014;302;18-24;33;43;76;SEC_302
2014;420;03-11;96;72;168;SEC_420
2014;201;75 i +;63;42;105;SEC_201
2014;238;00-02;19;21;40;SEC_238
2014;530;00-02;13;39;52;SEC_530
2014;226;03-11;74;65;139;SEC_226
2014;312;03-11;55;69;124;SEC_312
2014;317;65-74;33;32;65;SEC_317
2014;602;75 i +;65;59;124;SEC_602
2014;437;18-24;52;55;107;SEC_437
2014;207;03-11;75;75;150;SEC_207
2014;320;16-17;10;11;21;SEC_320
2014;101;16-17;21;19;40;SEC_101
2014;212;25-34;104;106;210;SEC_212
2014;506;50-64;206;144;350;SEC_506
2014;531;75 i +;46;35;81;SEC_531
2014;508;12-15;23;21;44;SEC_508
2014;134;65-74;70;58;128;SEC_134
2014;136;16-17;7;15;22;SEC_136
2014;440;16-17;4;5;9;SEC_440
2014;507;50-64;79;63;142;SEC_507
2014;204;18-24;67;62;129;SEC_204
2014;304;75 i +;109;59;168;SEC_304
2014;605;65-74;164;115;279;SEC_605
2014;305;35-49;175;177;352;SEC_305
2014;232;35-49;122;131;253;SEC_232
2014;632;18-24;30;42;72;SEC_632
2014;320;03-11;7;5;12;SEC_320
2014;248;65-74;44;36;80;SEC_248
2014;117;12-15;35;34;69;SEC_117
2014;618;25-34;46;55;101;SEC_618
2014;435;12-15;16;16;32;SEC_435
2014;610;18-24;29;43;72;SEC_610
2014;113;18-24;44;61;105;SEC_113
2014;128;50-64;79;81;160;SEC_128
2014;309;50-64;99;78;177;SEC_309
2014;440;35-49;111;114;225;SEC_440
2014;505;03-11;32;34;66;SEC_505
2014;619;00-02;10;15;25;SEC_619
2014;229;75 i +;90;52;142;SEC_229
2014;530;03-11;66;82;148;SEC_530
2014;613;50-64;57;68;125;SEC_613
2014;323;12-15;45;34;79;SEC_323
2014;216;18-24;49;40;89;SEC_216
2014;140;35-49;120;125;245;SEC_140
2014;631;16-17;7;7;14;SEC_631
2014;106;25-34;121;115;236;SEC_106
2014;526;03-11;69;94;163;SEC_526
2014;130;12-15;22;18;40;SEC_130
2014;319;65-74;66;70;136;SEC_319
2014;312;65-74;132;95;227;SEC_312
2014;118;18-24;70;53;123;SEC_118
2014;116;03-11;56;55;111;SEC_116
2014;240;00-02;19;18;37;SEC_240
2014;529;50-64;81;90;171;SEC_529
2014;314;12-15;34;30;64;SEC_314
2014;630;65-74;73;60;133;SEC_630
2014;327;50-64;171;138;309;SEC_327
2014;311;00-02;8;22;30;SEC_311
2014;247;25-34;94;93;187;SEC_247
2014;611;75 i +;89;73;162;SEC_611
2014;123;65-74;58;58;116;SEC_123
2014;430;03-11;58;58;116;SEC_430
2014;233;00-02;14;17;31;SEC_233
2014;502;25-34;97;108;205;SEC_502
2014;414;00-02;27;27;54;SEC_414
2014;133;16-17;5;6;11;SEC_133
2014;124;50-64;87;70;157;SEC_124
2014;612;12-15;13;19;32;SEC_612
2014;316;18-24;84;88;172;SEC_316
2014;403;75 i +;89;74;163;SEC_403
2014;231;00-02;24;19;43;SEC_231
2014;307;16-17;10;11;21;SEC_307
2014;626;65-74;77;53;130;SEC_626
2014;503;25-34;35;49;84;SEC_503
2014;406;18-24;64;50;114;SEC_406
2014;529;03-11;66;52;118;SEC_529
2014;304;25-34;308;257;565;SEC_304
2014;120;50-64;205;193;398;SEC_120
2014;304;03-11;163;158;321;SEC_304
2014;411;75 i +;96;75;171;SEC_411
2014;138;03-11;24;22;46;SEC_138
2014;116;50-64;139;111;250;SEC_116
2014;133;18-24;19;21;40;SEC_133
2014;131;00-02;20;12;32;SEC_131
2014;139;65-74;51;49;100;SEC_139
2014;537;65-74;85;66;151;SEC_537
2014;138;16-17;11;5;16;SEC_138
2014;503;65-74;47;54;101;SEC_503
2014;433;75 i +;90;46;136;SEC_433
2014;601;12-15;28;29;57;SEC_601
2014;246;50-64;93;88;181;SEC_246
2014;520;18-24;29;32;61;SEC_520
2014;246;03-11;58;46;104;SEC_246
2014;511;65-74;103;84;187;SEC_511
2014;432;00-02;19;18;37;SEC_432
2014;608;00-02;17;15;32;SEC_608
2014;233;03-11;35;37;72;SEC_233
2014;433;50-64;138;154;292;SEC_433
2014;418;12-15;31;27;58;SEC_418
2014;228;18-24;88;89;177;SEC_228
2014;118;25-34;96;87;183;SEC_118
2014;309;16-17;9;7;16;SEC_309
2014;139;03-11;32;35;67;SEC_139
2014;537;03-11;43;37;80;SEC_537
2014;301;35-49;387;404;791;SEC_301
2014;209;00-02;9;11;20;SEC_209
2014;523;12-15;18;14;32;SEC_523
2014;523;25-34;96;104;200;SEC_523
2014;425;75 i +;74;43;117;SEC_425
2014;616;12-15;41;59;100;SEC_616
2014;109;50-64;129;116;245;SEC_109
2014;612;75 i +;67;48;115;SEC_612
2014;308;18-24;63;82;145;SEC_308
2014;317;25-34;82;96;178;SEC_317
2014;133;35-49;90;102;192;SEC_133
2014;247;65-74;60;43;103;SEC_247
2014;211;50-64;116;99;215;SEC_211
2014;602;12-15;22;30;52;SEC_602
2014;538;75 i +;98;62;160;SEC_538
2014;602;00-02;20;19;39;SEC_602
2014;615;65-74;108;78;186;SEC_615
2014;224;18-24;38;49;87;SEC_224
2014;626;75 i +;60;47;107;SEC_626
2014;601;25-34;104;120;224;SEC_601
2014;123;00-02;13;20;33;SEC_123
2014;325;65-74;125;110;235;SEC_325
2014;245;65-74;49;25;74;SEC_245
2014;238;25-34;68;71;139;SEC_238
2014;111;18-24;30;23;53;SEC_111
2014;631;50-64;83;59;142;SEC_631
2014;327;75 i +;27;13;40;SEC_327
2014;510;03-11;43;43;86;SEC_510
2014;431;65-74;66;47;113;SEC_431
2014;223;16-17;11;8;19;SEC_223
2014;121;03-11;39;45;84;SEC_121
2014;116;00-02;17;15;32;SEC_116
2014;402;03-11;45;45;90;SEC_402
2014;531;25-34;74;65;139;SEC_531
2014;421;12-15;23;20;43;SEC_421
2014;139;25-34;56;61;117;SEC_139
2014;140;65-74;50;47;97;SEC_140
2014;609;35-49;107;105;212;SEC_609
2014;118;00-02;18;27;45;SEC_118
2014;423;00-02;13;13;26;SEC_423
2014;310;12-15;14;16;30;SEC_310
2014;132;35-49;232;252;484;SEC_132
2014;537;35-49;143;117;260;SEC_537
2014;242;50-64;84;83;167;SEC_242
2014;205;00-02;10;6;16;SEC_205
2014;237;00-02;31;20;51;SEC_237
2014;129;75 i +;88;60;148;SEC_129
2014;613;03-11;47;58;105;SEC_613
2014;106;00-02;22;19;41;SEC_106
2014;441;65-74;118;99;217;SEC_441
2014;202;50-64;129;98;227;SEC_202
2014;412;03-11;50;53;103;SEC_412
2014;502;35-49;181;199;380;SEC_502
2014;122;03-11;41;46;87;SEC_122
2014;537;12-15;26;19;45;SEC_537
2014;305;16-17;20;18;38;SEC_305
2014;118;12-15;31;17;48;SEC_118
2014;102;03-11;68;59;127;SEC_102
2014;414;75 i +;88;64;152;SEC_414
2014;406;65-74;81;67;148;SEC_406
2014;504;35-49;119;119;238;SEC_504
2014;404;75 i +;90;52;142;SEC_404
2014;614;12-15;16;12;28;SEC_614
2014;318;75 i +;38;24;62;SEC_318
2014;106;65-74;96;113;209;SEC_106
2014;526;25-34;146;160;306;SEC_526
2014;409;03-11;74;80;154;SEC_409
2014;623;16-17;10;15;25;SEC_623
2014;114;50-64;149;125;274;SEC_114
2014;107;18-24;35;62;97;SEC_107
2014;314;65-74;109;90;199;SEC_314
2014;223;18-24;63;52;115;SEC_223
2014;311;25-34;114;107;221;SEC_311
2014;615;00-02;12;12;24;SEC_615
2014;243;50-64;121;139;260;SEC_243
2014;326;25-34;167;129;296;SEC_326
2014;102;25-34;77;65;142;SEC_102
2014;528;18-24;49;44;93;SEC_528
2014;237;65-74;68;51;119;SEC_237
2014;105;35-49;140;134;274;SEC_105
2014;622;16-17;3;10;13;SEC_622
2014;513;16-17;14;14;28;SEC_513
2014;326;75 i +;4;2;6;SEC_326
2014;112;50-64;165;154;319;SEC_112
2014;118;16-17;13;13;26;SEC_118
2014;135;16-17;10;11;21;SEC_135
2014;317;03-11;62;63;125;SEC_317
2014;318;18-24;20;34;54;SEC_318
2014;305;25-34;106;137;243;SEC_305
2014;538;03-11;59;55;114;SEC_538
2014;126;35-49;116;115;231;SEC_126
2014;234;12-15;10;13;23;SEC_234
2014;205;75 i +;84;52;136;SEC_205
2014;319;00-02;22;28;50;SEC_319
2014;521;75 i +;61;56;117;SEC_521
2014;101;18-24;48;53;101;SEC_101
2014;249;18-24;43;37;80;SEC_249
2014;435;75 i +;75;37;112;SEC_435
2014;427;16-17;13;17;30;SEC_427
2014;132;75 i +;111;72;183;SEC_132
2014;506;00-02;22;16;38;SEC_506
2014;513;03-11;86;76;162;SEC_513
2014;605;16-17;13;15;28;SEC_605
2014;526;75 i +;86;56;142;SEC_526
2014;531;18-24;41;37;78;SEC_531
2014;315;25-34;132;137;269;SEC_315
2014;214;65-74;97;59;156;SEC_214
2014;528;03-11;51;55;106;SEC_528
2014;128;03-11;45;52;97;SEC_128
2014;422;16-17;11;13;24;SEC_422
2014;140;75 i +;58;42;100;SEC_140
2014;221;50-64;154;157;311;SEC_221
2014;208;00-02;16;14;30;SEC_208
2014;422;35-49;140;145;285;SEC_422
2014;320;50-64;104;112;216;SEC_320
2014;506;16-17;13;13;26;SEC_506
2014;236;16-17;8;9;17;SEC_236
2014;136;25-34;82;59;141;SEC_136
2014;117;65-74;120;92;212;SEC_117
2014;228;00-02;30;24;54;SEC_228
2014;231;50-64;77;76;153;SEC_231
2014;502;12-15;29;23;52;SEC_502
2014;313;16-17;16;16;32;SEC_313
2014;304;16-17;48;17;65;SEC_304
2014;530;16-17;9;11;20;SEC_530
2014;618;03-11;53;49;102;SEC_618
2014;234;03-11;38;33;71;SEC_234
2014;130;35-49;145;129;274;SEC_130
2014;305;50-64;189;180;369;SEC_305
2014;419;16-17;13;26;39;SEC_419
2014;303;35-49;191;205;396;SEC_303
2014;247;50-64;115;106;221;SEC_247
2014;217;03-11;45;60;105;SEC_217
2014;232;50-64;90;73;163;SEC_232
2014;135;50-64;165;142;307;SEC_135
2014;505;18-24;25;22;47;SEC_505
2014;605;03-11;77;79;156;SEC_605
2014;529;25-34;81;84;165;SEC_529
2014;114;00-02;20;16;36;SEC_114
2014;419;12-15;39;33;72;SEC_419
2014;208;18-24;52;53;105;SEC_208
2014;432;18-24;39;37;76;SEC_432
2014;613;35-49;147;155;302;SEC_613
2014;609;75 i +;44;30;74;SEC_609
2014;425;25-34;92;100;192;SEC_425
2014;136;12-15;26;20;46;SEC_136
2014;301;00-02;43;42;85;SEC_301
2014;233;75 i +;57;35;92;SEC_233
2014;201;35-49;213;212;425;SEC_201
2014;236;50-64;82;68;150;SEC_236
2014;213;50-64;86;75;161;SEC_213
2014;121;35-49;112;118;230;SEC_121
2014;418;00-02;20;18;38;SEC_418
2014;431;12-15;30;36;66;SEC_431
2014;531;12-15;14;13;27;SEC_531
2014;401;03-11;39;51;90;SEC_401
2014;248;25-34;90;95;185;SEC_248
2014;435;25-34;98;78;176;SEC_435
2014;212;16-17;15;11;26;SEC_212
2014;317;35-49;134;187;321;SEC_317
2014;611;18-24;56;61;117;SEC_611
2014;115;00-02;21;14;35;SEC_115
2014;528;00-02;18;13;31;SEC_528
2014;302;00-02;21;18;39;SEC_302
2014;409;18-24;83;82;165;SEC_409
2014;324;50-64;68;69;137;SEC_324
2014;246;65-74;42;35;77;SEC_246
2014;315;35-49;259;256;515;SEC_315
2014;435;16-17;6;12;18;SEC_435
2014;410;65-74;110;98;208;SEC_410
2014;625;65-74;85;80;165;SEC_625
2014;249;12-15;17;22;39;SEC_249
2014;632;35-49;106;120;226;SEC_632
2014;101;50-64;155;159;314;SEC_101
2014;204;00-02;13;26;39;SEC_204
2014;243;75 i +;108;71;179;SEC_243
2014;202;25-34;151;148;299;SEC_202
2014;121;65-74;24;20;44;SEC_121
2014;133;75 i +;59;34;93;SEC_133
2014;414;50-64;131;129;260;SEC_414
2014;312;12-15;20;23;43;SEC_312
2014;631;75 i +;59;39;98;SEC_631
2014;433;35-49;220;257;477;SEC_433
2014;610;35-49;122;134;256;SEC_610
2014;517;12-15;34;49;83;SEC_517
2014;231;18-24;33;41;74;SEC_231
2014;426;16-17;15;9;24;SEC_426
2014;615;12-15;17;10;27;SEC_615
2014;238;18-24;34;37;71;SEC_238
2014;246;00-02;18;18;36;SEC_246
2014;114;12-15;24;26;50;SEC_114
2014;441;12-15;34;32;66;SEC_441
2014;231;65-74;45;33;78;SEC_231
2014;326;18-24;15;16;31;SEC_326
2014;614;18-24;25;29;54;SEC_614
2014;436;35-49;196;231;427;SEC_436
2014;233;16-17;6;11;17;SEC_233
2014;502;03-11;65;63;128;SEC_502
2014;249;16-17;8;10;18;SEC_249
2014;214;75 i +;119;75;194;SEC_214
2014;627;18-24;11;26;37;SEC_627
2014;213;18-24;35;38;73;SEC_213
2014;436;12-15;38;34;72;SEC_436
2014;432;16-17;10;17;27;SEC_432
2014;107;12-15;24;17;41;SEC_107
2014;506;75 i +;97;73;170;SEC_506
2014;138;50-64;97;82;179;SEC_138
2014;314;75 i +;90;58;148;SEC_314
2014;136;00-02;21;20;41;SEC_136
2014;220;16-17;13;17;30;SEC_220
2014;616;16-17;22;33;55;SEC_616
2014;418;50-64;109;112;221;SEC_418
2014;214;25-34;196;156;352;SEC_214
2014;137;03-11;86;60;146;SEC_137
2014;405;65-74;102;55;157;SEC_405
2014;132;25-34;149;149;298;SEC_132
2014;201;16-17;6;12;18;SEC_201
2014;126;03-11;44;39;83;SEC_126
2014;517;65-74;77;52;129;SEC_517
2014;416;03-11;61;75;136;SEC_416
2014;119;35-49;121;137;258;SEC_119
2014;229;16-17;22;20;42;SEC_229
2014;121;16-17;9;7;16;SEC_121
2014;308;75 i +;102;80;182;SEC_308
2014;207;50-64;168;144;312;SEC_207
2014;507;00-02;7;10;17;SEC_507
2014;108;50-64;146;127;273;SEC_108
2014;134;00-02;18;24;42;SEC_134
2014;401;35-49;121;126;247;SEC_401
2014;313;03-11;88;86;174;SEC_313
2014;436;65-74;65;53;118;SEC_436
2014;119;12-15;7;16;23;SEC_119
2014;320;00-02;5;5;10;SEC_320
2014;422;03-11;49;61;110;SEC_422
2014;205;16-17;10;12;22;SEC_205
2014;304;65-74;83;66;149;SEC_304
2014;226;35-49;243;223;466;SEC_226
2014;124;12-15;11;10;21;SEC_124
2014;325;25-34;93;93;186;SEC_325
2014;122;50-64;55;48;103;SEC_122
2014;520;35-49;98;99;197;SEC_520
2014;313;35-49;230;215;445;SEC_313
2014;617;35-49;109;141;250;SEC_617
2014;138;00-02;10;16;26;SEC_138
2014;327;18-24;38;35;73;SEC_327
2014;504;00-02;15;6;21;SEC_504
2014;138;12-15;11;10;21;SEC_138
2014;433;12-15;30;32;62;SEC_433
2014;431;35-49;195;246;441;SEC_431
2014;221;35-49;255;274;529;SEC_221
2014;103;16-17;10;6;16;SEC_103
2014;213;25-34;78;81;159;SEC_213
2014;436;16-17;12;16;28;SEC_436
2014;238;35-49;120;133;253;SEC_238
2014;121;25-34;57;42;99;SEC_121
2014;104;35-49;105;120;225;SEC_104
2014;226;25-34;126;127;253;SEC_226
2014;506;25-34;88;101;189;SEC_506
2014;403;50-64;107;94;201;SEC_403
2014;625;50-64;190;150;340;SEC_625
2014;533;03-11;82;100;182;SEC_533
2014;111;16-17;1;10;11;SEC_111
2014;306;16-17;21;16;37;SEC_306
2014;126;00-02;13;13;26;SEC_126
2014;127;18-24;20;29;49;SEC_127
2014;103;75 i +;51;32;83;SEC_103
2014;208;75 i +;222;119;341;SEC_208
2014;124;75 i +;48;40;88;SEC_124
2014;612;25-34;47;41;88;SEC_612
2014;239;75 i +;94;53;147;SEC_239
2014;216;75 i +;75;57;132;SEC_216
2014;435;00-02;11;20;31;SEC_435
2014;423;35-49;107;116;223;SEC_423
2014;223;12-15;19;17;36;SEC_223
2014;313;12-15;38;40;78;SEC_313
2014;209;18-24;34;47;81;SEC_209
2014;327;03-11;43;63;106;SEC_327
2014;204;50-64;135;131;266;SEC_204
2014;232;03-11;34;54;88;SEC_232
2014;308;00-02;25;18;43;SEC_308
2014;115;25-34;66;60;126;SEC_115
2014;533;12-15;41;27;68;SEC_533
2014;119;25-34;77;64;141;SEC_119
2014;530;12-15;26;20;46;SEC_530
2014;610;00-02;9;10;19;SEC_610
2014;410;00-02;10;17;27;SEC_410
2014;405;16-17;11;18;29;SEC_405
2014;240;16-17;24;16;40;SEC_240
2014;201;50-64;94;78;172;SEC_201
2014;234;00-02;15;15;30;SEC_234
2014;518;16-17;14;9;23;SEC_518
2014;532;00-02;22;19;41;SEC_532
2014;431;25-34;116;124;240;SEC_431
2014;208;65-74;112;89;201;SEC_208
2014;414;12-15;38;31;69;SEC_414
2014;202;00-02;16;32;48;SEC_202
2014;122;16-17;8;8;16;SEC_122
2014;609;25-34;36;38;74;SEC_609
2014;318;03-11;27;36;63;SEC_318
2014;131;16-17;9;4;13;SEC_131
2014;105;00-02;16;13;29;SEC_105
2014;440;12-15;14;11;25;SEC_440
2014;616;50-64;227;198;425;SEC_616
2014;311;35-49;163;220;383;SEC_311
2014;112;18-24;57;56;113;SEC_112
2014;211;18-24;49;45;94;SEC_211
2014;412;12-15;22;20;42;SEC_412
2014;441;03-11;78;75;153;SEC_441
2014;606;18-24;32;36;68;SEC_606
2014;623;18-24;31;37;68;SEC_623
2014;249;25-34;80;90;170;SEC_249
2014;249;00-02;13;17;30;SEC_249
2014;426;03-11;43;51;94;SEC_426
2014;130;25-34;56;58;114;SEC_130
2014;139;00-02;8;9;17;SEC_139
2014;511;25-34;179;168;347;SEC_511
2014;210;25-34;42;53;95;SEC_210
2014;622;25-34;37;43;80;SEC_622
2014;249;65-74;48;43;91;SEC_249
2014;610;25-34;51;58;109;SEC_610
2014;122;12-15;12;17;29;SEC_122
2014;611;65-74;126;95;221;SEC_611
2014;204;65-74;67;53;120;SEC_204
2014;427;25-34;142;132;274;SEC_427
2014;232;16-17;11;12;23;SEC_232
2014;103;25-34;47;42;89;SEC_103
2014;423;16-17;5;9;14;SEC_423
2014;526;18-24;72;53;125;SEC_526
2014;302;03-11;40;38;78;SEC_302
2014;247;12-15;28;23;51;SEC_247
2014;314;16-17;20;14;34;SEC_314
2014;128;75 i +;55;38;93;SEC_128
2014;212;35-49;193;167;360;SEC_212
2014;403;35-49;117;134;251;SEC_403
2014;135;18-24;48;39;87;SEC_135
2014;318;12-15;10;16;26;SEC_318
2014;101;12-15;32;28;60;SEC_101
2014;204;25-34;110;115;225;SEC_204
2014;404;16-17;19;17;36;SEC_404
2014;537;25-34;107;86;193;SEC_537
2014;631;12-15;12;15;27;SEC_631
2014;213;03-11;40;48;88;SEC_213
2014;217;25-34;106;115;221;SEC_217
2014;305;00-02;22;11;33;SEC_305
2014;106;75 i +;77;34;111;SEC_106
2014;128;25-34;64;66;130;SEC_128
2014;409;65-74;94;73;167;SEC_409
2014;130;75 i +;95;61;156;SEC_130
2014;532;18-24;44;55;99;SEC_532
2014;612;65-74;120;80;200;SEC_612
2014;133;50-64;87;64;151;SEC_133
2014;622;18-24;26;35;61;SEC_622
2014;245;16-17;12;9;21;SEC_245
2014;135;65-74;82;80;162;SEC_135
2014;325;16-17;18;16;34;SEC_325
2014;416;12-15;34;25;59;SEC_416
2014;322;35-49;184;176;360;SEC_322
2014;237;25-34;118;101;219;SEC_237
2014;319;50-64;152;126;278;SEC_319
2014;323;50-64;204;184;388;SEC_323
2014;128;65-74;68;47;115;SEC_128
2014;104;65-74;40;35;75;SEC_104
2014;623;50-64;137;118;255;SEC_623
2014;631;00-02;11;13;24;SEC_631
2014;134;16-17;15;9;24;SEC_134
2014;606;75 i +;77;62;139;SEC_606
2014;529;12-15;17;31;48;SEC_529
2014;632;00-02;10;11;21;SEC_632
2014;534;50-64;80;73;153;SEC_534
2014;419;75 i +;105;81;186;SEC_419
2014;313;65-74;99;79;178;SEC_313
2014;112;75 i +;65;36;101;SEC_112
2014;621;00-02;15;21;36;SEC_621
2014;239;00-02;11;14;25;SEC_239
2014;320;35-49;27;41;68;SEC_320
2014;608;65-74;78;57;135;SEC_608
2014;131;75 i +;73;55;128;SEC_131
2014;305;75 i +;92;51;143;SEC_305
2014;109;35-49;126;121;247;SEC_109
2014;611;16-17;11;11;22;SEC_611
2014;524;25-34;91;106;197;SEC_524
2014;239;18-24;31;38;69;SEC_239
2014;410;12-15;26;33;59;SEC_410
2014;113;65-74;77;88;165;SEC_113
2014;411;03-11;33;29;62;SEC_411
2014;108;12-15;35;24;59;SEC_108
2014;220;75 i +;97;61;158;SEC_220
2014;126;25-34;60;56;116;SEC_126
2014;632;16-17;8;6;14;SEC_632
2014;226;12-15;31;28;59;SEC_226
2014;520;16-17;4;9;13;SEC_520
2014;106;18-24;40;54;94;SEC_106
2014;242;12-15;16;17;33;SEC_242
2014;303;16-17;12;14;26;SEC_303
2014;402;35-49;134;118;252;SEC_402
2014;427;35-49;231;226;457;SEC_427
2014;619;12-15;19;13;32;SEC_619
2014;402;65-74;44;30;74;SEC_402
2014;520;03-11;39;42;81;SEC_520
2014;248;18-24;43;46;89;SEC_248
2014;441;75 i +;113;69;182;SEC_441
2014;247;03-11;70;74;144;SEC_247
2014;613;65-74;142;103;245;SEC_613
2014;619;25-34;56;79;135;SEC_619
2014;102;18-24;40;51;91;SEC_102
2014;242;18-24;29;33;62;SEC_242
2014;505;65-74;155;127;282;SEC_505
2014;607;25-34;67;57;124;SEC_607
2014;421;50-64;85;75;160;SEC_421
2014;615;25-34;42;34;76;SEC_615
2014;122;25-34;55;45;100;SEC_122
2014;221;25-34;133;153;286;SEC_221
2014;134;75 i +;75;38;113;SEC_134
2014;422;00-02;18;18;36;SEC_422
2014;426;12-15;21;15;36;SEC_426
2014;229;50-64;138;133;271;SEC_229
2014;201;65-74;53;38;91;SEC_201
2014;532;16-17;6;9;15;SEC_532
2014;405;03-11;80;75;155;SEC_405
2014;240;50-64;135;135;270;SEC_240
2014;420;12-15;25;44;69;SEC_420
2014;322;12-15;25;31;56;SEC_322
2014;309;25-34;109;92;201;SEC_309
2014;407;65-74;45;33;78;SEC_407
2014;437;16-17;15;13;28;SEC_437
2014;622;12-15;10;21;31;SEC_622
2014;209;75 i +;78;55;133;SEC_209
2014;508;25-34;110;108;218;SEC_508
2014;136;65-74;64;63;127;SEC_136
2014;314;00-02;28;24;52;SEC_314
2014;430;75 i +;52;36;88;SEC_430
2014;437;35-49;187;221;408;SEC_437
2014;403;00-02;17;13;30;SEC_403
2014;623;65-74;125;97;222;SEC_623
2014;201;12-15;21;21;42;SEC_201
2014;621;50-64;163;106;269;SEC_621
2014;307;25-34;79;91;170;SEC_307
2014;610;50-64;79;72;151;SEC_610
2014;622;00-02;7;7;14;SEC_622
2014;617;25-34;49;49;98;SEC_617
2014;208;03-11;33;52;85;SEC_208
2014;523;50-64;87;115;202;SEC_523
2014;601;03-11;69;87;156;SEC_601
2014;440;75 i +;63;58;121;SEC_440
2014;525;50-64;68;64;132;SEC_525
2014;610;75 i +;72;62;134;SEC_610
2014;503;18-24;21;27;48;SEC_503
2014;322;00-02;26;29;55;SEC_322
2014;313;25-34;114;115;229;SEC_313
2014;529;75 i +;94;64;158;SEC_529
2014;426;50-64;73;79;152;SEC_426
2014;420;35-49;223;261;484;SEC_420
2014;133;12-15;17;11;28;SEC_133
2014;132;18-24;64;73;137;SEC_132
2014;605;18-24;44;40;84;SEC_605
2014;320;65-74;1;2;3;SEC_320
2014;101;75 i +;54;36;90;SEC_101
2014;508;16-17;13;12;25;SEC_508
2014;209;65-74;41;28;69;SEC_209
2014;605;50-64;132;91;223;SEC_605
2014;602;03-11;58;69;127;SEC_602
2014;625;00-02;10;13;23;SEC_625
2014;104;18-24;30;24;54;SEC_104
2014;229;18-24;70;88;158;SEC_229
2014;322;25-34;93;80;173;SEC_322
2014;401;75 i +;98;49;147;SEC_401
2014;421;03-11;45;48;93;SEC_421
2014;501;35-49;112;117;229;SEC_501
2014;626;03-11;32;37;69;SEC_626
2014;614;50-64;76;70;146;SEC_614
2014;120;12-15;33;42;75;SEC_120
2014;110;50-64;122;102;224;SEC_110
2014;617;65-74;65;46;111;SEC_617
2014;132;65-74;112;134;246;SEC_132
2014;531;65-74;48;33;81;SEC_531
2014;521;16-17;7;6;13;SEC_521
2014;228;35-49;295;318;613;SEC_228
2014;615;18-24;21;25;46;SEC_615
2014;210;35-49;92;89;181;SEC_210
2014;416;35-49;187;180;367;SEC_416
2014;248;35-49;165;179;344;SEC_248
2014;513;50-64;107;116;223;SEC_513
2014;520;65-74;48;44;92;SEC_520
2014;125;16-17;13;15;28;SEC_125
2014;209;12-15;17;12;29;SEC_209
2014;248;12-15;16;18;34;SEC_248
2014;607;50-64;88;86;174;SEC_607
2014;612;16-17;8;13;21;SEC_612
2014;221;18-24;88;76;164;SEC_221
2014;106;35-49;178;186;364;SEC_106
2014;626;25-34;50;43;93;SEC_626
2014;248;50-64;109;110;219;SEC_248
2014;207;16-17;14;15;29;SEC_207
2014;126;12-15;24;19;43;SEC_126
2014;621;25-34;81;83;164;SEC_621
2014;430;18-24;33;42;75;SEC_430
2014;114;65-74;127;92;219;SEC_114
2014;513;25-34;96;83;179;SEC_513
2014;210;16-17;8;8;16;SEC_210
2014;132;16-17;21;24;45;SEC_132
2014;627;25-34;50;63;113;SEC_627
2014;127;35-49;102;109;211;SEC_127
2014;221;16-17;11;17;28;SEC_221
2014;117;25-34;110;129;239;SEC_117
2014;234;50-64;84;76;160;SEC_234
2014;510;50-64;82;71;153;SEC_510
2014;326;12-15;10;10;20;SEC_326
2014;236;65-74;68;39;107;SEC_236
2014;517;35-49;257;298;555;SEC_517
2014;310;18-24;28;27;55;SEC_310
2014;204;12-15;26;18;44;SEC_204
2014;314;35-49;269;272;541;SEC_314
2014;407;75 i +;95;49;144;SEC_407
2014;326;16-17;5;5;10;SEC_326
2014;202;75 i +;80;60;140;SEC_202
2014;622;03-11;27;39;66;SEC_622
2014;236;75 i +;100;51;151;SEC_236
2014;423;03-11;45;41;86;SEC_423
2014;615;50-64;52;38;90;SEC_615
2014;626;35-49;98;104;202;SEC_626
2014;234;16-17;8;7;15;SEC_234
2014;117;75 i +;84;50;134;SEC_117
2014;214;03-11;97;105;202;SEC_214
2014;108;35-49;193;160;353;SEC_108
2014;239;03-11;34;47;81;SEC_239
2014;316;50-64;368;304;672;SEC_316
2014;313;00-02;23;20;43;SEC_313
2014;246;16-17;9;11;20;SEC_246
2014;411;65-74;77;57;134;SEC_411
2014;306;03-11;66;54;120;SEC_306
2014;116;18-24;44;36;80;SEC_116
2014;228;50-64;142;162;304;SEC_228
2014;101;25-34;97;89;186;SEC_101
2014;116;12-15;24;20;44;SEC_116
2014;223;00-02;13;21;34;SEC_223
2014;510;18-24;33;30;63;SEC_510
2014;243;00-02;18;20;38;SEC_243
2014;411;35-49;81;94;175;SEC_411
2014;301;12-15;44;48;92;SEC_301
2014;247;18-24;49;62;111;SEC_247
2014;518;03-11;41;44;85;SEC_518
2014;526;00-02;30;40;70;SEC_526
2014;133;03-11;29;30;59;SEC_133
2014;211;65-74;44;38;82;SEC_211
2014;433;25-34;137;121;258;SEC_433
2014;409;50-64;154;144;298;SEC_409
2014;308;65-74;113;101;214;SEC_308
2014;440;03-11;34;40;74;SEC_440
2014;239;25-34;84;79;163;SEC_239
2014;524;03-11;58;59;117;SEC_524
2014;437;75 i +;103;72;175;SEC_437
2014;322;75 i +;73;44;117;SEC_322
2014;231;25-34;127;110;237;SEC_231
2014;630;25-34;43;47;90;SEC_630
2014;304;12-15;68;41;109;SEC_304
2014;320;18-24;44;43;87;SEC_320
2014;137;25-34;107;84;191;SEC_137
2014;207;35-49;256;227;483;SEC_207
2014;501;18-24;31;35;66;SEC_501
2014;309;35-49;151;161;312;SEC_309
2014;625;03-11;29;44;73;SEC_625
2014;622;35-49;99;99;198;SEC_622
2014;111;65-74;71;55;126;SEC_111
2014;426;00-02;14;16;30;SEC_426
2014;246;75 i +;69;46;115;SEC_246
2014;217;75 i +;69;47;116;SEC_217
2014;506;35-49;163;176;339;SEC_506
2014;224;12-15;17;19;36;SEC_224
2014;612;50-64;58;61;119;SEC_612
2014;130;00-02;21;18;39;SEC_130
2014;109;75 i +;69;37;106;SEC_109
2014;237;03-11;60;69;129;SEC_237
2014;419;03-11;75;115;190;SEC_419
2014;532;25-34;111;108;219;SEC_532
2014;320;50-64;4;4;8;SEC_320
2014;532;35-49;179;195;374;SEC_532
2014;511;03-11;93;103;196;SEC_511
2014;127;12-15;11;15;26;SEC_127
2014;440;50-64;72;82;154;SEC_440
2014;220;00-02;27;25;52;SEC_220
2014;607;18-24;26;32;58;SEC_607
2014;322;18-24;39;47;86;SEC_322
2014;131;35-49;150;174;324;SEC_131
2014;520;00-02;8;8;16;SEC_520
2014;618;16-17;7;23;30;SEC_618
2014;520;50-64;80;50;130;SEC_520
2014;514;50-64;117;102;219;SEC_514
2014;117;50-64;237;223;460;SEC_117
2014;213;35-49;105;112;217;SEC_213
2014;231;16-17;10;10;20;SEC_231
2014;514;18-24;46;51;97;SEC_514
2014;111;75 i +;57;40;97;SEC_111
2014;513;18-24;47;53;100;SEC_513
2014;441;35-49;190;242;432;SEC_441
2014;422;75 i +;75;50;125;SEC_422
2014;436;75 i +;63;44;107;SEC_436
2014;108;25-34;95;84;179;SEC_108
2014;416;16-17;10;14;24;SEC_416
2014;232;65-74;48;40;88;SEC_232
2014;505;50-64;91;77;168;SEC_505
2014;319;12-15;30;38;68;SEC_319
2014;630;50-64;91;80;171;SEC_630
2014;128;35-49;147;146;293;SEC_128
2014;419;18-24;74;91;165;SEC_419
2014;436;18-24;65;57;122;SEC_436
2014;534;18-24;29;23;52;SEC_534
2014;229;25-34;158;142;300;SEC_229
2014;407;50-64;77;77;154;SEC_407
2014;108;18-24;43;48;91;SEC_108
2014;422;50-64;87;93;180;SEC_422
2014;615;35-49;91;102;193;SEC_615
2014;212;18-24;47;45;92;SEC_212
2014;139;18-24;29;32;61;SEC_139
2014;601;16-17;12;16;28;SEC_601
2014;204;35-49;184;204;388;SEC_204
2014;414;16-17;9;15;24;SEC_414
2014;613;12-15;18;18;36;SEC_613
2014;625;75 i +;59;38;97;SEC_625
2014;249;50-64;96;81;177;SEC_249
2014;117;03-11;69;81;150;SEC_117
2014;210;03-11;30;33;63;SEC_210
2014;327;65-74;48;55;103;SEC_327
2014;240;35-49;204;193;397;SEC_240
2014;324;18-24;30;30;60;SEC_324
2014;107;25-34;99;108;207;SEC_107
2014;107;16-17;11;17;28;SEC_107
2014;525;12-15;15;15;30;SEC_525
2014;321;75 i +;120;80;200;SEC_321
2014;302;35-49;140;163;303;SEC_302
2014;612;00-02;18;14;32;SEC_612
2014;122;65-74;64;38;102;SEC_122
2014;103;35-49;104;116;220;SEC_103
2014;322;16-17;20;14;34;SEC_322
2014;311;50-64;109;93;202;SEC_311
2014;234;35-49;134;139;273;SEC_234
2014;425;16-17;10;10;20;SEC_425
2014;320;75 i +;49;28;77;SEC_320
2014;624;03-11;38;45;83;SEC_624
2014;315;75 i +;49;39;88;SEC_315
2014;226;50-64;168;138;306;SEC_226
2014;310;25-34;74;67;141;SEC_310
2014;318;50-64;107;101;208;SEC_318
2014;421;35-49;159;163;322;SEC_421
2014;112;25-34;99;86;185;SEC_112
2014;121;00-02;6;10;16;SEC_121
2014;216;00-02;17;17;34;SEC_216
2014;537;00-02;16;18;34;SEC_537
2014;501;50-64;116;90;206;SEC_501
2014;310;16-17;3;7;10;SEC_310
2014;109;25-34;87;78;165;SEC_109
2014;109;18-24;31;35;66;SEC_109
2014;414;65-74;67;55;122;SEC_414
2014;127;50-64;82;75;157;SEC_127
2014;130;65-74;54;29;83;SEC_130
2014;212;12-15;24;22;46;SEC_212
2014;231;75 i +;81;40;121;SEC_231
2014;402;12-15;11;17;28;SEC_402
2014;601;35-49;214;276;490;SEC_601
2014;104;00-02;11;10;21;SEC_104
2014;107;65-74;103;91;194;SEC_107
2014;209;35-49;124;118;242;SEC_209
2014;624;12-15;14;16;30;SEC_624
2014;114;35-49;171;186;357;SEC_114
2014;110;18-24;23;38;61;SEC_110
2014;119;03-11;33;36;69;SEC_119
2014;201;00-02;35;41;76;SEC_201
2014;404;25-34;106;91;197;SEC_404
2014;626;12-15;11;20;31;SEC_626
2014;102;16-17;11;16;27;SEC_102
2014;234;65-74;41;24;65;SEC_234
2014;502;18-24;38;38;76;SEC_502
2014;618;75 i +;69;61;130;SEC_618
2014;518;75 i +;80;57;137;SEC_518
2014;232;00-02;15;21;36;SEC_232
2014;125;12-15;23;28;51;SEC_125
2014;313;75 i +;87;59;146;SEC_313
2014;128;12-15;12;17;29;SEC_128
2014;410;25-34;99;99;198;SEC_410
2014;237;75 i +;83;49;132;SEC_237
2014;308;16-17;21;18;39;SEC_308
2014;502;65-74;88;84;172;SEC_502
2014;101;03-11;139;152;291;SEC_101
2014;401;18-24;51;52;103;SEC_401
2014;510;35-49;122;132;254;SEC_510
2014;132;50-64;243;208;451;SEC_132
2014;404;65-74;68;50;118;SEC_404
2014;118;50-64;207;165;372;SEC_118
2014;504;75 i +;89;79;168;SEC_504
2014;130;16-17;8;12;20;SEC_130
2014;105;75 i +;58;35;93;SEC_105
2014;524;35-49;163;194;357;SEC_524
2014;120;00-02;15;13;28;SEC_120
2014;322;03-11;64;57;121;SEC_322
2014;517;75 i +;98;71;169;SEC_517
2014;312;25-34;179;147;326;SEC_312
2014;401;50-64;133;104;237;SEC_401
2014;510;12-15;17;13;30;SEC_510
2014;101;35-49;309;301;610;SEC_101
2014;240;03-11;84;62;146;SEC_240
2014;220;65-74;67;36;103;SEC_220
2014;125;00-02;26;37;63;SEC_125
2014;224;25-34;114;107;221;SEC_224
2014;627;65-74;79;85;164;SEC_627
2014;425;50-64;71;85;156;SEC_425
2014;501;65-74;95;111;206;SEC_501
2014;124;03-11;40;33;73;SEC_124
2014;412;18-24;46;63;109;SEC_412
2014;623;35-49;151;158;309;SEC_623
2014;126;50-64;79;55;134;SEC_126
2014;611;12-15;28;29;57;SEC_611
2014;623;00-02;8;15;23;SEC_623
2014;115;16-17;12;4;16;SEC_115
2014;127;25-34;58;49;107;SEC_127
2014;506;18-24;64;66;130;SEC_506
2014;228;12-15;38;42;80;SEC_228
2014;315;12-15;31;26;57;SEC_315
2014;404;50-64;108;103;211;SEC_404
2014;418;75 i +;78;61;139;SEC_418
2014;123;75 i +;85;64;149;SEC_123
2014;437;65-74;91;68;159;SEC_437
2014;602;16-17;12;20;32;SEC_602
2014;525;03-11;45;49;94;SEC_525
2014;504;18-24;24;25;49;SEC_504
2014;306;18-24;63;72;135;SEC_306
2014;517;50-64;171;149;320;SEC_517
2014;305;65-74;68;70;138;SEC_305
2014;302;75 i +;66;44;110;SEC_302
2014;426;65-74;39;36;75;SEC_426
2014;524;16-17;8;15;23;SEC_524
2014;130;03-11;54;40;94;SEC_130
2014;401;65-74;48;46;94;SEC_401
2014;511;35-49;275;290;565;SEC_511
2014;606;03-11;51;47;98;SEC_606
2014;617;03-11;31;52;83;SEC_617
2014;113;00-02;25;28;53;SEC_113
2014;114;18-24;41;39;80;SEC_114
2014;321;00-02;20;26;46;SEC_321
2014;608;16-17;7;4;11;SEC_608
2014;433;18-24;77;68;145;SEC_433
2014;234;75 i +;70;40;110;SEC_234
2014;507;75 i +;48;21;69;SEC_507
2014;119;18-24;29;36;65;SEC_119
2014;207;12-15;26;32;58;SEC_207
2014;433;03-11;75;106;181;SEC_433
2014;303;65-74;127;90;217;SEC_303
2014;520;75 i +;52;38;90;SEC_520
2014;323;65-74;92;103;195;SEC_323
2014;619;16-17;7;11;18;SEC_619
2014;406;00-02;25;18;43;SEC_406
2014;309;00-02;26;30;56;SEC_309
2014;208;25-34;126;110;236;SEC_208
2014;139;75 i +;34;30;64;SEC_139
2014;246;35-49;142;163;305;SEC_246
2014;407;35-49;120;147;267;SEC_407
2014;616;03-11;110;103;213;SEC_616
2014;242;16-17;13;9;22;SEC_242
2014;617;00-02;13;14;27;SEC_617
2014;237;16-17;11;16;27;SEC_237
2014;224;75 i +;70;32;102;SEC_224
2014;304;50-64;165;148;313;SEC_304
2014;514;16-17;19;20;39;SEC_514
2014;125;35-49;217;229;446;SEC_125
2014;217;00-02;17;11;28;SEC_217
2014;326;00-02;41;32;73;SEC_326
2014;108;03-11;50;48;98;SEC_108
2014;109;03-11;46;43;89;SEC_109
2014;246;12-15;12;18;30;SEC_246
2014;416;00-02;17;24;41;SEC_416
2014;112;16-17;8;20;28;SEC_112
2014;432;25-34;88;84;172;SEC_432
2014;128;18-24;27;22;49;SEC_128
2014;239;65-74;55;38;93;SEC_239
2014;402;25-34;68;56;124;SEC_402
2014;319;25-34;116;113;229;SEC_319
2014;404;18-24;48;54;102;SEC_404
2014;618;35-49;133;125;258;SEC_618
2014;311;03-11;64;81;145;SEC_311
2014;503;50-64;122;87;209;SEC_503
2014;102;65-74;136;125;261;SEC_102
2014;504;12-15;9;15;24;SEC_504
2014;632;03-11;44;57;101;SEC_632
2014;103;50-64;62;60;122;SEC_103
2014;427;00-02;22;37;59;SEC_427
2014;432;75 i +;69;52;121;SEC_432
2014;113;35-49;204;198;402;SEC_113
2014;616;25-34;133;137;270;SEC_616
2014;304;18-24;86;68;154;SEC_304
2014;103;00-02;14;13;27;SEC_103
2014;308;35-49;266;238;504;SEC_308
2014;111;00-02;9;3;12;SEC_111
2014;302;25-34;94;81;175;SEC_302
2014;440;18-24;34;37;71;SEC_440
2014;202;65-74;71;64;135;SEC_202
2014;307;75 i +;82;66;148;SEC_307
2014;212;65-74;65;51;116;SEC_212
2014;607;75 i +;88;75;163;SEC_607
2014;440;00-02;8;12;20;SEC_440
2014;601;75 i +;138;98;236;SEC_601
2014;110;75 i +;77;36;113;SEC_110
2014;317;12-15;16;19;35;SEC_317
2014;129;03-11;43;50;93;SEC_129
2014;327;00-02;6;12;18;SEC_327
2014;514;03-11;59;66;125;SEC_514
2014;618;18-24;38;37;75;SEC_618
2014;140;12-15;17;16;33;SEC_140
2014;224;65-74;52;40;92;SEC_224
2014;505;16-17;1;5;6;SEC_505
2014;108;00-02;20;26;46;SEC_108
2014;321;65-74;141;138;279;SEC_321
2014;136;50-64;106;99;205;SEC_136
2014;416;50-64;110;102;212;SEC_416
2014;609;65-74;85;78;163;SEC_609
2014;116;35-49;152;170;322;SEC_116
2014;229;03-11;80;75;155;SEC_229
2014;618;12-15;24;31;55;SEC_618
2014;126;16-17;8;10;18;SEC_126
2014;316;75 i +;75;40;115;SEC_316
2014;441;18-24;75;58;133;SEC_441
2014;318;65-74;42;36;78;SEC_318
2014;301;75 i +;144;97;241;SEC_301
2014;136;03-11;62;52;114;SEC_136
2014;411;12-15;13;12;25;SEC_411
2014;120;16-17;19;21;40;SEC_120
2014;616;35-49;284;284;568;SEC_616
2014;234;18-24;37;44;81;SEC_234
2014;625;12-15;20;24;44;SEC_625
2014;315;50-64;184;156;340;SEC_315
2014;528;50-64;104;82;186;SEC_528
2014;523;18-24;42;50;92;SEC_523
2014;412;65-74;115;82;197;SEC_412
2014;612;03-11;44;37;81;SEC_612
2014;105;16-17;3;6;9;SEC_105
2014;116;75 i +;80;69;149;SEC_116
2014;245;50-64;88;84;172;SEC_245
2014;112;12-15;32;22;54;SEC_112
2014;212;00-02;21;18;39;SEC_212
2014;236;35-49;133;120;253;SEC_236
2014;223;50-64;96;92;188;SEC_223
2014;115;18-24;27;52;79;SEC_115
2014;309;75 i +;40;22;62;SEC_309
2014;406;16-17;12;10;22;SEC_406
2014;120;25-34;88;97;185;SEC_120
2014;226;75 i +;119;75;194;SEC_226
2014;608;35-49;134;188;322;SEC_608
2014;510;16-17;6;7;13;SEC_510
2014;534;16-17;7;8;15;SEC_534
2014;311;18-24;32;51;83;SEC_311
2014;120;03-11;52;81;133;SEC_120
2014;402;00-02;8;16;24;SEC_402
2014;217;18-24;70;52;122;SEC_217
2014;325;35-49;190;193;383;SEC_325
2014;517;03-11;118;96;214;SEC_517
2014;239;16-17;12;9;21;SEC_239
2014;606;65-74;62;40;102;SEC_606
2014;401;16-17;12;18;30;SEC_401
2014;613;75 i +;80;50;130;SEC_613
2014;421;25-34;76;78;154;SEC_421
2014;430;00-02;18;13;31;SEC_430
2014;104;25-34;49;49;98;SEC_104
2014;405;35-49;230;221;451;SEC_405
2014;127;65-74;35;23;58;SEC_127
2014;139;50-64;94;84;178;SEC_139
2014;621;18-24;52;41;93;SEC_621
2014;529;65-74;55;41;96;SEC_529
2014;630;12-15;13;11;24;SEC_630
2014;122;18-24;27;17;44;SEC_122
2014;310;03-11;37;48;85;SEC_310
2014;535;25-34;46;44;90;SEC_535
2014;310;75 i +;45;20;65;SEC_310
2014;310;50-64;88;89;177;SEC_310
2014;209;25-34;76;77;153;SEC_209
2014;614;75 i +;65;52;117;SEC_614
2014;202;12-15;30;23;53;SEC_202
2014;226;00-02;19;26;45;SEC_226
2014;114;75 i +;102;62;164;SEC_114
2014;322;65-74;61;53;114;SEC_322
2014;624;65-74;106;114;220;SEC_624
2014;119;65-74;109;105;214;SEC_119
2014;201;03-11;67;78;145;SEC_201
2014;418;18-24;56;70;126;SEC_418
2014;630;16-17;4;11;15;SEC_630
2014;528;65-74;67;47;114;SEC_528
2014;606;35-49;129;141;270;SEC_606
2014;630;00-02;5;9;14;SEC_630
2014;430;12-15;17;26;43;SEC_430
2014;532;12-15;28;14;42;SEC_532
2014;309;12-15;15;26;41;SEC_309
2014;138;35-49;86;78;164;SEC_138
2014;247;35-49;182;179;361;SEC_247
2014;246;18-24;54;37;91;SEC_246
2014;611;35-49;243;278;521;SEC_611
2014;311;75 i +;96;50;146;SEC_311
2014;306;12-15;32;29;61;SEC_306
2014;511;00-02;29;28;57;SEC_511
2014;631;35-49;124;131;255;SEC_631
2014;216;35-49;154;149;303;SEC_216
2014;212;50-64;109;106;215;SEC_212
2014;306;25-34;103;101;204;SEC_306
2014;521;50-64;98;73;171;SEC_521
2014;306;65-74;65;64;129;SEC_306
2014;433;16-17;17;18;35;SEC_433
2014;233;65-74;43;21;64;SEC_233
2014;613;00-02;7;13;20;SEC_613
2014;436;50-64;124;113;237;SEC_436
2014;324;12-15;20;25;45;SEC_324
2014;307;00-02;15;11;26;SEC_307
2014;520;12-15;18;18;36;SEC_520
2014;411;50-64;84;71;155;SEC_411
2014;422;65-74;52;25;77;SEC_422
2014;238;12-15;14;18;32;SEC_238
2014;113;75 i +;56;40;96;SEC_113
2014;137;35-49;178;158;336;SEC_137
2014;409;12-15;29;24;53;SEC_409
2014;214;16-17;19;17;36;SEC_214
2014;621;65-74;106;133;239;SEC_621
2014;602;18-24;37;44;81;SEC_602
2014;503;75 i +;41;19;60;SEC_503
2014;135;25-34;80;91;171;SEC_135
2014;619;35-49;111;125;236;SEC_619
2014;612;35-49;114;143;257;SEC_612
2014;304;00-02;73;80;153;SEC_304
2014;118;35-49;181;208;389;SEC_118
2014;131;18-24;41;44;85;SEC_131
2014;611;03-11;82;100;182;SEC_611
2014;237;12-15;17;29;46;SEC_237
2014;436;00-02;20;29;49;SEC_436
2014;207;65-74;75;55;130;SEC_207
2014;618;65-74;106;84;190;SEC_618
2014;538;35-49;169;162;331;SEC_538
2014;608;25-34;59;70;129;SEC_608
2014;112;65-74;92;74;166;SEC_112
2014;401;25-34;83;89;172;SEC_401
2014;521;03-11;32;33;65;SEC_521
2014;204;75 i +;112;58;170;SEC_204
2014;613;18-24;28;36;64;SEC_613
2014;246;25-34;93;81;174;SEC_246
2014;239;12-15;13;21;34;SEC_239
2014;632;50-64;82;70;152;SEC_632
2014;504;16-17;9;6;15;SEC_504
2014;609;12-15;9;14;23;SEC_609
2014;248;00-02;16;21;37;SEC_248
2014;124;18-24;18;24;42;SEC_124
2014;248;16-17;12;13;25;SEC_248
2014;320;25-34;63;75;138;SEC_320
2014;503;03-11;17;22;39;SEC_503
2014;524;12-15;27;17;44;SEC_524
2014;423;12-15;20;16;36;SEC_423
2014;114;16-17;19;6;25;SEC_114
2014;511;18-24;81;80;161;SEC_511
2014;323;03-11;83;89;172;SEC_323
2014;117;18-24;66;57;123;SEC_117
2014;402;18-24;26;21;47;SEC_402
2014;110;16-17;9;2;11;SEC_110
2014;207;00-02;27;22;49;SEC_207
2014;605;75 i +;105;93;198;SEC_605
2014;135;03-11;42;59;101;SEC_135
2014;621;03-11;52;54;106;SEC_621
2014;624;18-24;28;27;55;SEC_624
2014;621;35-49;166;185;351;SEC_621
2014;102;50-64;142;134;276;SEC_102
2014;303;75 i +;134;110;244;SEC_303
2014;610;03-11;38;37;75;SEC_610
2014;427;12-15;33;29;62;SEC_427
2014;325;00-02;23;21;44;SEC_325
2014;609;00-02;12;8;20;SEC_609
2014;435;03-11;54;54;108;SEC_435
2014;631;03-11;36;45;81;SEC_631
2014;623;03-11;56;67;123;SEC_623
2014;506;12-15;38;36;74;SEC_506
2014;304;35-49;372;416;788;SEC_304
2014;305;12-15;29;26;55;SEC_305
2014;133;25-34;54;58;112;SEC_133
2014;240;75 i +;123;71;194;SEC_240
2014;416;65-74;67;56;123;SEC_416
2014;614;00-02;10;9;19;SEC_614
2014;514;00-02;24;26;50;SEC_514
2014;311;16-17;15;14;29;SEC_311
2014;514;12-15;29;26;55;SEC_514
2014;502;50-64;138;125;263;SEC_502
2014;305;18-24;65;53;118;SEC_305
2014;405;50-64;120;140;260;SEC_405
2014;423;50-64;81;61;142;SEC_423
2014;124;65-74;41;32;73;SEC_124
2014;525;35-49;124;136;260;SEC_525
2014;406;03-11;50;58;108;SEC_406
2014;321;50-64;292;251;543;SEC_321
2014;412;16-17;12;6;18;SEC_412
2014;621;75 i +;51;32;83;SEC_621
2014;105;25-34;64;68;132;SEC_105
2014;102;75 i +;111;77;188;SEC_102
2014;212;03-11;57;57;114;SEC_212
2014;614;25-34;37;66;103;SEC_614
2014;535;50-64;102;85;187;SEC_535
2014;619;50-64;141;124;265;SEC_619
2014;524;65-74;58;31;89;SEC_524
2014;212;75 i +;82;45;127;SEC_212
2014;306;00-02;21;27;48;SEC_306
2014;441;50-64;234;208;442;SEC_441
2014;630;35-49;86;87;173;SEC_630
2014;507;25-34;59;61;120;SEC_507
2014;409;75 i +;114;86;200;SEC_409
2014;405;00-02;21;23;44;SEC_405
2014;111;50-64;83;67;150;SEC_111
2014;626;50-64;75;78;153;SEC_626
2014;525;75 i +;69;36;105;SEC_525
2014;533;75 i +;132;82;214;SEC_533
2014;137;00-02;15;13;28;SEC_137
2014;508;00-02;26;23;49;SEC_508
2014;523;75 i +;94;66;160;SEC_523
2014;303;18-24;35;31;66;SEC_303
2014;533;65-74;105;65;170;SEC_533
2014;513;12-15;30;27;57;SEC_513
2014;621;16-17;9;14;23;SEC_621
2014;627;50-64;128;93;221;SEC_627
2014;323;18-24;58;56;114;SEC_323
2014;123;03-11;49;57;106;SEC_123
2014;233;35-49;121;149;270;SEC_233
2014;138;18-24;23;23;46;SEC_138
2014;240;18-24;74;62;136;SEC_240
2014;320;12-15;30;38;68;SEC_320
2014;228;25-34;147;164;311;SEC_228
2014;238;65-74;41;33;74;SEC_238
2014;129;16-17;13;13;26;SEC_129
2014;414;03-11;90;83;173;SEC_414
2014;138;65-74;60;43;103;SEC_138
2014;245;35-49;131;151;282;SEC_245
2014;133;00-02;13;11;24;SEC_133
2014;245;00-02;23;17;40;SEC_245
2014;102;00-02;10;13;23;SEC_102
2014;504;03-11;24;41;65;SEC_504
2014;319;75 i +;43;29;72;SEC_319
2014;632;65-74;53;49;102;SEC_632
2014;131;03-11;41;57;98;SEC_131
2014;624;00-02;17;10;27;SEC_624
2014;507;35-49;91;109;200;SEC_507
2014;103;12-15;16;18;34;SEC_103
2014;405;12-15;30;36;66;SEC_405
2014;220;03-11;60;74;134;SEC_220
2014;120;35-49;202;199;401;SEC_120
2014;214;12-15;50;45;95;SEC_214
2014;312;18-24;66;55;121;SEC_312
2014;608;75 i +;96;60;156;SEC_608
2014;530;50-64;131;117;248;SEC_530
2014;615;03-11;29;21;50;SEC_615
2014;321;03-11;70;78;148;SEC_321
2014;236;12-15;14;15;29;SEC_236
2014;316;12-15;21;28;49;SEC_316
2014;243;35-49;213;217;430;SEC_243
2014;608;18-24;37;42;79;SEC_608
2014;119;75 i +;91;47;138;SEC_119
2014;607;16-17;3;11;14;SEC_607
2014;606;16-17;5;5;10;SEC_606
2014;503;35-49;82;61;143;SEC_503
2014;513;75 i +;95;55;150;SEC_513
2014;240;25-34;122;149;271;SEC_240
2014;430;50-64;68;81;149;SEC_430
2014;303;25-34;109;102;211;SEC_303
2014;217;35-49;179;222;401;SEC_217
2014;425;18-24;38;41;79;SEC_425
2014;404;35-49;162;184;346;SEC_404
2014;517;25-34;147;166;313;SEC_517
2014;243;16-17;13;19;32;SEC_243
2014;239;50-64;92;77;169;SEC_239
2014;320;12-15;2;5;7;SEC_320
2014;627;03-11;29;29;58;SEC_627
2014;234;25-34;83;73;156;SEC_234
2014;226;65-74;81;70;151;SEC_226
2014;610;12-15;19;29;48;SEC_610
2014;418;35-49;154;175;329;SEC_418
2014;248;03-11;56;53;109;SEC_248
2014;525;16-17;8;9;17;SEC_525
2014;507;16-17;2;9;11;SEC_507
2014;237;35-49;176;191;367;SEC_237
2014;221;75 i +;116;80;196;SEC_221
2014;134;03-11;63;68;131;SEC_134
2014;249;75 i +;73;39;112;SEC_249
2014;226;18-24;52;69;121;SEC_226
2014;314;25-34;167;174;341;SEC_314
2014;317;18-24;41;37;78;SEC_317
2014;420;16-17;24;15;39;SEC_420
2014;122;35-49;114;113;227;SEC_122
2014;619;03-11;48;40;88;SEC_619
2014;523;35-49;168;174;342;SEC_523
2014;419;00-02;33;29;62;SEC_419
2014;414;18-24;68;78;146;SEC_414
2014;209;50-64;107;90;197;SEC_209
2014;327;35-49;111;111;222;SEC_327
2014;511;75 i +;137;91;228;SEC_511
2014;401;12-15;19;20;39;SEC_401
2014;220;12-15;26;20;46;SEC_220
2014;305;03-11;57;64;121;SEC_305
2014;423;75 i +;76;55;131;SEC_423
2014;223;75 i +;66;42;108;SEC_223
2014;411;00-02;10;7;17;SEC_411
2014;608;03-11;51;46;97;SEC_608
2014;134;35-49;183;164;347;SEC_134
2014;627;75 i +;48;33;81;SEC_627
2014;308;03-11;100;102;202;SEC_308
2014;513;65-74;64;44;108;SEC_513
2014;105;50-64;143;109;252;SEC_105
2014;425;35-49;129;140;269;SEC_425
2014;239;35-49;138;147;285;SEC_239
2014;433;65-74;62;45;107;SEC_433
2014;320;03-11;75;73;148;SEC_320
2014;609;16-17;13;4;17;SEC_609
2014;430;65-74;39;30;69;SEC_430
2014;409;00-02;34;26;60;SEC_409
2014;326;03-11;54;49;103;SEC_326
2014;630;75 i +;41;27;68;SEC_630
2014;302;12-15;11;20;31;SEC_302
2014;242;65-74;67;49;116;SEC_242
2014;233;12-15;12;22;34;SEC_233
2014;627;00-02;6;17;23;SEC_627
2014;125;25-34;99;105;204;SEC_125
2014;437;12-15;33;36;69;SEC_437
2014;418;25-34;77;107;184;SEC_418
2014;110;65-74;112;96;208;SEC_110
2014;523;65-74;76;54;130;SEC_523
2014;232;18-24;39;42;81;SEC_232
2014;416;25-34;97;110;207;SEC_416
2014;211;00-02;14;25;39;SEC_211
2014;427;18-24;70;84;154;SEC_427
2014;228;75 i +;133;83;216;SEC_228
2014;243;12-15;21;28;49;SEC_243
2014;309;65-74;44;42;86;SEC_309
2014;431;50-64;105;96;201;SEC_431
2014;624;25-34;53;53;106;SEC_624
2014;327;12-15;19;19;38;SEC_327
2014;314;50-64;281;261;542;SEC_314
2014;511;16-17;20;24;44;SEC_511
2014;137;65-74;83;73;156;SEC_137
2014;419;25-34;143;181;324;SEC_419
2014;419;35-49;234;306;540;SEC_419
2014;528;75 i +;67;55;122;SEC_528
2014;538;12-15;22;31;53;SEC_538
2014;104;50-64;79;69;148;SEC_104
2014;529;16-17;15;13;28;SEC_529
2014;130;18-24;26;38;64;SEC_130
2014;232;25-34;73;71;144;SEC_232
2014;214;35-49;299;313;612;SEC_214
2014;119;00-02;16;12;28;SEC_119
2014;320;16-17;0;1;1;SEC_320
2014;125;50-64;152;137;289;SEC_125
