AnyPadro;Seccio;GrupEdat;Dones;Homes;Total;IdSeccio
2011;621;25-34;101;123;224;SEC_621
2011;214;65-74;45;27;72;SEC_214
2011;621;16-17;16;13;29;SEC_621
2011;111;65-74;66;49;115;SEC_111
2011;139;18-24;27;29;56;SEC_139
2011;527;16-17;10;5;15;SEC_527
2011;226;25-34;104;116;220;SEC_226
2011;524;35-49;157;190;347;SEC_524
2011;107;03-11;71;81;152;SEC_107
2011;120;00-02;22;26;48;SEC_120
2011;238;50-64;68;68;136;SEC_238
2011;408;18-24;33;37;70;SEC_408
2011;236;00-02;12;17;29;SEC_236
2011;527;65-74;46;29;75;SEC_527
2011;508;18-24;30;23;53;SEC_508
2011;406;18-24;61;48;109;SEC_406
2011;140;18-24;25;37;62;SEC_140
2011;624;75 i +;54;25;79;SEC_624
2011;325;00-02;19;27;46;SEC_325
2011;104;00-02;10;12;22;SEC_104
2011;622;50-64;104;85;189;SEC_622
2011;505;03-11;34;38;72;SEC_505
2011;116;35-49;162;170;332;SEC_116
2011;246;25-34;111;101;212;SEC_246
2011;608;12-15;13;7;20;SEC_608
2011;530;18-24;64;62;126;SEC_530
2011;134;75 i +;77;39;116;SEC_134
2011;534;50-64;84;78;162;SEC_534
2011;139;00-02;13;12;25;SEC_139
2011;139;75 i +;35;27;62;SEC_139
2011;434;12-15;11;11;22;SEC_434
2011;247;00-02;33;28;61;SEC_247
2011;115;18-24;40;54;94;SEC_115
2011;419;65-74;49;28;77;SEC_419
2011;538;35-49;153;144;297;SEC_538
2011;134;18-24;42;42;84;SEC_134
2011;135;35-49;187;181;368;SEC_135
2011;417;75 i +;37;23;60;SEC_417
2011;236;25-34;77;87;164;SEC_236
2011;507;35-49;103;109;212;SEC_507
2011;215;75 i +;66;32;98;SEC_215
2011;245;16-17;2;9;11;SEC_245
2011;231;00-02;14;27;41;SEC_231
2011;437;00-02;17;17;34;SEC_437
2011;615;50-64;81;44;125;SEC_615
2011;417;00-02;14;23;37;SEC_417
2011;417;03-11;36;42;78;SEC_417
2011;415;35-49;97;146;243;SEC_415
2011;524;03-11;57;62;119;SEC_524
2011;603;35-49;80;79;159;SEC_603
2011;308;03-11;106;114;220;SEC_308
2011;234;35-49;135;144;279;SEC_234
2011;114;65-74;120;100;220;SEC_114
2011;625;00-02;10;12;22;SEC_625
2011;219;18-24;59;52;111;SEC_219
2011;538;65-74;77;42;119;SEC_538
2011;527;00-02;18;21;39;SEC_527
2011;208;16-17;8;15;23;SEC_208
2011;609;75 i +;33;29;62;SEC_609
2011;108;50-64;149;125;274;SEC_108
2011;130;50-64;62;63;125;SEC_130
2011;307;18-24;30;48;78;SEC_307
2011;205;00-02;10;8;18;SEC_205
2011;322;12-15;28;29;57;SEC_322
2011;132;65-74;97;102;199;SEC_132
2011;318;03-11;24;37;61;SEC_318
2011;403;18-24;36;39;75;SEC_403
2011;433;03-11;60;63;123;SEC_433
2011;629;03-11;27;12;39;SEC_629
2011;216;35-49;142;135;277;SEC_216
2011;615;16-17;5;6;11;SEC_615
2011;602;75 i +;30;29;59;SEC_602
2011;207;00-02;12;13;25;SEC_207
2011;229;65-74;34;26;60;SEC_229
2011;402;00-02;13;13;26;SEC_402
2011;201;65-74;50;36;86;SEC_201
2011;132;03-11;98;71;169;SEC_132
2011;228;35-49;102;108;210;SEC_228
2011;521;50-64;130;96;226;SEC_521
2011;133;00-02;17;11;28;SEC_133
2011;110;18-24;38;36;74;SEC_110
2011;508;50-64;46;38;84;SEC_508
2011;304;00-02;44;55;99;SEC_304
2011;128;25-34;82;95;177;SEC_128
2011;602;00-02;5;7;12;SEC_602
2011;630;35-49;76;97;173;SEC_630
2011;237;00-02;24;32;56;SEC_237
2011;538;50-64;99;84;183;SEC_538
2011;631;16-17;8;7;15;SEC_631
2011;247;16-17;10;11;21;SEC_247
2011;323;16-17;30;30;60;SEC_323
2011;203;18-24;36;31;67;SEC_203
2011;114;16-17;11;13;24;SEC_114
2011;528;50-64;96;78;174;SEC_528
2011;320;18-24;30;32;62;SEC_320
2011;508;12-15;5;12;17;SEC_508
2011;631;75 i +;54;29;83;SEC_631
2011;422;50-64;79;89;168;SEC_422
2011;611;35-49;231;285;516;SEC_611
2011;314;18-24;67;114;181;SEC_314
2011;120;03-11;55;91;146;SEC_120
2011;219;50-64;95;81;176;SEC_219
2011;133;12-15;17;14;31;SEC_133
2011;417;50-64;52;45;97;SEC_417
2011;430;00-02;21;19;40;SEC_430
2011;322;25-34;127;109;236;SEC_322
2011;248;50-64;106;97;203;SEC_248
2011;526;16-17;9;13;22;SEC_526
2011;236;03-11;51;43;94;SEC_236
2011;221;75 i +;75;47;122;SEC_221
2011;136;16-17;11;3;14;SEC_136
2011;629;35-49;54;74;128;SEC_629
2011;511;35-49;96;98;194;SEC_511
2011;202;35-49;104;137;241;SEC_202
2011;501;65-74;65;80;145;SEC_501
2011;424;75 i +;30;32;62;SEC_424
2011;210;18-24;18;18;36;SEC_210
2011;440;00-02;9;12;21;SEC_440
2011;413;18-24;24;26;50;SEC_413
2011;422;03-11;48;50;98;SEC_422
2011;626;35-49;104;103;207;SEC_626
2011;324;18-24;36;47;83;SEC_324
2011;302;50-64;163;130;293;SEC_302
2011;113;16-17;8;19;27;SEC_113
2011;301;25-34;170;168;338;SEC_301
2011;117;75 i +;79;45;124;SEC_117
2011;202;25-34;92;106;198;SEC_202
2011;232;00-02;16;16;32;SEC_232
2011;404;12-15;27;36;63;SEC_404
2011;139;12-15;13;29;42;SEC_139
2011;411;16-17;10;7;17;SEC_411
2011;130;00-02;13;20;33;SEC_130
2011;222;35-49;133;156;289;SEC_222
2011;523;03-11;55;55;110;SEC_523
2011;622;65-74;43;40;83;SEC_622
2011;246;50-64;87;80;167;SEC_246
2011;502;12-15;26;33;59;SEC_502
2011;312;16-17;10;11;21;SEC_312
2011;538;75 i +;95;59;154;SEC_538
2011;430;75 i +;51;30;81;SEC_430
2011;420;16-17;13;14;27;SEC_420
2011;438;00-02;16;9;25;SEC_438
2011;224;12-15;11;13;24;SEC_224
2011;102;00-02;20;14;34;SEC_102
2011;313;00-02;28;24;52;SEC_313
2011;101;00-02;37;43;80;SEC_101
2011;436;75 i +;28;24;52;SEC_436
2011;607;18-24;42;38;80;SEC_607
2011;201;03-11;51;54;105;SEC_201
2011;431;03-11;82;79;161;SEC_431
2011;232;18-24;40;35;75;SEC_232
2011;604;16-17;8;7;15;SEC_604
2011;225;12-15;5;7;12;SEC_225
2011;616;16-17;27;38;65;SEC_616
2011;235;00-02;28;25;53;SEC_235
2011;513;12-15;14;14;28;SEC_513
2011;235;65-74;78;59;137;SEC_235
2011;123;03-11;47;52;99;SEC_123
2011;528;65-74;65;52;117;SEC_528
2011;510;25-34;74;74;148;SEC_510
2011;537;75 i +;74;55;129;SEC_537
2011;213;03-11;32;51;83;SEC_213
2011;113;50-64;227;189;416;SEC_113
2011;430;50-64;63;62;125;SEC_430
2011;303;12-15;18;27;45;SEC_303
2011;225;75 i +;48;21;69;SEC_225
2011;135;18-24;50;49;99;SEC_135
2011;420;12-15;24;26;50;SEC_420
2011;112;16-17;21;11;32;SEC_112
2011;429;16-17;7;4;11;SEC_429
2011;116;25-34;89;100;189;SEC_116
2011;117;50-64;238;219;457;SEC_117
2011;246;35-49;149;180;329;SEC_246
2011;602;18-24;13;16;29;SEC_602
2011;230;65-74;32;19;51;SEC_230
2011;619;65-74;102;85;187;SEC_619
2011;220;65-74;36;23;59;SEC_220
2011;425;50-64;81;75;156;SEC_425
2011;302;16-17;8;11;19;SEC_302
2011;317;03-11;58;53;111;SEC_317
2011;625;35-49;114;103;217;SEC_625
2011;312;35-49;224;258;482;SEC_312
2011;128;12-15;11;14;25;SEC_128
2011;219;12-15;30;29;59;SEC_219
2011;321;25-34;183;151;334;SEC_321
2011;323;12-15;64;50;114;SEC_323
2011;133;50-64;96;75;171;SEC_133
2011;210;03-11;30;25;55;SEC_210
2011;323;35-49;326;347;673;SEC_323
2011;611;18-24;64;62;126;SEC_611
2011;228;00-02;11;17;28;SEC_228
2011;620;12-15;6;15;21;SEC_620
2011;111;03-11;29;39;68;SEC_111
2011;629;65-74;38;26;64;SEC_629
2011;245;35-49;153;157;310;SEC_245
2011;614;65-74;80;75;155;SEC_614
2011;218;16-17;10;3;13;SEC_218
2011;419;75 i +;44;33;77;SEC_419
2011;124;12-15;10;12;22;SEC_124
2011;615;03-11;40;25;65;SEC_615
2011;404;65-74;74;45;119;SEC_404
2011;502;25-34;133;149;282;SEC_502
2011;312;25-34;182;174;356;SEC_312
2011;525;03-11;41;44;85;SEC_525
2011;527;75 i +;57;28;85;SEC_527
2011;321;65-74;108;109;217;SEC_321
2011;440;50-64;91;79;170;SEC_440
2011;601;00-02;20;24;44;SEC_601
2011;440;35-49;114;116;230;SEC_440
2011;517;35-49;160;210;370;SEC_517
2011;218;50-64;74;68;142;SEC_218
2011;311;25-34;114;128;242;SEC_311
2011;619;75 i +;82;66;148;SEC_619
2011;138;50-64;101;95;196;SEC_138
2011;209;50-64;93;77;170;SEC_209
2011;220;35-49;125;118;243;SEC_220
2011;208;25-34;132;127;259;SEC_208
2011;109;00-02;19;18;37;SEC_109
2011;110;35-49;127;118;245;SEC_110
2011;515;12-15;9;10;19;SEC_515
2011;313;35-49;236;217;453;SEC_313
2011;110;50-64;151;130;281;SEC_110
2011;322;65-74;57;45;102;SEC_322
2011;604;00-02;7;11;18;SEC_604
2011;221;03-11;28;36;64;SEC_221
2011;605;65-74;71;66;137;SEC_605
2011;532;03-11;63;59;122;SEC_532
2011;219;00-02;16;21;37;SEC_219
2011;216;03-11;48;41;89;SEC_216
2011;232;16-17;11;8;19;SEC_232
2011;613;12-15;13;24;37;SEC_613
2011;304;65-74;80;53;133;SEC_304
2011;619;03-11;41;45;86;SEC_619
2011;502;03-11;47;73;120;SEC_502
2011;514;25-34;59;66;125;SEC_514
2011;414;18-24;42;37;79;SEC_414
2011;316;35-49;142;122;264;SEC_316
2011;519;00-02;8;12;20;SEC_519
2011;628;03-11;42;46;88;SEC_628
2011;211;12-15;20;28;48;SEC_211
2011;126;65-74;87;87;174;SEC_126
2011;301;65-74;140;112;252;SEC_301
2011;124;35-49;80;79;159;SEC_124
2011;423;12-15;16;15;31;SEC_423
2011;302;12-15;15;18;33;SEC_302
2011;130;75 i +;94;61;155;SEC_130
2011;627;75 i +;45;32;77;SEC_627
2011;216;16-17;19;9;28;SEC_216
2011;427;25-34;102;109;211;SEC_427
2011;245;50-64;78;73;151;SEC_245
2011;117;16-17;19;19;38;SEC_117
2011;236;35-49;138;121;259;SEC_236
2011;120;50-64;196;198;394;SEC_120
2011;114;00-02;11;26;37;SEC_114
2011;122;16-17;10;5;15;SEC_122
2011;213;16-17;9;10;19;SEC_213
2011;202;50-64;71;53;124;SEC_202
2011;537;65-74;87;73;160;SEC_537
2011;242;16-17;9;4;13;SEC_242
2011;621;12-15;23;34;57;SEC_621
2011;207;12-15;9;12;21;SEC_207
2011;246;65-74;35;37;72;SEC_246
2011;223;75 i +;69;47;116;SEC_223
2011;625;65-74;82;64;146;SEC_625
2011;623;50-64;164;121;285;SEC_623
2011;135;16-17;20;8;28;SEC_135
2011;536;18-24;32;28;60;SEC_536
2011;105;75 i +;57;35;92;SEC_105
2011;524;12-15;22;22;44;SEC_524
2011;420;25-34;135;130;265;SEC_420
2011;244;16-17;7;4;11;SEC_244
2011;407;75 i +;97;55;152;SEC_407
2011;205;03-11;32;31;63;SEC_205
2011;213;25-34;73;105;178;SEC_213
2011;439;35-49;153;164;317;SEC_439
2011;630;50-64;114;89;203;SEC_630
2011;124;25-34;69;60;129;SEC_124
2011;220;75 i +;56;38;94;SEC_220
2011;233;03-11;36;36;72;SEC_233
2011;241;12-15;26;17;43;SEC_241
2011;438;16-17;4;9;13;SEC_438
2011;306;00-02;26;16;42;SEC_306
2011;429;65-74;24;22;46;SEC_429
2011;226;18-24;49;53;102;SEC_226
2011;441;16-17;21;7;28;SEC_441
2011;234;12-15;17;14;31;SEC_234
2011;121;12-15;20;16;36;SEC_121
2011;610;65-74;123;118;241;SEC_610
2011;504;75 i +;86;69;155;SEC_504
2011;407;50-64;78;76;154;SEC_407
2011;209;75 i +;78;68;146;SEC_209
2011;432;75 i +;71;51;122;SEC_432
2011;208;03-11;43;55;98;SEC_208
2011;537;03-11;59;35;94;SEC_537
2011;514;16-17;11;5;16;SEC_514
2011;535;25-34;55;55;110;SEC_535
2011;106;75 i +;77;33;110;SEC_106
2011;123;65-74;54;50;104;SEC_123
2011;601;12-15;13;17;30;SEC_601
2011;111;00-02;11;6;17;SEC_111
2011;226;65-74;48;38;86;SEC_226
2011;514;75 i +;47;32;79;SEC_514
2011;236;12-15;19;17;36;SEC_236
2011;209;65-74;52;32;84;SEC_209
2011;203;16-17;4;6;10;SEC_203
2011;614;16-17;6;10;16;SEC_614
2011;402;65-74;45;33;78;SEC_402
2011;421;16-17;8;14;22;SEC_421
2011;305;12-15;31;22;53;SEC_305
2011;623;65-74;99;105;204;SEC_623
2011;414;35-49;136;128;264;SEC_414
2011;203;65-74;34;36;70;SEC_203
2011;108;75 i +;118;72;190;SEC_108
2011;437;18-24;43;55;98;SEC_437
2011;517;65-74;59;40;99;SEC_517
2011;127;25-34;69;61;130;SEC_127
2011;226;35-49;176;163;339;SEC_226
2011;434;16-17;9;5;14;SEC_434
2011;211;50-64;100;88;188;SEC_211
2011;227;50-64;67;55;122;SEC_227
2011;227;75 i +;52;34;86;SEC_227
2011;313;65-74;88;72;160;SEC_313
2011;605;25-34;42;48;90;SEC_605
2011;102;03-11;66;73;139;SEC_102
2011;426;35-49;127;146;273;SEC_426
2011;309;25-34;112;104;216;SEC_309
2011;440;16-17;9;3;12;SEC_440
2011;632;50-64;84;71;155;SEC_632
2011;618;03-11;38;37;75;SEC_618
2011;316;03-11;43;54;97;SEC_316
2011;240;00-02;9;15;24;SEC_240
2011;535;18-24;34;33;67;SEC_535
2011;521;75 i +;58;48;106;SEC_521
2011;533;25-34;107;108;215;SEC_533
2011;313;25-34;125;133;258;SEC_313
2011;501;25-34;65;64;129;SEC_501
2011;407;03-11;47;51;98;SEC_407
2011;130;35-49;137;145;282;SEC_130
2011;516;03-11;32;30;62;SEC_516
2011;139;16-17;5;5;10;SEC_139
2011;243;35-49;214;201;415;SEC_243
2011;415;12-15;11;20;31;SEC_415
2011;530;16-17;7;9;16;SEC_530
2011;137;65-74;71;67;138;SEC_137
2011;603;00-02;18;18;36;SEC_603
2011;217;25-34;59;71;130;SEC_217
2011;409;00-02;13;13;26;SEC_409
2011;410;00-02;15;17;32;SEC_410
2011;607;25-34;63;89;152;SEC_607
2011;240;75 i +;60;38;98;SEC_240
2011;508;25-34;52;53;105;SEC_508
2011;122;12-15;13;12;25;SEC_122
2011;309;16-17;9;12;21;SEC_309
2011;504;25-34;74;72;146;SEC_504
2011;132;75 i +;101;69;170;SEC_132
2011;215;00-02;13;17;30;SEC_215
2011;126;75 i +;70;37;107;SEC_126
2011;522;25-34;77;86;163;SEC_522
2011;608;16-17;9;6;15;SEC_608
2011;401;35-49;140;136;276;SEC_401
2011;403;16-17;7;5;12;SEC_403
2011;507;00-02;15;10;25;SEC_507
2011;212;16-17;4;14;18;SEC_212
2011;605;50-64;53;35;88;SEC_605
2011;219;25-34;99;112;211;SEC_219
2011;606;65-74;70;50;120;SEC_606
2011;432;25-34;81;108;189;SEC_432
2011;421;18-24;45;47;92;SEC_421
2011;610;16-17;12;13;25;SEC_610
2011;603;50-64;50;42;92;SEC_603
2011;506;75 i +;102;67;169;SEC_506
2011;208;75 i +;233;122;355;SEC_208
2011;244;03-11;28;30;58;SEC_244
2011;319;00-02;29;39;68;SEC_319
2011;431;50-64;109;107;216;SEC_431
2011;411;75 i +;96;71;167;SEC_411
2011;627;00-02;9;17;26;SEC_627
2011;431;12-15;25;29;54;SEC_431
2011;632;18-24;26;34;60;SEC_632
2011;519;75 i +;40;31;71;SEC_519
2011;207;03-11;34;28;62;SEC_207
2011;627;25-34;76;82;158;SEC_627
2011;303;18-24;48;37;85;SEC_303
2011;406;16-17;7;16;23;SEC_406
2011;416;75 i +;51;45;96;SEC_416
2011;222;03-11;37;38;75;SEC_222
2011;536;35-49;108;120;228;SEC_536
2011;216;50-64;117;101;218;SEC_216
2011;617;50-64;88;82;170;SEC_617
2011;439;12-15;22;24;46;SEC_439
2011;204;00-02;12;5;17;SEC_204
2011;318;65-74;35;25;60;SEC_318
2011;504;03-11;32;36;68;SEC_504
2011;218;03-11;19;27;46;SEC_218
2011;533;75 i +;57;39;96;SEC_533
2011;607;50-64;80;73;153;SEC_607
2011;105;00-02;17;20;37;SEC_105
2011;434;50-64;54;58;112;SEC_434
2011;123;35-49;150;163;313;SEC_123
2011;437;25-34;70;98;168;SEC_437
2011;433;65-74;31;28;59;SEC_433
2011;203;35-49;105;133;238;SEC_203
2011;514;18-24;42;20;62;SEC_514
2011;101;50-64;147;136;283;SEC_101
2011;222;18-24;36;47;83;SEC_222
2011;509;35-49;100;113;213;SEC_509
2011;510;65-74;54;52;106;SEC_510
2011;207;65-74;32;28;60;SEC_207
2011;239;50-64;91;80;171;SEC_239
2011;512;50-64;63;61;124;SEC_512
2011;124;16-17;2;4;6;SEC_124
2011;116;03-11;58;61;119;SEC_116
2011;413;00-02;9;11;20;SEC_413
2011;321;12-15;47;34;81;SEC_321
2011;526;25-34;67;83;150;SEC_526
2011;405;75 i +;85;54;139;SEC_405
2011;243;75 i +;105;73;178;SEC_243
2011;525;65-74;53;32;85;SEC_525
2011;239;35-49;135;150;285;SEC_239
2011;228;50-64;39;48;87;SEC_228
2011;126;50-64;84;65;149;SEC_126
2011;525;12-15;17;16;33;SEC_525
2011;518;03-11;47;49;96;SEC_518
2011;435;65-74;38;29;67;SEC_435
2011;535;00-02;12;10;22;SEC_535
2011;405;35-49;95;109;204;SEC_405
2011;529;50-64;86;86;172;SEC_529
2011;216;65-74;75;54;129;SEC_216
2011;242;03-11;31;39;70;SEC_242
2011;229;03-11;31;31;62;SEC_229
2011;202;18-24;30;30;60;SEC_202
2011;420;35-49;174;178;352;SEC_420
2011;110;03-11;42;36;78;SEC_110
2011;405;65-74;77;46;123;SEC_405
2011;408;16-17;8;7;15;SEC_408
2011;109;03-11;41;39;80;SEC_109
2011;442;16-17;5;5;10;SEC_442
2011;237;75 i +;87;52;139;SEC_237
2011;101;75 i +;50;42;92;SEC_101
2011;114;25-34;105;107;212;SEC_114
2011;440;03-11;38;49;87;SEC_440
2011;301;12-15;36;37;73;SEC_301
2011;129;65-74;69;71;140;SEC_129
2011;318;50-64;105;107;212;SEC_318
2011;422;16-17;7;10;17;SEC_422
2011;533;18-24;41;36;77;SEC_533
2011;139;03-11;36;42;78;SEC_139
2011;135;03-11;47;59;106;SEC_135
2011;120;12-15;34;45;79;SEC_120
2011;519;03-11;26;32;58;SEC_519
2011;607;16-17;13;7;20;SEC_607
2011;321;18-24;86;90;176;SEC_321
2011;313;18-24;66;60;126;SEC_313
2011;210;50-64;75;79;154;SEC_210
2011;137;12-15;32;24;56;SEC_137
2011;415;00-02;16;19;35;SEC_415
2011;410;50-64;163;132;295;SEC_410
2011;509;65-74;39;32;71;SEC_509
2011;210;65-74;56;50;106;SEC_210
2011;517;75 i +;62;39;101;SEC_517
2011;132;50-64;233;217;450;SEC_132
2011;515;50-64;36;32;68;SEC_515
2011;108;35-49;205;172;377;SEC_108
2011;220;50-64;68;57;125;SEC_220
2011;602;25-34;38;39;77;SEC_602
2011;629;16-17;4;5;9;SEC_629
2011;627;50-64;157;127;284;SEC_627
2011;218;00-02;11;12;23;SEC_218
2011;522;65-74;29;13;42;SEC_522
2011;522;00-02;23;20;43;SEC_522
2011;534;03-11;29;33;62;SEC_534
2011;235;25-34;137;141;278;SEC_235
2011;212;18-24;74;56;130;SEC_212
2011;304;12-15;63;32;95;SEC_304
2011;247;25-34;127;133;260;SEC_247
2011;213;75 i +;59;36;95;SEC_213
2011;206;75 i +;81;45;126;SEC_206
2011;126;12-15;15;17;32;SEC_126
2011;131;35-49;149;179;328;SEC_131
2011;503;50-64;123;94;217;SEC_503
2011;314;50-64;272;260;532;SEC_314
2011;242;65-74;69;57;126;SEC_242
2011;533;16-17;9;5;14;SEC_533
2011;529;35-49;168;165;333;SEC_529
2011;307;03-11;34;34;68;SEC_307
2011;115;00-02;24;25;49;SEC_115
2011;137;25-34;121;122;243;SEC_137
2011;623;35-49;147;163;310;SEC_623
2011;622;75 i +;32;16;48;SEC_622
2011;310;00-02;13;18;31;SEC_310
2011;309;12-15;9;28;37;SEC_309
2011;135;00-02;17;20;37;SEC_135
2011;438;18-24;28;31;59;SEC_438
2011;535;12-15;11;11;22;SEC_535
2011;516;50-64;44;47;91;SEC_516
2011;322;16-17;9;14;23;SEC_322
2011;628;75 i +;53;37;90;SEC_628
2011;529;16-17;14;10;24;SEC_529
2011;245;75 i +;74;44;118;SEC_245
2011;523;25-34;129;122;251;SEC_523
2011;316;00-02;15;16;31;SEC_316
2011;236;75 i +;96;63;159;SEC_236
2011;512;16-17;7;4;11;SEC_512
2011;428;12-15;16;10;26;SEC_428
2011;306;65-74;65;47;112;SEC_306
2011;241;25-34;79;65;144;SEC_241
2011;422;00-02;14;19;33;SEC_422
2011;404;75 i +;87;54;141;SEC_404
2011;140;12-15;14;20;34;SEC_140
2011;606;00-02;23;21;44;SEC_606
2011;526;50-64;49;56;105;SEC_526
2011;240;50-64;61;44;105;SEC_240
2011;616;12-15;61;85;146;SEC_616
2011;311;03-11;62;76;138;SEC_311
2011;232;35-49;128;133;261;SEC_232
2011;522;75 i +;42;35;77;SEC_522
2011;441;75 i +;96;69;165;SEC_441
2011;439;00-02;27;27;54;SEC_439
2011;442;35-49;70;83;153;SEC_442
2011;324;35-49;144;160;304;SEC_324
2011;420;03-11;64;79;143;SEC_420
2011;511;75 i +;51;29;80;SEC_511
2011;132;00-02;28;25;53;SEC_132
2011;245;03-11;51;42;93;SEC_245
2011;119;50-64;161;127;288;SEC_119
2011;531;75 i +;50;35;85;SEC_531
2011;231;50-64;78;63;141;SEC_231
2011;110;75 i +;76;36;112;SEC_110
2011;239;25-34;117;119;236;SEC_239
2011;439;16-17;14;9;23;SEC_439
2011;249;18-24;47;45;92;SEC_249
2011;313;16-17;16;9;25;SEC_313
2011;238;00-02;12;12;24;SEC_238
2011;616;03-11;139;144;283;SEC_616
2011;133;03-11;39;38;77;SEC_133
2011;118;00-02;22;28;50;SEC_118
2011;247;65-74;52;51;103;SEC_247
2011;435;03-11;58;52;110;SEC_435
2011;302;35-49;149;173;322;SEC_302
2011;229;75 i +;51;38;89;SEC_229
2011;442;75 i +;31;18;49;SEC_442
2011;434;00-02;10;12;22;SEC_434
2011;128;16-17;9;4;13;SEC_128
2011;314;12-15;35;37;72;SEC_314
2011;239;65-74;62;41;103;SEC_239
2011;113;12-15;28;27;55;SEC_113
2011;515;18-24;31;31;62;SEC_515
2011;138;35-49;82;65;147;SEC_138
2011;625;75 i +;47;28;75;SEC_625
2011;309;00-02;22;29;51;SEC_309
2011;217;18-24;43;39;82;SEC_217
2011;502;18-24;51;51;102;SEC_502
2011;524;25-34;142;113;255;SEC_524
2011;127;18-24;33;37;70;SEC_127
2011;305;25-34;117;127;244;SEC_305
2011;429;25-34;44;51;95;SEC_429
2011;440;75 i +;65;48;113;SEC_440
2011;533;35-49;122;144;266;SEC_533
2011;602;12-15;9;12;21;SEC_602
2011;119;35-49;130;132;262;SEC_119
2011;129;00-02;19;21;40;SEC_129
2011;122;18-24;34;18;52;SEC_122
2011;412;75 i +;92;82;174;SEC_412
2011;612;18-24;24;29;53;SEC_612
2011;218;12-15;10;16;26;SEC_218
2011;214;12-15;16;12;28;SEC_214
2011;208;18-24;48;49;97;SEC_208
2011;121;65-74;32;17;49;SEC_121
2011;249;12-15;20;19;39;SEC_249
2011;130;12-15;14;17;31;SEC_130
2011;324;16-17;9;12;21;SEC_324
2011;605;75 i +;46;34;80;SEC_605
2011;140;16-17;3;14;17;SEC_140
2011;114;50-64;157;121;278;SEC_114
2011;409;35-49;95;104;199;SEC_409
2011;107;35-49;199;210;409;SEC_107
2011;614;00-02;7;16;23;SEC_614
2011;437;50-64;66;63;129;SEC_437
2011;317;25-34;112;124;236;SEC_317
2011;217;35-49;95;118;213;SEC_217
2011;122;75 i +;55;40;95;SEC_122
2011;417;12-15;9;15;24;SEC_417
2011;430;65-74;49;38;87;SEC_430
2011;630;65-74;54;47;101;SEC_630
2011;535;75 i +;42;39;81;SEC_535
2011;205;16-17;8;9;17;SEC_205
2011;112;18-24;48;66;114;SEC_112
2011;129;50-64;93;85;178;SEC_129
2011;312;12-15;22;28;50;SEC_312
2011;534;12-15;15;18;33;SEC_534
2011;623;00-02;16;15;31;SEC_623
2011;530;12-15;20;29;49;SEC_530
2011;424;25-34;51;57;108;SEC_424
2011;315;50-64;162;157;319;SEC_315
2011;515;75 i +;35;16;51;SEC_515
2011;432;50-64;168;131;299;SEC_432
2011;127;65-74;37;22;59;SEC_127
2011;421;03-11;54;39;93;SEC_421
2011;322;00-02;21;22;43;SEC_322
2011;437;16-17;7;6;13;SEC_437
2011;108;03-11;58;45;103;SEC_108
2011;321;35-49;258;216;474;SEC_321
2011;119;00-02;8;9;17;SEC_119
2011;242;00-02;11;15;26;SEC_242
2011;609;03-11;33;27;60;SEC_609
2011;537;16-17;11;11;22;SEC_537
2011;625;16-17;9;9;18;SEC_625
2011;441;12-15;39;32;71;SEC_441
2011;313;75 i +;97;63;160;SEC_313
2011;516;35-49;100;101;201;SEC_516
2011;206;18-24;34;33;67;SEC_206
2011;513;35-49;99;80;179;SEC_513
2011;237;35-49;176;210;386;SEC_237
2011;209;25-34;92;83;175;SEC_209
2011;512;12-15;16;15;31;SEC_512
2011;104;25-34;61;55;116;SEC_104
2011;424;65-74;32;21;53;SEC_424
2011;420;18-24;52;48;100;SEC_420
2011;107;50-64;159;129;288;SEC_107
2011;115;75 i +;80;39;119;SEC_115
2011;131;65-74;81;77;158;SEC_131
2011;512;03-11;35;39;74;SEC_512
2011;310;65-74;37;39;76;SEC_310
2011;616;65-74;106;90;196;SEC_616
2011;115;16-17;7;19;26;SEC_115
2011;204;03-11;24;26;50;SEC_204
2011;503;12-15;14;14;28;SEC_503
2011;103;25-34;55;65;120;SEC_103
2011;605;35-49;74;70;144;SEC_605
2011;603;03-11;36;43;79;SEC_603
2011;501;18-24;31;27;58;SEC_501
2011;516;65-74;32;19;51;SEC_516
2011;219;35-49;186;158;344;SEC_219
2011;622;12-15;7;15;22;SEC_622
2011;233;12-15;12;25;37;SEC_233
2011;244;12-15;7;7;14;SEC_244
2011;523;50-64;104;107;211;SEC_523
2011;117;00-02;24;28;52;SEC_117
2011;614;75 i +;56;42;98;SEC_614
2011;426;12-15;22;13;35;SEC_426
2011;441;65-74;105;94;199;SEC_441
2011;631;25-34;76;70;146;SEC_631
2011;442;18-24;27;26;53;SEC_442
2011;102;50-64;155;138;293;SEC_102
2011;517;12-15;28;29;57;SEC_517
2011;501;75 i +;36;23;59;SEC_501
2011;611;75 i +;90;62;152;SEC_611
2011;436;00-02;20;24;44;SEC_436
2011;325;16-17;19;11;30;SEC_325
2011;204;75 i +;44;21;65;SEC_204
2011;246;00-02;13;21;34;SEC_246
2011;305;35-49;184;178;362;SEC_305
2011;138;75 i +;39;29;68;SEC_138
2011;320;16-17;7;4;11;SEC_320
2011;516;25-34;53;62;115;SEC_516
2011;301;75 i +;135;91;226;SEC_301
2011;515;65-74;28;30;58;SEC_515
2011;429;00-02;5;7;12;SEC_429
2011;230;16-17;11;12;23;SEC_230
2011;211;03-11;60;62;122;SEC_211
2011;411;03-11;39;35;74;SEC_411
2011;243;25-34;116;109;225;SEC_243
2011;606;50-64;79;68;147;SEC_606
2011;621;03-11;46;65;111;SEC_621
2011;508;00-02;5;12;17;SEC_508
2011;215;25-34;93;74;167;SEC_215
2011;125;18-24;58;50;108;SEC_125
2011;229;50-64;74;61;135;SEC_229
2011;427;65-74;37;24;61;SEC_427
2011;608;03-11;22;30;52;SEC_608
2011;203;75 i +;47;30;77;SEC_203
2011;407;35-49;120;142;262;SEC_407
2011;314;25-34;205;213;418;SEC_314
2011;531;18-24;44;32;76;SEC_531
2011;410;75 i +;139;106;245;SEC_410
2011;306;18-24;59;64;123;SEC_306
2011;217;16-17;3;6;9;SEC_217
2011;413;50-64;47;50;97;SEC_413
2011;521;00-02;15;8;23;SEC_521
2011;530;75 i +;97;70;167;SEC_530
2011;529;65-74;65;45;110;SEC_529
2011;534;35-49;127;129;256;SEC_534
2011;513;65-74;46;33;79;SEC_513
2011;305;75 i +;101;58;159;SEC_305
2011;510;03-11;44;28;72;SEC_510
2011;137;35-49;184;171;355;SEC_137
2011;135;25-34;104;116;220;SEC_135
2011;428;03-11;33;25;58;SEC_428
2011;119;03-11;33;39;72;SEC_119
2011;519;18-24;18;31;49;SEC_519
2011;409;12-15;9;11;20;SEC_409
2011;214;35-49;128;138;266;SEC_214
2011;617;03-11;36;40;76;SEC_617
2011;315;65-74;68;61;129;SEC_315
2011;205;12-15;16;16;32;SEC_205
2011;612;75 i +;60;42;102;SEC_612
2011;130;16-17;10;6;16;SEC_130
2011;506;12-15;33;31;64;SEC_506
2011;534;65-74;55;48;103;SEC_534
2011;112;25-34;125;101;226;SEC_112
2011;227;00-02;9;10;19;SEC_227
2011;244;65-74;31;22;53;SEC_244
2011;231;35-49;164;169;333;SEC_231
2011;519;12-15;13;19;32;SEC_519
2011;236;16-17;19;3;22;SEC_236
2011;111;75 i +;61;47;108;SEC_111
2011;105;18-24;46;56;102;SEC_105
2011;123;50-64;125;111;236;SEC_123
2011;431;16-17;21;23;44;SEC_431
2011;510;35-49;114;141;255;SEC_510
2011;321;16-17;17;23;40;SEC_321
2011;423;65-74;50;53;103;SEC_423
2011;439;18-24;50;58;108;SEC_439
2011;124;00-02;12;10;22;SEC_124
2011;534;18-24;40;39;79;SEC_534
2011;508;16-17;4;4;8;SEC_508
2011;624;18-24;35;28;63;SEC_624
2011;516;75 i +;45;23;68;SEC_516
2011;619;16-17;4;7;11;SEC_619
2011;130;65-74;62;44;106;SEC_130
2011;432;16-17;5;9;14;SEC_432
2011;601;03-11;51;59;110;SEC_601
2011;314;03-11;83;98;181;SEC_314
2011;239;75 i +;100;62;162;SEC_239
2011;438;65-74;61;48;109;SEC_438
2011;305;00-02;20;23;43;SEC_305
2011;308;18-24;59;68;127;SEC_308
2011;430;25-34;111;108;219;SEC_430
2011;131;16-17;8;7;15;SEC_131
2011;620;75 i +;36;25;61;SEC_620
2011;324;03-11;56;53;109;SEC_324
2011;319;03-11;100;110;210;SEC_319
2011;434;03-11;31;36;67;SEC_434
2011;214;50-64;52;42;94;SEC_214
2011;231;03-11;61;60;121;SEC_231
2011;531;12-15;14;20;34;SEC_531
2011;522;12-15;11;22;33;SEC_522
2011;222;12-15;21;14;35;SEC_222
2011;230;03-11;50;39;89;SEC_230
2011;417;16-17;6;11;17;SEC_417
2011;211;00-02;19;23;42;SEC_211
2011;609;65-74;72;81;153;SEC_609
2011;627;35-49;88;105;193;SEC_627
2011;249;75 i +;74;43;117;SEC_249
2011;419;25-34;77;76;153;SEC_419
2011;617;16-17;8;9;17;SEC_617
2011;604;03-11;24;31;55;SEC_604
2011;101;12-15;32;29;61;SEC_101
2011;212;50-64;108;110;218;SEC_212
2011;617;75 i +;57;33;90;SEC_617
2011;133;65-74;44;39;83;SEC_133
2011;418;65-74;79;59;138;SEC_418
2011;237;25-34;147;119;266;SEC_237
2011;225;25-34;44;53;97;SEC_225
2011;605;12-15;5;7;12;SEC_605
2011;520;12-15;10;12;22;SEC_520
2011;222;75 i +;44;28;72;SEC_222
2011;318;75 i +;28;19;47;SEC_318
2011;422;18-24;41;53;94;SEC_422
2011;303;00-02;20;19;39;SEC_303
2011;504;50-64;88;69;157;SEC_504
2011;306;03-11;62;58;120;SEC_306
2011;409;03-11;26;29;55;SEC_409
2011;615;75 i +;38;33;71;SEC_615
2011;432;00-02;12;18;30;SEC_432
2011;103;03-11;30;39;69;SEC_103
2011;520;03-11;39;36;75;SEC_520
2011;249;50-64;91;77;168;SEC_249
2011;531;35-49;123;141;264;SEC_531
2011;532;00-02;24;22;46;SEC_532
2011;204;65-74;23;17;40;SEC_204
2011;219;03-11;49;46;95;SEC_219
2011;215;65-74;44;26;70;SEC_215
2011;228;12-15;8;12;20;SEC_228
2011;537;00-02;13;17;30;SEC_537
2011;532;75 i +;86;57;143;SEC_532
2011;416;00-02;9;13;22;SEC_416
2011;312;00-02;28;34;62;SEC_312
2011;238;75 i +;66;40;106;SEC_238
2011;504;65-74;90;82;172;SEC_504
2011;613;35-49;147;171;318;SEC_613
2011;433;00-02;21;34;55;SEC_433
2011;316;18-24;102;97;199;SEC_316
2011;626;65-74;70;52;122;SEC_626
2011;503;03-11;24;22;46;SEC_503
2011;201;18-24;22;31;53;SEC_201
2011;302;00-02;20;29;49;SEC_302
2011;529;00-02;18;21;39;SEC_529
2011;307;16-17;8;5;13;SEC_307
2011;406;35-49;142;169;311;SEC_406
2011;419;18-24;37;38;75;SEC_419
2011;506;65-74;113;133;246;SEC_506
2011;407;25-34;83;90;173;SEC_407
2011;206;25-34;59;94;153;SEC_206
2011;519;16-17;7;5;12;SEC_519
2011;307;65-74;97;86;183;SEC_307
2011;102;75 i +;103;60;163;SEC_102
2011;529;75 i +;91;65;156;SEC_529
2011;519;50-64;41;26;67;SEC_519
2011;204;35-49;80;87;167;SEC_204
2011;234;65-74;39;31;70;SEC_234
2011;624;65-74;82;104;186;SEC_624
2011;136;75 i +;63;35;98;SEC_136
2011;223;03-11;49;61;110;SEC_223
2011;427;50-64;71;56;127;SEC_427
2011;629;50-64;50;47;97;SEC_629
2011;431;75 i +;87;44;131;SEC_431
2011;217;03-11;25;30;55;SEC_217
2011;136;12-15;13;23;36;SEC_136
2011;110;25-34;88;87;175;SEC_110
2011;412;18-24;45;62;107;SEC_412
2011;427;18-24;28;36;64;SEC_427
2011;247;35-49;162;201;363;SEC_247
2011;613;18-24;35;38;73;SEC_613
2011;238;18-24;34;39;73;SEC_238
2011;401;50-64;114;92;206;SEC_401
2011;221;65-74;52;51;103;SEC_221
2011;406;12-15;34;25;59;SEC_406
2011;240;65-74;35;33;68;SEC_240
2011;210;16-17;7;3;10;SEC_210
2011;245;00-02;15;17;32;SEC_245
2011;608;75 i +;61;43;104;SEC_608
2011;316;25-34;151;193;344;SEC_316
2011;213;00-02;10;14;24;SEC_213
2011;308;12-15;38;50;88;SEC_308
2011;224;35-49;83;90;173;SEC_224
2011;409;18-24;23;34;57;SEC_409
2011;317;50-64;65;75;140;SEC_317
2011;229;25-34;74;75;149;SEC_229
2011;304;50-64;133;126;259;SEC_304
2011;107;75 i +;100;52;152;SEC_107
2011;247;03-11;70;67;137;SEC_247
2011;438;25-34;70;60;130;SEC_438
2011;525;50-64;64;71;135;SEC_525
2011;435;00-02;32;23;55;SEC_435
2011;212;12-15;25;29;54;SEC_212
2011;120;65-74;58;65;123;SEC_120
2011;441;50-64;238;222;460;SEC_441
2011;103;12-15;16;15;31;SEC_103
2011;435;16-17;7;11;18;SEC_435
2011;324;00-02;29;21;50;SEC_324
2011;212;35-49;189;187;376;SEC_212
2011;217;65-74;14;16;30;SEC_217
2011;617;00-02;12;20;32;SEC_617
2011;313;12-15;26;38;64;SEC_313
2011;630;18-24;31;28;59;SEC_630
2011;121;00-02;15;16;31;SEC_121
2011;131;25-34;91;126;217;SEC_131
2011;621;50-64;182;146;328;SEC_621
2011;601;18-24;38;51;89;SEC_601
2011;412;50-64;177;153;330;SEC_412
2011;427;16-17;11;13;24;SEC_427
2011;603;18-24;17;28;45;SEC_603
2011;312;03-11;62;71;133;SEC_312
2011;625;18-24;48;55;103;SEC_625
2011;322;75 i +;71;46;117;SEC_322
2011;231;25-34;120;126;246;SEC_231
2011;319;75 i +;52;30;82;SEC_319
2011;624;35-49;101;138;239;SEC_624
2011;106;65-74;61;87;148;SEC_106
2011;137;18-24;59;50;109;SEC_137
2011;509;75 i +;41;19;60;SEC_509
2011;318;35-49;99;86;185;SEC_318
2011;515;03-11;26;26;52;SEC_515
2011;130;25-34;65;42;107;SEC_130
2011;501;12-15;18;21;39;SEC_501
2011;610;18-24;29;38;67;SEC_610
2011;527;03-11;45;59;104;SEC_527
2011;131;03-11;42;63;105;SEC_131
2011;305;16-17;17;12;29;SEC_305
2011;211;35-49;169;195;364;SEC_211
2011;518;18-24;44;41;85;SEC_518
2011;434;25-34;52;38;90;SEC_434
2011;623;18-24;26;35;61;SEC_623
2011;506;25-34;97;120;217;SEC_506
2011;439;03-11;58;67;125;SEC_439
2011;215;12-15;18;15;33;SEC_215
2011;607;35-49;122;142;264;SEC_607
2011;245;18-24;50;48;98;SEC_245
2011;249;35-49;140;145;285;SEC_249
2011;213;35-49;122;111;233;SEC_213
2011;425;18-24;34;53;87;SEC_425
2011;607;12-15;13;17;30;SEC_607
2011;220;12-15;13;13;26;SEC_220
2011;538;25-34;80;111;191;SEC_538
2011;104;35-49;102;136;238;SEC_104
2011;243;16-17;13;11;24;SEC_243
2011;536;00-02;8;9;17;SEC_536
2011;604;25-34;38;72;110;SEC_604
2011;301;00-02;40;41;81;SEC_301
2011;227;16-17;4;7;11;SEC_227
2011;406;03-11;40;65;105;SEC_406
2011;403;50-64;111;88;199;SEC_403
2011;234;50-64;78;62;140;SEC_234
2011;532;65-74;76;72;148;SEC_532
2011;105;25-34;98;95;193;SEC_105
2011;107;65-74;98;97;195;SEC_107
2011;526;00-02;6;9;15;SEC_526
2011;630;16-17;2;5;7;SEC_630
2011;522;16-17;6;9;15;SEC_522
2011;433;16-17;16;7;23;SEC_433
2011;316;65-74;80;92;172;SEC_316
2011;425;35-49;117;118;235;SEC_425
2011;604;50-64;63;57;120;SEC_604
2011;622;03-11;25;36;61;SEC_622
2011;221;50-64;87;85;172;SEC_221
2011;619;18-24;34;38;72;SEC_619
2011;114;03-11;45;64;109;SEC_114
2011;316;50-64;392;343;735;SEC_316
2011;435;35-49;111;160;271;SEC_435
2011;138;18-24;25;31;56;SEC_138
2011;323;65-74;98;110;208;SEC_323
2011;212;75 i +;78;50;128;SEC_212
2011;521;65-74;81;94;175;SEC_521
2011;408;25-34;86;108;194;SEC_408
2011;103;00-02;4;12;16;SEC_103
2011;441;25-34;207;178;385;SEC_441
2011;238;12-15;14;18;32;SEC_238
2011;531;50-64;89;75;164;SEC_531
2011;502;65-74;87;87;174;SEC_502
2011;233;18-24;32;40;72;SEC_233
2011;418;50-64;100;93;193;SEC_418
2011;127;16-17;8;6;14;SEC_127
2011;608;00-02;8;9;17;SEC_608
2011;527;50-64;86;89;175;SEC_527
2011;209;03-11;28;39;67;SEC_209
2011;618;25-34;27;28;55;SEC_618
2011;135;50-64;161;135;296;SEC_135
2011;627;12-15;16;9;25;SEC_627
2011;131;75 i +;62;52;114;SEC_131
2011;507;25-34;66;68;134;SEC_507
2011;314;75 i +;86;51;137;SEC_314
2011;115;03-11;45;58;103;SEC_115
2011;408;03-11;43;37;80;SEC_408
2011;314;16-17;22;23;45;SEC_314
2011;601;25-34;86;102;188;SEC_601
2011;230;75 i +;55;22;77;SEC_230
2011;615;25-34;58;41;99;SEC_615
2011;622;25-34;53;56;109;SEC_622
2011;423;16-17;10;12;22;SEC_423
2011;133;35-49;107;108;215;SEC_133
2011;416;16-17;10;10;20;SEC_416
2011;628;18-24;31;33;64;SEC_628
2011;226;03-11;60;39;99;SEC_226
2011;441;00-02;20;27;47;SEC_441
2011;437;35-49;116;130;246;SEC_437
2011;249;03-11;42;42;84;SEC_249
2011;421;75 i +;93;66;159;SEC_421
2011;212;00-02;23;26;49;SEC_212
2011;433;25-34;127;147;274;SEC_433
2011;428;16-17;5;7;12;SEC_428
2011;249;00-02;14;19;33;SEC_249
2011;218;65-74;38;38;76;SEC_218
2011;224;03-11;32;28;60;SEC_224
2011;402;25-34;93;60;153;SEC_402
2011;136;50-64;113;103;216;SEC_136
2011;442;65-74;34;32;66;SEC_442
2011;626;12-15;20;20;40;SEC_626
2011;436;16-17;7;13;20;SEC_436
2011;401;12-15;21;31;52;SEC_401
2011;246;03-11;45;60;105;SEC_246
2011;241;35-49;114;111;225;SEC_241
2011;325;50-64;186;161;347;SEC_325
2011;112;12-15;19;31;50;SEC_112
2011;304;16-17;46;17;63;SEC_304
2011;518;25-34;81;93;174;SEC_518
2011;606;75 i +;84;56;140;SEC_606
2011;516;12-15;15;20;35;SEC_516
2011;518;16-17;11;13;24;SEC_518
2011;318;00-02;8;11;19;SEC_318
2011;227;25-34;60;58;118;SEC_227
2011;616;35-49;401;396;797;SEC_616
2011;506;35-49;187;180;367;SEC_506
2011;319;35-49;278;264;542;SEC_319
2011;606;25-34;98;95;193;SEC_606
2011;208;50-64;188;152;340;SEC_208
2011;523;75 i +;97;64;161;SEC_523
2011;122;00-02;16;21;37;SEC_122
2011;421;65-74;79;55;134;SEC_421
2011;538;03-11;54;48;102;SEC_538
2011;432;03-11;49;42;91;SEC_432
2011;419;00-02;12;23;35;SEC_419
2011;121;50-64;47;51;98;SEC_121
2011;430;16-17;13;12;25;SEC_430
2011;124;75 i +;45;39;84;SEC_124
2011;532;16-17;16;13;29;SEC_532
2011;241;00-02;11;10;21;SEC_241
2011;512;25-34;88;79;167;SEC_512
2011;218;35-49;92;94;186;SEC_218
2011;124;03-11;42;35;77;SEC_124
2011;402;12-15;19;10;29;SEC_402
2011;623;12-15;19;25;44;SEC_623
2011;238;16-17;3;9;12;SEC_238
2011;324;12-15;21;21;42;SEC_324
2011;512;00-02;16;10;26;SEC_512
2011;134;35-49;174;159;333;SEC_134
2011;128;00-02;17;23;40;SEC_128
2011;412;00-02;15;20;35;SEC_412
2011;632;25-34;51;65;116;SEC_632
2011;107;25-34;123;144;267;SEC_107
2011;509;25-34;76;89;165;SEC_509
2011;225;35-49;59;59;118;SEC_225
2011;106;25-34;140;156;296;SEC_106
2011;628;12-15;19;16;35;SEC_628
2011;538;12-15;19;24;43;SEC_538
2011;244;00-02;10;11;21;SEC_244
2011;421;00-02;13;23;36;SEC_421
2011;134;65-74;62;54;116;SEC_134
2011;440;25-34;73;57;130;SEC_440
2011;221;35-49;129;130;259;SEC_221
2011;401;18-24;49;55;104;SEC_401
2011;625;25-34;89;100;189;SEC_625
2011;611;25-34;129;118;247;SEC_611
2011;125;65-74;71;76;147;SEC_125
2011;428;65-74;17;12;29;SEC_428
2011;138;16-17;4;4;8;SEC_138
2011;317;35-49;144;170;314;SEC_317
2011;602;03-11;24;18;42;SEC_602
2011;112;50-64;168;165;333;SEC_112
2011;505;00-02;17;12;29;SEC_505
2011;243;65-74;75;58;133;SEC_243
2011;424;35-49;63;83;146;SEC_424
2011;528;12-15;26;22;48;SEC_528
2011;613;00-02;13;16;29;SEC_613
2011;306;35-49;180;202;382;SEC_306
2011;244;50-64;48;54;102;SEC_244
2011;308;65-74;96;84;180;SEC_308
2011;321;75 i +;114;74;188;SEC_321
2011;429;18-24;29;33;62;SEC_429
2011;513;16-17;3;3;6;SEC_513
2011;620;18-24;26;28;54;SEC_620
2011;620;16-17;3;4;7;SEC_620
2011;537;35-49;145;124;269;SEC_537
2011;603;16-17;4;6;10;SEC_603
2011;208;65-74;111;88;199;SEC_208
2011;205;65-74;49;36;85;SEC_205
2011;526;18-24;26;33;59;SEC_526
2011;113;18-24;63;68;131;SEC_113
2011;410;35-49;177;166;343;SEC_410
2011;111;50-64;101;60;161;SEC_111
2011;625;03-11;37;49;86;SEC_625
2011;120;35-49;229;204;433;SEC_120
2011;627;03-11;30;30;60;SEC_627
2011;507;18-24;33;35;68;SEC_507
2011;403;12-15;16;19;35;SEC_403
2011;228;16-17;6;8;14;SEC_228
2011;116;00-02;20;19;39;SEC_116
2011;133;16-17;4;4;8;SEC_133
2011;107;12-15;22;28;50;SEC_107
2011;609;25-34;60;63;123;SEC_609
2011;535;35-49;89;101;190;SEC_535
2011;502;00-02;31;27;58;SEC_502
2011;612;25-34;53;64;117;SEC_612
2011;632;12-15;18;19;37;SEC_632
2011;514;00-02;14;8;22;SEC_514
2011;323;75 i +;88;38;126;SEC_323
2011;136;35-49;143;166;309;SEC_136
2011;317;75 i +;60;22;82;SEC_317
2011;418;25-34;101;113;214;SEC_418
2011;436;25-34;98;125;223;SEC_436
2011;209;12-15;16;14;30;SEC_209
2011;601;50-64;117;108;225;SEC_601
2011;435;75 i +;90;41;131;SEC_435
2011;621;18-24;45;36;81;SEC_621
2011;418;12-15;23;34;57;SEC_418
2011;536;25-34;71;64;135;SEC_536
2011;617;12-15;13;22;35;SEC_617
2011;311;18-24;53;50;103;SEC_311
2011;118;03-11;77;65;142;SEC_118
2011;217;75 i +;44;24;68;SEC_217
2011;420;50-64;108;97;205;SEC_420
2011;515;16-17;7;6;13;SEC_515
2011;116;16-17;17;6;23;SEC_116
2011;207;25-34;75;81;156;SEC_207
2011;119;12-15;16;19;35;SEC_119
2011;431;35-49;198;230;428;SEC_431
2011;223;00-02;32;16;48;SEC_223
2011;207;35-49;94;95;189;SEC_207
2011;247;50-64;101;97;198;SEC_247
2011;121;35-49;109;124;233;SEC_121
2011;202;75 i +;47;29;76;SEC_202
2011;217;00-02;12;18;30;SEC_217
2011;226;00-02;19;19;38;SEC_226
2011;605;16-17;4;3;7;SEC_605
2011;223;35-49;159;153;312;SEC_223
2011;624;50-64;119;69;188;SEC_624
2011;511;18-24;22;30;52;SEC_511
2011;427;03-11;58;54;112;SEC_427
2011;304;75 i +;98;55;153;SEC_304
2011;206;03-11;39;34;73;SEC_206
2011;117;12-15;29;29;58;SEC_117
2011;245;12-15;25;19;44;SEC_245
2011;610;00-02;15;12;27;SEC_610
2011;139;50-64;85;92;177;SEC_139
2011;306;50-64;166;139;305;SEC_306
2011;303;50-64;123;104;227;SEC_303
2011;211;25-34;122;141;263;SEC_211
2011;503;25-34;61;67;128;SEC_503
2011;320;03-11;62;58;120;SEC_320
2011;531;25-34;79;80;159;SEC_531
2011;242;18-24;30;46;76;SEC_242
2011;128;75 i +;55;37;92;SEC_128
2011;533;50-64;56;61;117;SEC_533
2011;137;00-02;23;24;47;SEC_137
2011;113;75 i +;61;43;104;SEC_113
2011;507;75 i +;50;22;72;SEC_507
2011;412;12-15;24;17;41;SEC_412
2011;233;50-64;61;72;133;SEC_233
2011;310;03-11;36;43;79;SEC_310
2011;511;12-15;14;13;27;SEC_511
2011;522;50-64;72;59;131;SEC_522
2011;408;12-15;9;18;27;SEC_408
2011;301;18-24;76;82;158;SEC_301
2011;629;25-34;36;42;78;SEC_629
2011;415;25-34;99;100;199;SEC_415
2011;315;25-34;153;181;334;SEC_315
2011;310;16-17;8;6;14;SEC_310
2011;128;65-74;53;53;106;SEC_128
2011;601;35-49;141;177;318;SEC_601
2011;101;18-24;41;44;85;SEC_101
2011;109;35-49;122;122;244;SEC_109
2011;235;35-49;200;224;424;SEC_235
2011;631;35-49;120;126;246;SEC_631
2011;606;03-11;46;47;93;SEC_606
2011;407;00-02;19;15;34;SEC_407
2011;516;18-24;25;32;57;SEC_516
2011;311;35-49;181;205;386;SEC_311
2011;140;35-49;110;145;255;SEC_140
2011;508;65-74;30;21;51;SEC_508
2011;437;75 i +;49;36;85;SEC_437
2011;117;03-11;74;87;161;SEC_117
2011;238;25-34;72;87;159;SEC_238
2011;223;65-74;56;47;103;SEC_223
2011;303;65-74;133;113;246;SEC_303
2011;244;35-49;125;107;232;SEC_244
2011;608;25-34;46;51;97;SEC_608
2011;426;65-74;38;31;69;SEC_426
2011;239;03-11;45;54;99;SEC_239
2011;532;50-64;112;77;189;SEC_532
2011;403;65-74;90;74;164;SEC_403
2011;118;25-34;125;122;247;SEC_118
2011;411;18-24;35;24;59;SEC_411
2011;303;03-11;45;49;94;SEC_303
2011;513;50-64;55;53;108;SEC_513
2011;425;65-74;49;44;93;SEC_425
2011;512;35-49;113;112;225;SEC_512
2011;402;75 i +;60;49;109;SEC_402
2011;626;03-11;35;41;76;SEC_626
2011;438;03-11;25;40;65;SEC_438
2011;406;00-02;17;20;37;SEC_406
2011;428;18-24;34;22;56;SEC_428
2011;303;25-34;123;122;245;SEC_303
2011;311;16-17;11;15;26;SEC_311
2011;535;50-64;128;101;229;SEC_535
2011;630;75 i +;42;28;70;SEC_630
2011;631;03-11;35;47;82;SEC_631
2011;417;65-74;27;21;48;SEC_417
2011;137;03-11;72;66;138;SEC_137
2011;517;50-64;75;84;159;SEC_517
2011;530;35-49;194;201;395;SEC_530
2011;320;00-02;25;19;44;SEC_320
2011;617;35-49;109;122;231;SEC_617
2011;603;12-15;16;11;27;SEC_603
2011;324;25-34;95;112;207;SEC_324
2011;128;50-64;90;67;157;SEC_128
2011;612;35-49;107;138;245;SEC_612
2011;623;75 i +;65;40;105;SEC_623
2011;131;00-02;23;21;44;SEC_131
2011;511;65-74;38;22;60;SEC_511
2011;215;16-17;13;9;22;SEC_215
2011;418;03-11;58;48;106;SEC_418
2011;604;65-74;49;33;82;SEC_604
2011;116;75 i +;77;56;133;SEC_116
2011;523;16-17;11;13;24;SEC_523
2011;626;50-64;81;80;161;SEC_626
2011;201;00-02;16;22;38;SEC_201
2011;514;03-11;30;36;66;SEC_514
2011;317;12-15;28;28;56;SEC_317
2011;108;00-02;14;18;32;SEC_108
2011;125;12-15;20;32;52;SEC_125
2011;427;00-02;22;23;45;SEC_427
2011;307;50-64;199;153;352;SEC_307
2011;111;25-34;50;60;110;SEC_111
2011;309;50-64;97;70;167;SEC_309
2011;510;12-15;14;18;32;SEC_510
2011;242;75 i +;91;59;150;SEC_242
2011;431;25-34;147;180;327;SEC_431
2011;610;12-15;15;27;42;SEC_610
2011;612;65-74;117;90;207;SEC_612
2011;316;75 i +;83;31;114;SEC_316
2011;432;12-15;19;26;45;SEC_432
2011;315;03-11;74;79;153;SEC_315
2011;237;16-17;15;10;25;SEC_237
2011;122;65-74;75;58;133;SEC_122
2011;236;18-24;41;51;92;SEC_236
2011;601;16-17;15;14;29;SEC_601
2011;420;00-02;36;23;59;SEC_420
2011;136;25-34;111;95;206;SEC_136
2011;442;03-11;30;24;54;SEC_442
2011;431;65-74;70;45;115;SEC_431
2011;619;00-02;14;16;30;SEC_619
2011;418;16-17;16;17;33;SEC_418
2011;312;50-64;149;145;294;SEC_312
2011;503;35-49;83;60;143;SEC_503
2011;109;18-24;43;34;77;SEC_109
2011;507;16-17;5;8;13;SEC_507
2011;202;12-15;7;17;24;SEC_202
2011;503;16-17;3;10;13;SEC_503
2011;616;18-24;131;135;266;SEC_616
2011;608;18-24;22;27;49;SEC_608
2011;621;75 i +;49;26;75;SEC_621
2011;127;00-02;5;13;18;SEC_127
2011;305;03-11;70;54;124;SEC_305
2011;231;16-17;11;12;23;SEC_231
2011;402;50-64;61;70;131;SEC_402
2011;624;03-11;39;46;85;SEC_624
2011;121;75 i +;86;48;134;SEC_121
2011;621;00-02;18;13;31;SEC_621
2011;107;18-24;46;53;99;SEC_107
2011;234;00-02;12;20;32;SEC_234
2011;202;16-17;7;9;16;SEC_202
2011;324;65-74;41;35;76;SEC_324
2011;529;03-11;63;58;121;SEC_529
2011;528;35-49;185;143;328;SEC_528
2011;603;65-74;54;46;100;SEC_603
2011;510;18-24;31;38;69;SEC_510
2011;222;25-34;80;90;170;SEC_222
2011;510;16-17;9;14;23;SEC_510
2011;521;35-49;99;115;214;SEC_521
2011;417;18-24;44;22;66;SEC_417
2011;631;00-02;16;15;31;SEC_631
2011;305;50-64;190;171;361;SEC_305
2011;230;35-49;134;132;266;SEC_230
2011;509;03-11;42;41;83;SEC_509
2011;122;25-34;78;64;142;SEC_122
2011;610;35-49;135;152;287;SEC_610
2011;416;18-24;18;32;50;SEC_416
2011;502;35-49;181;216;397;SEC_502
2011;606;12-15;15;23;38;SEC_606
2011;517;16-17;8;9;17;SEC_517
2011;128;03-11;34;43;77;SEC_128
2011;319;16-17;11;11;22;SEC_319
2011;232;50-64;84;72;156;SEC_232
2011;504;00-02;11;20;31;SEC_504
2011;435;25-34;112;126;238;SEC_435
2011;616;00-02;52;57;109;SEC_616
2011;302;25-34;114;129;243;SEC_302
2011;507;03-11;30;44;74;SEC_507
2011;620;00-02;5;4;9;SEC_620
2011;612;00-02;11;16;27;SEC_612
2011;627;18-24;22;41;63;SEC_627
2011;112;35-49;194;158;352;SEC_112
2011;537;25-34;101;119;220;SEC_537
2011;520;25-34;53;63;116;SEC_520
2011;532;18-24;70;49;119;SEC_532
2011;246;12-15;28;27;55;SEC_246
2011;518;50-64;86;65;151;SEC_518
2011;629;12-15;5;9;14;SEC_629
2011;240;35-49;94;96;190;SEC_240
2011;611;12-15;23;33;56;SEC_611
2011;104;16-17;6;6;12;SEC_104
2011;216;75 i +;72;52;124;SEC_216
2011;404;35-49;153;175;328;SEC_404
2011;424;18-24;19;26;45;SEC_424
2011;317;65-74;36;35;71;SEC_317
2011;308;75 i +;98;61;159;SEC_308
2011;625;50-64;196;178;374;SEC_625
2011;225;16-17;1;3;4;SEC_225
2011;126;25-34;79;64;143;SEC_126
2011;403;00-02;18;20;38;SEC_403
2011;201;50-64;73;59;132;SEC_201
2011;320;65-74;64;62;126;SEC_320
2011;239;12-15;20;19;39;SEC_239
2011;411;25-34;79;71;150;SEC_411
2011;125;75 i +;56;44;100;SEC_125
2011;315;12-15;33;35;68;SEC_315
2011;602;16-17;5;5;10;SEC_602
2011;408;75 i +;42;39;81;SEC_408
2011;228;75 i +;43;35;78;SEC_228
2011;622;18-24;24;29;53;SEC_622
2011;430;35-49;134;162;296;SEC_430
2011;427;35-49;107;165;272;SEC_427
2011;315;18-24;63;64;127;SEC_315
2011;128;18-24;29;30;59;SEC_128
2011;424;12-15;6;14;20;SEC_424
2011;231;65-74;55;38;93;SEC_231
2011;248;16-17;18;14;32;SEC_248
2011;419;35-49;116;144;260;SEC_419
2011;439;25-34;98;114;212;SEC_439
2011;520;35-49;102;94;196;SEC_520
2011;626;16-17;7;6;13;SEC_626
2011;302;65-74;74;86;160;SEC_302
2011;422;75 i +;83;50;133;SEC_422
2011;501;50-64;145;122;267;SEC_501
2011;130;03-11;50;42;92;SEC_130
2011;440;18-24;22;31;53;SEC_440
2011;206;50-64;73;74;147;SEC_206
2011;405;03-11;22;30;52;SEC_405
2011;620;03-11;17;18;35;SEC_620
2011;423;35-49;115;138;253;SEC_423
2011;528;03-11;56;57;113;SEC_528
2011;406;50-64;119;113;232;SEC_406
2011;417;25-34;77;76;153;SEC_417
2011;419;16-17;9;15;24;SEC_419
2011;533;00-02;19;25;44;SEC_533
2011;402;18-24;32;29;61;SEC_402
2011;248;65-74;39;34;73;SEC_248
2011;435;12-15;14;25;39;SEC_435
2011;214;75 i +;34;31;65;SEC_214
2011;132;16-17;19;20;39;SEC_132
2011;325;65-74;114;97;211;SEC_325
2011;604;75 i +;38;22;60;SEC_604
2011;412;35-49;165;208;373;SEC_412
2011;516;16-17;5;11;16;SEC_516
2011;237;03-11;62;71;133;SEC_237
2011;307;25-34;115;107;222;SEC_307
2011;103;35-49;96;102;198;SEC_103
2011;119;25-34;86;83;169;SEC_119
2011;522;03-11;46;35;81;SEC_522
2011;240;18-24;33;34;67;SEC_240
2011;115;12-15;24;19;43;SEC_115
2011;204;16-17;6;9;15;SEC_204
2011;416;35-49;105;100;205;SEC_416
2011;413;12-15;7;10;17;SEC_413
2011;102;65-74;119;120;239;SEC_102
2011;123;18-24;48;44;92;SEC_123
2011;537;50-64;115;96;211;SEC_537
2011;618;12-15;10;17;27;SEC_618
2011;232;25-34;93;90;183;SEC_232
2011;314;35-49;280;296;576;SEC_314
2011;628;00-02;13;13;26;SEC_628
2011;127;03-11;36;41;77;SEC_127
2011;524;00-02;19;25;44;SEC_524
2011;311;75 i +;100;55;155;SEC_311
2011;248;00-02;16;27;43;SEC_248
2011;307;00-02;14;12;26;SEC_307
2011;417;35-49;87;91;178;SEC_417
2011;613;50-64;92;64;156;SEC_613
2011;114;75 i +;85;54;139;SEC_114
2011;106;00-02;17;28;45;SEC_106
2011;603;25-34;45;50;95;SEC_603
2011;426;18-24;40;42;82;SEC_426
2011;436;65-74;31;23;54;SEC_436
2011;624;25-34;61;86;147;SEC_624
2011;411;65-74;66;57;123;SEC_411
2011;507;65-74;45;47;92;SEC_507
2011;215;35-49;135;147;282;SEC_215
2011;108;18-24;39;43;82;SEC_108
2011;439;65-74;60;34;94;SEC_439
2011;528;16-17;15;17;32;SEC_528
2011;207;75 i +;60;20;80;SEC_207
2011;136;00-02;26;20;46;SEC_136
2011;502;50-64;139;116;255;SEC_502
2011;134;12-15;25;17;42;SEC_134
2011;631;65-74;92;93;185;SEC_631
2011;519;35-49;72;106;178;SEC_519
2011;609;50-64;75;46;121;SEC_609
2011;318;12-15;14;16;30;SEC_318
2011;108;12-15;28;28;56;SEC_108
2011;214;25-34;94;106;200;SEC_214
2011;532;25-34;138;144;282;SEC_532
2011;109;50-64;122;113;235;SEC_109
2011;228;65-74;46;28;74;SEC_228
2011;225;50-64;49;38;87;SEC_225
2011;424;03-11;20;26;46;SEC_424
2011;526;75 i +;37;19;56;SEC_526
2011;425;00-02;18;20;38;SEC_425
2011;122;03-11;48;39;87;SEC_122
2011;605;00-02;9;12;21;SEC_605
2011;240;25-34;74;85;159;SEC_240
2011;620;50-64;62;58;120;SEC_620
2011;205;25-34;88;70;158;SEC_205
2011;132;25-34;147;169;316;SEC_132
2011;115;35-49;155;156;311;SEC_115
2011;234;75 i +;76;41;117;SEC_234
2011;614;25-34;47;73;120;SEC_614
2011;304;03-11;115;104;219;SEC_304
2011;424;16-17;5;4;9;SEC_424
2011;413;35-49;68;86;154;SEC_413
2011;109;25-34;102;85;187;SEC_109
2011;437;03-11;45;37;82;SEC_437
2011;108;16-17;11;9;20;SEC_108
2011;614;12-15;11;12;23;SEC_614
2011;124;18-24;28;30;58;SEC_124
2011;627;16-17;3;6;9;SEC_627
2011;521;25-34;57;51;108;SEC_521
2011;616;50-64;279;263;542;SEC_616
2011;207;18-24;23;25;48;SEC_207
2011;418;75 i +;71;51;122;SEC_418
2011;413;65-74;20;23;43;SEC_413
2011;404;03-11;52;61;113;SEC_404
2011;410;03-11;59;80;139;SEC_410
2011;506;16-17;13;14;27;SEC_506
2011;322;50-64;107;93;200;SEC_322
2011;441;35-49;194;219;413;SEC_441
2011;524;65-74;57;43;100;SEC_524
2011;534;00-02;8;14;22;SEC_534
2011;243;12-15;15;33;48;SEC_243
2011;405;00-02;14;12;26;SEC_405
2011;244;18-24;28;25;53;SEC_244
2011;137;75 i +;52;36;88;SEC_137
2011;123;12-15;14;28;42;SEC_123
2011;135;12-15;27;22;49;SEC_135
2011;611;00-02;16;29;45;SEC_611
2011;238;35-49;121;133;254;SEC_238
2011;618;50-64;61;40;101;SEC_618
2011;535;03-11;31;40;71;SEC_535
2011;215;50-64;85;70;155;SEC_215
2011;414;65-74;43;43;86;SEC_414
2011;313;03-11;93;91;184;SEC_313
2011;524;18-24;53;62;115;SEC_524
2011;402;35-49;106;107;213;SEC_402
2011;119;65-74;87;80;167;SEC_119
2011;416;50-64;57;55;112;SEC_416
2011;248;75 i +;72;50;122;SEC_248
2011;506;00-02;12;14;26;SEC_506
2011;121;16-17;9;9;18;SEC_121
2011;440;12-15;14;18;32;SEC_440
2011;117;25-34;150;159;309;SEC_117
2011;220;16-17;8;8;16;SEC_220
2011;442;00-02;8;9;17;SEC_442
2011;103;18-24;27;13;40;SEC_103
2011;246;16-17;19;9;28;SEC_246
2011;237;50-64;101;101;202;SEC_237
2011;140;65-74;55;56;111;SEC_140
2011;205;75 i +;87;52;139;SEC_205
2011;405;12-15;17;12;29;SEC_405
2011;435;18-24;58;46;104;SEC_435
2011;229;12-15;25;17;42;SEC_229
2011;218;25-34;50;82;132;SEC_218
2011;502;16-17;12;16;28;SEC_502
2011;401;25-34;96;105;201;SEC_401
2011;139;25-34;72;87;159;SEC_139
2011;617;25-34;60;70;130;SEC_617
2011;206;65-74;48;33;81;SEC_206
2011;104;12-15;20;11;31;SEC_104
2011;535;16-17;10;12;22;SEC_535
2011;242;50-64;96;92;188;SEC_242
2011;607;00-02;8;11;19;SEC_607
2011;203;03-11;28;45;73;SEC_203
2011;237;18-24;63;53;116;SEC_237
2011;629;00-02;9;7;16;SEC_629
2011;221;00-02;20;15;35;SEC_221
2011;624;12-15;12;13;25;SEC_624
2011;426;50-64;80;69;149;SEC_426
2011;102;18-24;46;47;93;SEC_102
2011;613;25-34;82;89;171;SEC_613
2011;433;18-24;51;57;108;SEC_433
2011;531;65-74;42;39;81;SEC_531
2011;111;12-15;13;12;25;SEC_111
2011;308;00-02;23;27;50;SEC_308
2011;322;03-11;68;70;138;SEC_322
2011;612;16-17;3;9;12;SEC_612
2011;422;25-34;84;107;191;SEC_422
2011;629;75 i +;29;23;52;SEC_629
2011;248;18-24;56;47;103;SEC_248
2011;620;25-34;29;28;57;SEC_620
2011;138;03-11;25;27;52;SEC_138
2011;505;50-64;128;83;211;SEC_505
2011;306;25-34;128;134;262;SEC_306
2011;513;18-24;23;21;44;SEC_513
2011;442;25-34;45;54;99;SEC_442
2011;240;03-11;37;22;59;SEC_240
2011;302;18-24;52;36;88;SEC_302
2011;537;18-24;64;48;112;SEC_537
2011;319;50-64;149;142;291;SEC_319
2011;433;12-15;16;23;39;SEC_433
2011;418;35-49;161;175;336;SEC_418
2011;621;35-49;160;176;336;SEC_621
2011;224;75 i +;36;23;59;SEC_224
2011;402;03-11;28;43;71;SEC_402
2011;606;16-17;11;12;23;SEC_606
2011;206;35-49;121;123;244;SEC_206
2011;607;03-11;46;31;77;SEC_607
2011;617;65-74;59;43;102;SEC_617
2011;248;35-49;192;178;370;SEC_248
2011;129;12-15;19;25;44;SEC_129
2011;628;16-17;9;5;14;SEC_628
2011;536;16-17;6;10;16;SEC_536
2011;424;00-02;10;11;21;SEC_424
2011;314;00-02;35;37;72;SEC_314
2011;602;35-49;82;83;165;SEC_602
2011;518;75 i +;79;54;133;SEC_518
2011;609;18-24;21;21;42;SEC_609
2011;415;50-64;49;47;96;SEC_415
2011;428;75 i +;34;23;57;SEC_428
2011;523;18-24;51;52;103;SEC_523
2011;322;35-49;179;158;337;SEC_322
2011;116;18-24;47;42;89;SEC_116
2011;411;00-02;12;8;20;SEC_411
2011;630;12-15;6;17;23;SEC_630
2011;622;16-17;10;11;21;SEC_622
2011;208;00-02;15;11;26;SEC_208
2011;308;50-64;219;200;419;SEC_308
2011;208;12-15;26;25;51;SEC_208
2011;122;50-64;63;50;113;SEC_122
2011;138;00-02;10;10;20;SEC_138
2011;517;18-24;61;63;124;SEC_517
2011;219;65-74;58;47;105;SEC_219
2011;110;00-02;20;16;36;SEC_110
2011;534;75 i +;60;48;108;SEC_534
2011;224;65-74;15;11;26;SEC_224
2011;511;16-17;9;11;20;SEC_511
2011;211;16-17;12;16;28;SEC_211
2011;411;12-15;14;9;23;SEC_411
2011;312;75 i +;75;46;121;SEC_312
2011;522;35-49;104;109;213;SEC_522
2011;311;00-02;25;19;44;SEC_311
2011;403;25-34;100;92;192;SEC_403
2011;129;35-49;144;154;298;SEC_129
2011;111;35-49;96;96;192;SEC_111
2011;438;12-15;16;18;34;SEC_438
2011;408;65-74;52;27;79;SEC_408
2011;432;18-24;48;52;100;SEC_432
2011;301;35-49;338;342;680;SEC_301
2011;101;25-34;119;89;208;SEC_101
2011;507;50-64;89;73;162;SEC_507
2011;226;12-15;7;12;19;SEC_226
2011;247;12-15;15;25;40;SEC_247
2011;117;18-24;55;63;118;SEC_117
2011;617;18-24;32;26;58;SEC_617
2011;526;65-74;28;30;58;SEC_526
2011;102;25-34;84;89;173;SEC_102
2011;310;75 i +;49;24;73;SEC_310
2011;609;00-02;14;14;28;SEC_609
2011;513;00-02;17;8;25;SEC_513
2011;324;75 i +;50;25;75;SEC_324
2011;319;12-15;28;33;61;SEC_319
2011;505;12-15;8;9;17;SEC_505
2011;320;35-49;158;152;310;SEC_320
2011;138;25-34;62;62;124;SEC_138
2011;612;12-15;9;24;33;SEC_612
2011;615;12-15;12;16;28;SEC_615
2011;530;50-64;94;96;190;SEC_530
2011;316;12-15;25;31;56;SEC_316
2011;208;35-49;173;160;333;SEC_208
2011;231;18-24;42;40;82;SEC_231
2011;442;50-64;44;47;91;SEC_442
2011;134;25-34;104;110;214;SEC_134
2011;133;25-34;57;69;126;SEC_133
2011;140;50-64;87;76;163;SEC_140
2011;519;65-74;29;18;47;SEC_519
2011;115;25-34;103;103;206;SEC_115
2011;436;35-49;125;153;278;SEC_436
2011;118;65-74;70;80;150;SEC_118
2011;220;18-24;35;36;71;SEC_220
2011;230;25-34;110;107;217;SEC_230
2011;206;00-02;15;19;34;SEC_206
2011;239;00-02;11;18;29;SEC_239
2011;415;18-24;34;33;67;SEC_415
2011;605;03-11;26;26;52;SEC_605
2011;307;75 i +;82;62;144;SEC_307
2011;235;12-15;29;34;63;SEC_235
2011;528;75 i +;67;45;112;SEC_528
2011;414;16-17;9;9;18;SEC_414
2011;230;00-02;14;18;32;SEC_230
2011;615;65-74;86;89;175;SEC_615
2011;242;35-49;122;143;265;SEC_242
2011;614;03-11;46;36;82;SEC_614
2011;109;12-15;22;19;41;SEC_109
2011;618;35-49;77;76;153;SEC_618
2011;129;16-17;12;9;21;SEC_129
2011;309;18-24;34;31;65;SEC_309
2011;137;50-64;152;128;280;SEC_137
2011;201;35-49;136;147;283;SEC_201
2011;304;35-49;300;306;606;SEC_304
2011;425;12-15;9;15;24;SEC_425
2011;237;12-15;28;25;53;SEC_237
2011;632;65-74;60;41;101;SEC_632
2011;109;16-17;7;6;13;SEC_109
2011;239;16-17;14;8;22;SEC_239
2011;216;18-24;41;47;88;SEC_216
2011;524;50-64;95;88;183;SEC_524
2011;503;18-24;28;29;57;SEC_503
2011;215;03-11;35;46;81;SEC_215
2011;311;65-74;61;59;120;SEC_311
2011;103;16-17;2;3;5;SEC_103
2011;233;25-34;106;103;209;SEC_233
2011;106;16-17;10;10;20;SEC_106
2011;123;00-02;22;14;36;SEC_123
2011;232;65-74;53;51;104;SEC_232
2011;415;75 i +;34;26;60;SEC_415
2011;224;25-34;60;57;117;SEC_224
2011;609;16-17;6;9;15;SEC_609
2011;225;03-11;14;22;36;SEC_225
2011;405;50-64;45;63;108;SEC_405
2011;323;50-64;377;345;722;SEC_323
2011;631;18-24;31;31;62;SEC_631
2011;412;03-11;63;49;112;SEC_412
2011;403;35-49;110;139;249;SEC_403
2011;311;12-15;27;25;52;SEC_311
2011;410;65-74;111;85;196;SEC_410
2011;504;12-15;13;13;26;SEC_504
2011;614;35-49;103;109;212;SEC_614
2011;531;03-11;33;36;69;SEC_531
2011;530;00-02;22;28;50;SEC_530
2011;315;35-49;228;248;476;SEC_315
2011;225;00-02;7;8;15;SEC_225
2011;129;18-24;43;38;81;SEC_129
2011;412;65-74;103;84;187;SEC_412
2011;235;50-64;93;89;182;SEC_235
2011;505;16-17;10;8;18;SEC_505
2011;520;00-02;12;8;20;SEC_520
2011;532;35-49;167;178;345;SEC_532
2011;410;25-34;121;121;242;SEC_410
2011;501;03-11;40;51;91;SEC_501
2011;139;65-74;48;37;85;SEC_139
2011;314;65-74;92;86;178;SEC_314
2011;619;35-49;122;137;259;SEC_619
2011;104;75 i +;90;43;133;SEC_104
2011;610;03-11;42;52;94;SEC_610
2011;120;16-17;20;17;37;SEC_120
2011;429;03-11;24;20;44;SEC_429
2011;307;12-15;15;18;33;SEC_307
2011;244;25-34;58;62;120;SEC_244
2011;318;25-34;54;47;101;SEC_318
2011;437;65-74;51;27;78;SEC_437
2011;513;25-34;47;54;101;SEC_513
2011;413;16-17;15;7;22;SEC_413
2011;627;65-74;53;65;118;SEC_627
2011;233;75 i +;55;37;92;SEC_233
2011;246;18-24;45;42;87;SEC_246
2011;609;35-49;106;101;207;SEC_609
2011;517;25-34;100;155;255;SEC_517
2011;105;12-15;8;12;20;SEC_105
2011;140;00-02;15;14;29;SEC_140
2011;220;25-34;75;92;167;SEC_220
2011;514;50-64;51;52;103;SEC_514
2011;402;16-17;5;4;9;SEC_402
2011;136;03-11;58;50;108;SEC_136
2011;306;16-17;23;16;39;SEC_306
2011;315;16-17;9;7;16;SEC_315
2011;401;00-02;11;27;38;SEC_401
2011;116;65-74;101;94;195;SEC_116
2011;606;35-49;133;150;283;SEC_606
2011;618;75 i +;25;18;43;SEC_618
2011;109;65-74;52;49;101;SEC_109
2011;626;75 i +;63;44;107;SEC_626
2011;227;18-24;17;11;28;SEC_227
2011;628;50-64;103;76;179;SEC_628
2011;221;12-15;17;16;33;SEC_221
2011;135;65-74;81;80;161;SEC_135
2011;438;50-64;66;65;131;SEC_438
2011;405;16-17;4;8;12;SEC_405
2011;407;16-17;4;6;10;SEC_407
2011;105;65-74;44;48;92;SEC_105
2011;510;75 i +;72;39;111;SEC_510
2011;401;65-74;51;54;105;SEC_401
2011;614;18-24;26;37;63;SEC_614
2011;411;50-64;90;73;163;SEC_411
2011;233;65-74;52;24;76;SEC_233
2011;236;50-64;91;80;171;SEC_236
2011;104;50-64;78;62;140;SEC_104
2011;325;35-49;204;168;372;SEC_325
2011;108;25-34;105;105;210;SEC_108
2011;127;35-49;102;113;215;SEC_127
2011;536;65-74;49;40;89;SEC_536
2011;619;50-64;144;118;262;SEC_619
2011;418;00-02;23;13;36;SEC_418
2011;632;16-17;10;11;21;SEC_632
2011;213;50-64;85;79;164;SEC_213
2011;138;12-15;20;13;33;SEC_138
2011;403;03-11;43;35;78;SEC_403
2011;523;65-74;84;69;153;SEC_523
2011;425;25-34;69;107;176;SEC_425
2011;325;25-34;109;140;249;SEC_325
2011;125;50-64;159;151;310;SEC_125
2011;536;12-15;12;15;27;SEC_536
2011;106;12-15;19;25;44;SEC_106
2011;521;12-15;14;17;31;SEC_521
2011;538;00-02;23;14;37;SEC_538
2011;234;25-34;95;93;188;SEC_234
2011;503;75 i +;41;22;63;SEC_503
2011;211;65-74;48;37;85;SEC_211
2011;422;12-15;20;14;34;SEC_422
2011;205;35-49;116;112;228;SEC_205
2011;414;25-34;78;86;164;SEC_414
2011;604;12-15;11;10;21;SEC_604
2011;426;03-11;51;55;106;SEC_426
2011;324;50-64;74;67;141;SEC_324
2011;136;18-24;40;38;78;SEC_136
2011;611;03-11;90;91;181;SEC_611
2011;428;00-02;18;11;29;SEC_428
2011;518;00-02;10;12;22;SEC_518
2011;126;03-11;50;48;98;SEC_126
2011;520;75 i +;57;42;99;SEC_520
2011;613;75 i +;76;46;122;SEC_613
2011;409;50-64;52;54;106;SEC_409
2011;427;75 i +;64;35;99;SEC_427
2011;221;25-34;79;93;172;SEC_221
2011;310;35-49;111;117;228;SEC_310
2011;103;75 i +;45;34;79;SEC_103
2011;410;16-17;8;12;20;SEC_410
2011;320;12-15;17;19;36;SEC_320
2011;129;25-34;87;83;170;SEC_129
2011;626;18-24;27;20;47;SEC_626
2011;414;50-64;65;55;120;SEC_414
2011;505;25-34;72;75;147;SEC_505
2011;106;50-64;273;214;487;SEC_106
2011;111;18-24;36;17;53;SEC_111
2011;426;75 i +;58;34;92;SEC_426
2011;613;03-11;47;57;104;SEC_613
2011;235;03-11;70;77;147;SEC_235
2011;214;18-24;41;45;86;SEC_214
2011;241;65-74;30;26;56;SEC_241
2011;235;75 i +;88;59;147;SEC_235
2011;533;65-74;51;26;77;SEC_533
2011;118;16-17;11;24;35;SEC_118
2011;319;18-24;44;58;102;SEC_319
2011;521;16-17;5;5;10;SEC_521
2011;126;18-24;26;24;50;SEC_126
2011;234;16-17;9;7;16;SEC_234
2011;516;00-02;12;22;34;SEC_516
2011;525;35-49;113;129;242;SEC_525
2011;506;50-64;234;181;415;SEC_506
2011;512;65-74;59;44;103;SEC_512
2011;325;12-15;33;33;66;SEC_325
2011;618;16-17;4;6;10;SEC_618
2011;242;25-34;90;101;191;SEC_242
2011;216;00-02;19;19;38;SEC_216
2011;138;65-74;53;36;89;SEC_138
2011;505;35-49;135;134;269;SEC_505
2011;101;35-49;276;297;573;SEC_101
2011;429;75 i +;53;27;80;SEC_429
2011;210;75 i +;111;45;156;SEC_210
2011;416;25-34;49;59;108;SEC_416
2011;527;18-24;45;44;89;SEC_527
2011;325;18-24;54;60;114;SEC_325
2011;133;75 i +;64;33;97;SEC_133
2011;408;35-49;117;111;228;SEC_408
2011;604;18-24;24;40;64;SEC_604
2011;521;18-24;25;28;53;SEC_521
2011;401;16-17;10;9;19;SEC_401
2011;406;25-34;125;118;243;SEC_406
2011;513;75 i +;56;34;90;SEC_513
2011;419;50-64;48;52;100;SEC_419
2011;232;12-15;18;21;39;SEC_232
2011;227;65-74;31;34;65;SEC_227
2011;318;18-24;39;43;82;SEC_318
2011;302;03-11;47;38;85;SEC_302
2011;216;12-15;21;14;35;SEC_216
2011;202;03-11;38;39;77;SEC_202
2011;111;16-17;4;8;12;SEC_111
2011;215;18-24;43;39;82;SEC_215
2011;247;75 i +;77;45;122;SEC_247
2011;121;03-11;24;41;65;SEC_121
2011;240;16-17;5;8;13;SEC_240
2011;211;18-24;57;57;114;SEC_211
2011;224;00-02;14;14;28;SEC_224
2011;102;35-49;181;185;366;SEC_102
2011;140;75 i +;63;44;107;SEC_140
2011;315;00-02;34;37;71;SEC_315
2011;119;75 i +;84;47;131;SEC_119
2011;505;75 i +;72;53;125;SEC_505
2011;304;18-24;81;78;159;SEC_304
2011;305;65-74;55;60;115;SEC_305
2011;413;25-34;61;55;116;SEC_413
2011;523;35-49;185;174;359;SEC_523
2011;524;16-17;12;12;24;SEC_524
2011;201;75 i +;62;40;102;SEC_201
2011;110;16-17;8;10;18;SEC_110
2011;241;03-11;34;36;70;SEC_241
2011;210;00-02;9;11;20;SEC_210
2011;506;18-24;61;79;140;SEC_506
2011;204;25-34;47;53;100;SEC_204
2011;522;18-24;30;32;62;SEC_522
2011;222;65-74;37;37;74;SEC_222
2011;128;35-49;131;143;274;SEC_128
2011;434;65-74;22;15;37;SEC_434
2011;514;35-49;94;121;215;SEC_514
2011;113;03-11;54;79;133;SEC_113
2011;406;75 i +;83;65;148;SEC_406
2011;526;03-11;20;28;48;SEC_526
2011;405;25-34;49;62;111;SEC_405
2011;520;16-17;10;6;16;SEC_520
2011;125;03-11;83;83;166;SEC_125
2011;220;00-02;14;13;27;SEC_220
2011;502;75 i +;127;68;195;SEC_502
2011;120;75 i +;65;27;92;SEC_120
2011;520;50-64;76;56;132;SEC_520
2011;114;18-24;39;30;69;SEC_114
2011;430;18-24;35;45;80;SEC_430
2011;442;12-15;13;21;34;SEC_442
2011;229;35-49;102;111;213;SEC_229
2011;203;50-64;71;54;125;SEC_203
2011;610;25-34;62;64;126;SEC_610
2011;624;00-02;16;12;28;SEC_624
2011;126;35-49;109;113;222;SEC_126
2011;410;18-24;60;50;110;SEC_410
2011;232;75 i +;79;46;125;SEC_232
2011;618;18-24;14;21;35;SEC_618
2011;427;12-15;15;19;34;SEC_427
2011;305;18-24;73;71;144;SEC_305
2011;521;03-11;29;41;70;SEC_521
2011;104;18-24;26;22;48;SEC_104
2011;114;12-15;36;20;56;SEC_114
2011;220;03-11;53;39;92;SEC_220
2011;320;50-64;86;84;170;SEC_320
2011;317;18-24;46;46;92;SEC_317
2011;323;03-11;137;141;278;SEC_323
2011;132;18-24;69;82;151;SEC_132
2011;134;50-64;129;120;249;SEC_134
2011;227;35-49;85;84;169;SEC_227
2011;321;50-64;300;269;569;SEC_321
2011;412;25-34;126;140;266;SEC_412
2011;404;00-02;26;28;54;SEC_404
2011;525;18-24;41;39;80;SEC_525
2011;528;25-34;111;113;224;SEC_528
2011;428;25-34;74;78;152;SEC_428
2011;632;75 i +;47;34;81;SEC_632
2011;510;50-64;83;72;155;SEC_510
2011;423;50-64;70;68;138;SEC_423
2011;113;65-74;62;68;130;SEC_113
2011;207;16-17;6;5;11;SEC_207
2011;503;00-02;5;10;15;SEC_503
2011;429;12-15;11;14;25;SEC_429
2011;610;75 i +;63;44;107;SEC_610
2011;310;12-15;12;12;24;SEC_310
2011;125;35-49;214;225;439;SEC_125
2011;510;00-02;14;14;28;SEC_510
2011;110;65-74;78;82;160;SEC_110
2011;624;16-17;5;9;14;SEC_624
2011;536;50-64;72;61;133;SEC_536
2011;306;75 i +;100;71;171;SEC_306
2011;221;16-17;11;15;26;SEC_221
2011;243;50-64;123;111;234;SEC_243
2011;404;18-24;48;62;110;SEC_404
2011;224;16-17;3;5;8;SEC_224
2011;628;25-34;57;68;125;SEC_628
2011;426;00-02;11;17;28;SEC_426
2011;423;75 i +;81;50;131;SEC_423
2011;404;25-34;104;84;188;SEC_404
2011;212;25-34;161;163;324;SEC_212
2011;426;25-34;102;106;208;SEC_426
2011;409;16-17;4;6;10;SEC_409
2011;518;35-49;134;129;263;SEC_518
2011;217;12-15;18;13;31;SEC_217
2011;309;03-11;45;56;101;SEC_309
2011;410;12-15;23;32;55;SEC_410
2011;421;50-64;77;79;156;SEC_421
2011;249;16-17;9;9;18;SEC_249
2011;127;50-64;76;71;147;SEC_127
2011;307;35-49;130;116;246;SEC_307
2011;112;65-74;76;54;130;SEC_112
2011;431;00-02;31;22;53;SEC_431
2011;505;65-74;126;140;266;SEC_505
2011;105;35-49;141;127;268;SEC_105
2011;317;00-02;17;25;42;SEC_317
2011;121;25-34;80;55;135;SEC_121
2011;133;18-24;22;27;49;SEC_133
2011;527;25-34;123;109;232;SEC_527
2011;231;75 i +;84;51;135;SEC_231
2011;504;35-49;117;121;238;SEC_504
2011;517;03-11;59;64;123;SEC_517
2011;216;25-34;105;102;207;SEC_216
2011;217;50-64;44;60;104;SEC_217
2011;512;75 i +;49;35;84;SEC_512
2011;441;03-11;78;78;156;SEC_441
2011;110;12-15;9;14;23;SEC_110
2011;515;25-34;50;65;115;SEC_515
2011;125;16-17;9;14;23;SEC_125
2011;107;16-17;4;11;15;SEC_107
2011;405;18-24;29;21;50;SEC_405
2011;422;65-74;51;35;86;SEC_422
2011;118;18-24;68;59;127;SEC_118
2011;209;35-49;123;125;248;SEC_209
2011;227;12-15;16;14;30;SEC_227
2011;623;25-34;90;105;195;SEC_623
2011;125;00-02;24;30;54;SEC_125
2011;436;18-24;34;43;77;SEC_436
2011;531;00-02;12;12;24;SEC_531
2011;429;50-64;69;68;137;SEC_429
2011;235;16-17;10;11;21;SEC_235
2011;621;65-74;81;100;181;SEC_621
2011;601;65-74;117;94;211;SEC_601
2011;126;16-17;6;6;12;SEC_126
2011;529;18-24;52;60;112;SEC_529
2011;101;65-74;56;49;105;SEC_101
2011;103;50-64;63;59;122;SEC_103
2011;223;50-64;95;94;189;SEC_223
2011;504;18-24;21;31;52;SEC_504
2011;212;65-74;67;47;114;SEC_212
2011;132;35-49;218;266;484;SEC_132
2011;632;35-49;101;113;214;SEC_632
2011;508;35-49;75;91;166;SEC_508
2011;213;65-74;45;43;88;SEC_213
2011;103;65-74;42;27;69;SEC_103
2011;416;03-11;49;42;91;SEC_416
2011;320;25-34;57;70;127;SEC_320
2011;309;35-49;138;147;285;SEC_309
2011;511;03-11;32;31;63;SEC_511
2011;323;00-02;36;50;86;SEC_323
2011;243;00-02;19;25;44;SEC_243
2011;312;65-74;121;104;225;SEC_312
2011;211;75 i +;96;44;140;SEC_211
2011;408;00-02;20;11;31;SEC_408
2011;526;35-49;86;86;172;SEC_526
2011;409;75 i +;32;22;54;SEC_409
2011;201;25-34;127;108;235;SEC_201
2011;509;12-15;17;22;39;SEC_509
2011;421;35-49;147;172;319;SEC_421
2011;214;00-02;15;11;26;SEC_214
2011;611;50-64;110;103;213;SEC_611
2011;534;16-17;4;4;8;SEC_534
2011;125;25-34;120;139;259;SEC_125
2011;310;50-64;90;94;184;SEC_310
2011;407;65-74;52;34;86;SEC_407
2011;430;03-11;48;52;100;SEC_430
2011;323;18-24;105;92;197;SEC_323
2011;226;75 i +;85;49;134;SEC_226
2011;112;00-02;15;14;29;SEC_112
2011;419;12-15;20;24;44;SEC_419
2011;201;16-17;7;7;14;SEC_201
2011;421;25-34;100;103;203;SEC_421
2011;221;18-24;52;39;91;SEC_221
2011;225;65-74;31;18;49;SEC_225
2011;515;00-02;4;13;17;SEC_515
2011;113;00-02;30;41;71;SEC_113
2011;245;25-34;89;99;188;SEC_245
2011;223;16-17;15;10;25;SEC_223
2011;623;16-17;8;18;26;SEC_623
2011;122;35-49;105;107;212;SEC_122
2011;213;18-24;33;39;72;SEC_213
2011;241;16-17;11;12;23;SEC_241
2011;607;75 i +;68;59;127;SEC_607
2011;116;12-15;28;23;51;SEC_116
2011;230;12-15;21;24;45;SEC_230
2011;529;12-15;22;21;43;SEC_529
2011;249;65-74;58;39;97;SEC_249
2011;303;75 i +;122;105;227;SEC_303
2011;512;18-24;31;35;66;SEC_512
2011;218;75 i +;37;25;62;SEC_218
2011;536;75 i +;74;46;120;SEC_536
2011;202;00-02;18;18;36;SEC_202
2011;536;03-11;36;42;78;SEC_536
2011;321;00-02;21;16;37;SEC_321
2011;619;25-34;62;84;146;SEC_619
2011;134;03-11;55;62;117;SEC_134
2011;102;12-15;22;31;53;SEC_102
2011;325;75 i +;184;98;282;SEC_325
2011;316;16-17;18;20;38;SEC_316
2011;139;35-49;101;124;225;SEC_139
2011;511;50-64;49;45;94;SEC_511
2011;630;00-02;11;13;24;SEC_630
2011;623;03-11;58;74;132;SEC_623
2011;509;50-64;60;53;113;SEC_509
2011;422;35-49;132;151;283;SEC_422
2011;414;12-15;19;20;39;SEC_414
2011;303;35-49;167;184;351;SEC_303
2011;225;18-24;20;19;39;SEC_225
2011;119;16-17;7;4;11;SEC_119
2011;132;12-15;28;38;66;SEC_132
2011;514;65-74;40;29;69;SEC_514
2011;626;25-34;48;57;105;SEC_626
2011;509;00-02;11;11;22;SEC_509
2011;319;65-74;41;51;92;SEC_319
2011;429;35-49;58;76;134;SEC_429
2011;238;65-74;37;37;74;SEC_238
2011;108;65-74;52;48;100;SEC_108
2011;140;25-34;77;92;169;SEC_140
2011;518;65-74;76;40;116;SEC_518
2011;514;12-15;19;15;34;SEC_514
2011;423;18-24;30;39;69;SEC_423
2011;123;16-17;7;15;22;SEC_123
2011;436;12-15;19;12;31;SEC_436
2011;123;25-34;92;80;172;SEC_123
2011;602;65-74;60;52;112;SEC_602
2011;230;18-24;28;39;67;SEC_230
2011;414;00-02;15;18;33;SEC_414
2011;538;18-24;43;43;86;SEC_538
2011;508;75 i +;38;24;62;SEC_508
2011;618;00-02;4;8;12;SEC_618
2011;523;00-02;20;19;39;SEC_523
2011;530;25-34;150;142;292;SEC_530
2011;219;16-17;17;10;27;SEC_219
2011;106;35-49;190;175;365;SEC_106
2011;203;00-02;9;12;21;SEC_203
2011;520;18-24;34;35;69;SEC_520
2011;503;65-74;45;43;88;SEC_503
2011;530;65-74;75;57;132;SEC_530
2011;424;50-64;50;47;97;SEC_424
2011;535;65-74;90;90;180;SEC_535
2011;501;35-49;112;113;225;SEC_501
2011;226;16-17;9;4;13;SEC_226
2011;611;65-74;139;118;257;SEC_611
2011;620;35-49;57;55;112;SEC_620
2011;311;50-64;116;93;209;SEC_311
2011;413;03-11;23;30;53;SEC_413
2011;603;75 i +;22;23;45;SEC_603
2011;508;03-11;31;31;62;SEC_508
2011;243;03-11;68;73;141;SEC_243
2011;601;75 i +;60;50;110;SEC_601
2011;511;25-34;64;63;127;SEC_511
2011;440;65-74;82;82;164;SEC_440
2011;112;03-11;72;58;130;SEC_112
2011;533;12-15;20;12;32;SEC_533
2011;120;25-34;100;126;226;SEC_120
2011;226;50-64;101;73;174;SEC_226
2011;222;16-17;13;8;21;SEC_222
2011;608;35-49;85;114;199;SEC_608
2011;407;12-15;19;12;31;SEC_407
2011;615;00-02;8;9;17;SEC_615
2011;242;12-15;17;21;38;SEC_242
2011;439;75 i +;57;47;104;SEC_439
2011;414;03-11;48;39;87;SEC_414
2011;248;03-11;57;49;106;SEC_248
2011;419;03-11;44;57;101;SEC_419
2011;202;65-74;28;30;58;SEC_202
2011;507;12-15;13;21;34;SEC_507
2011;608;50-64;79;62;141;SEC_608
2011;230;50-64;53;49;102;SEC_230
2011;401;03-11;49;60;109;SEC_401
2011;437;12-15;14;13;27;SEC_437
2011;137;16-17;5;12;17;SEC_137
2011;425;75 i +;78;50;128;SEC_425
2011;524;75 i +;75;43;118;SEC_524
2011;525;00-02;20;21;41;SEC_525
2011;301;50-64;186;181;367;SEC_301
2011;431;18-24;64;53;117;SEC_431
2011;613;16-17;10;7;17;SEC_613
2011;243;18-24;62;61;123;SEC_243
2011;102;16-17;10;13;23;SEC_102
2011;105;16-17;10;7;17;SEC_105
2011;629;18-24;24;16;40;SEC_629
2011;212;03-11;61;55;116;SEC_212
2011;430;12-15;14;24;38;SEC_430
2011;609;12-15;18;15;33;SEC_609
2011;407;18-24;37;38;75;SEC_407
2011;511;00-02;8;10;18;SEC_511
2011;441;18-24;88;93;181;SEC_441
2011;206;12-15;19;16;35;SEC_206
2011;304;25-34;263;225;488;SEC_304
2011;525;75 i +;66;39;105;SEC_525
2011;233;00-02;16;17;33;SEC_233
2011;606;18-24;40;48;88;SEC_606
2011;415;16-17;4;8;12;SEC_415
2011;224;18-24;25;17;42;SEC_224
2011;418;18-24;37;56;93;SEC_418
2011;210;12-15;13;12;25;SEC_210
2011;213;12-15;10;18;28;SEC_213
2011;249;25-34;107;95;202;SEC_249
2011;117;35-49;214;234;448;SEC_117
2011;413;75 i +;49;25;74;SEC_413
2011;631;50-64;107;74;181;SEC_631
2011;134;00-02;19;23;42;SEC_134
2011;205;18-24;32;40;72;SEC_205
2011;438;75 i +;45;37;82;SEC_438
2011;241;50-64;70;67;137;SEC_241
2011;525;16-17;13;10;23;SEC_525
2011;229;18-24;33;29;62;SEC_229
2011;322;18-24;56;44;100;SEC_322
2011;107;00-02;27;24;51;SEC_107
2011;501;00-02;8;11;19;SEC_501
2011;325;03-11;61;68;129;SEC_325
2011;423;25-34;103;99;202;SEC_423
2011;323;25-34;203;207;410;SEC_323
2011;104;03-11;37;42;79;SEC_104
2011;320;75 i +;41;18;59;SEC_320
2011;409;65-74;39;29;68;SEC_409
2011;241;75 i +;71;40;111;SEC_241
2011;616;75 i +;58;45;103;SEC_616
2011;411;35-49;102;104;206;SEC_411
2011;403;75 i +;83;65;148;SEC_403
2011;435;50-64;86;83;169;SEC_435
2011;632;00-02;11;17;28;SEC_632
2011;528;00-02;15;20;35;SEC_528
2011;206;16-17;9;11;20;SEC_206
2011;434;18-24;24;31;55;SEC_434
2011;310;25-34;96;77;173;SEC_310
2011;404;16-17;10;14;24;SEC_404
2011;223;18-24;59;65;124;SEC_223
2011;214;03-11;32;29;61;SEC_214
2011;628;65-74;77;76;153;SEC_628
2011;105;50-64;151;112;263;SEC_105
2011;420;75 i +;80;55;135;SEC_420
2011;523;12-15;15;24;39;SEC_523
2011;604;35-49;86;104;190;SEC_604
2011;630;25-34;65;85;150;SEC_630
2011;115;50-64;135;121;256;SEC_115
2011;136;65-74;60;47;107;SEC_136
2011;415;65-74;29;26;55;SEC_415
2011;509;16-17;9;10;19;SEC_509
2011;317;16-17;8;14;22;SEC_317
2011;248;25-34;100;112;212;SEC_248
2011;605;18-24;12;9;21;SEC_605
2011;433;50-64;79;84;163;SEC_433
2011;432;35-49;115;148;263;SEC_432
2011;607;65-74;94;70;164;SEC_607
2011;246;75 i +;86;48;134;SEC_246
2011;131;50-64;177;151;328;SEC_131
2011;218;18-24;28;33;61;SEC_218
2011;315;75 i +;62;35;97;SEC_315
2011;129;75 i +;70;52;122;SEC_129
2011;626;00-02;4;6;10;SEC_626
2011;224;50-64;50;62;112;SEC_224
2011;504;16-17;4;8;12;SEC_504
2011;232;03-11;31;45;76;SEC_232
2011;309;65-74;31;37;68;SEC_309
2011;308;25-34;144;137;281;SEC_308
2011;505;18-24;33;22;55;SEC_505
2011;301;16-17;19;17;36;SEC_301
2011;415;03-11;37;42;79;SEC_415
2011;416;65-74;46;26;72;SEC_416
2011;436;03-11;47;57;104;SEC_436
2011;631;12-15;12;16;28;SEC_631
2011;210;25-34;50;58;108;SEC_210
2011;124;50-64;105;79;184;SEC_124
2011;210;35-49;97;87;184;SEC_210
2011;131;12-15;15;18;33;SEC_131
2011;421;12-15;20;19;39;SEC_421
2011;434;35-49;78;82;160;SEC_434
2011;309;75 i +;40;18;58;SEC_309
2011;112;75 i +;72;32;104;SEC_112
2011;118;35-49;196;184;380;SEC_118
2011;614;50-64;100;78;178;SEC_614
2011;105;03-11;50;61;111;SEC_105
2011;118;50-64;222;196;418;SEC_118
2011;247;18-24;54;62;116;SEC_247
2011;201;12-15;7;19;26;SEC_201
2011;233;35-49;129;147;276;SEC_233
2011;222;00-02;15;19;34;SEC_222
2011;532;12-15;18;19;37;SEC_532
2011;520;65-74;40;40;80;SEC_520
2011;528;18-24;55;46;101;SEC_528
2011;209;00-02;9;13;22;SEC_209
2011;438;35-49;103;104;207;SEC_438
2011;428;35-49;75;85;160;SEC_428
2011;109;75 i +;70;48;118;SEC_109
2011;113;25-34;155;130;285;SEC_113
2011;533;03-11;52;52;104;SEC_533
2011;537;12-15;17;20;37;SEC_537
2011;118;75 i +;59;36;95;SEC_118
2011;101;03-11;126;124;250;SEC_101
2011;248;12-15;26;19;45;SEC_248
2011;239;18-24;42;48;90;SEC_239
2011;313;50-64;219;190;409;SEC_313
2011;229;16-17;12;11;23;SEC_229
2011;233;16-17;9;9;18;SEC_233
2011;235;18-24;59;46;105;SEC_235
2011;432;65-74;68;67;135;SEC_432
2011;101;16-17;16;15;31;SEC_101
2011;126;00-02;10;9;19;SEC_126
2011;423;00-02;16;22;38;SEC_423
2011;404;50-64;101;104;205;SEC_404
2011;120;18-24;79;71;150;SEC_120
2011;527;12-15;30;20;50;SEC_527
2011;436;50-64;53;65;118;SEC_436
2011;612;03-11;37;36;73;SEC_612
2011;209;16-17;6;8;14;SEC_209
2011;538;16-17;10;14;24;SEC_538
2011;425;16-17;5;9;14;SEC_425
2011;612;50-64;68;68;136;SEC_612
2011;209;18-24;33;48;81;SEC_209
2011;426;16-17;7;12;19;SEC_426
2011;306;12-15;30;32;62;SEC_306
2011;124;65-74;31;28;59;SEC_124
2011;234;18-24;36;40;76;SEC_234
2011;228;03-11;37;35;72;SEC_228
2011;205;50-64;104;96;200;SEC_205
2011;310;18-24;25;31;56;SEC_310
2011;106;18-24;64;70;134;SEC_106
2011;119;18-24;36;44;80;SEC_119
2011;622;35-49;91;96;187;SEC_622
2011;406;65-74;74;63;137;SEC_406
2011;229;00-02;12;13;25;SEC_229
2011;228;25-34;77;74;151;SEC_228
2011;616;25-34;279;302;581;SEC_616
2011;104;65-74;45;35;80;SEC_104
2011;531;16-17;11;13;24;SEC_531
2011;222;50-64;67;59;126;SEC_222
2011;135;75 i +;78;55;133;SEC_135
2011;414;75 i +;62;49;111;SEC_414
2011;526;12-15;10;15;25;SEC_526
2011;517;00-02;24;24;48;SEC_517
2011;204;12-15;13;4;17;SEC_204
2011;113;35-49;181;186;367;SEC_113
2011;219;75 i +;86;51;137;SEC_219
2011;622;00-02;8;11;19;SEC_622
2011;608;65-74;53;29;82;SEC_608
2011;245;65-74;52;26;78;SEC_245
2011;632;03-11;55;50;105;SEC_632
2011;610;50-64;107;68;175;SEC_610
2011;204;50-64;45;40;85;SEC_204
2011;501;16-17;9;8;17;SEC_501
2011;439;50-64;55;63;118;SEC_439
2011;620;65-74;53;54;107;SEC_620
2011;525;25-34;82;98;180;SEC_525
2011;416;12-15;6;15;21;SEC_416
2011;318;16-17;6;9;15;SEC_318
2011;401;75 i +;93;48;141;SEC_401
2011;237;65-74;62;48;110;SEC_237
2011;519;25-34;69;53;122;SEC_519
2011;204;18-24;40;27;67;SEC_204
2011;625;12-15;16;15;31;SEC_625
2011;434;75 i +;58;23;81;SEC_434
2011;301;03-11;122;136;258;SEC_301
2011;223;12-15;26;18;44;SEC_223
2011;513;03-11;34;29;63;SEC_513
2011;433;75 i +;43;24;67;SEC_433
2011;117;65-74;93;90;183;SEC_117
2011;321;03-11;83;87;170;SEC_321
2011;240;12-15;12;13;25;SEC_240
2011;618;65-74;40;44;84;SEC_618
2011;602;50-64;35;29;64;SEC_602
2011;423;03-11;45;35;80;SEC_423
2011;515;35-49;82;95;177;SEC_515
2011;244;75 i +;53;30;83;SEC_244
2011;115;65-74;50;62;112;SEC_115
2011;241;18-24;44;35;79;SEC_241
2011;127;75 i +;48;34;82;SEC_127
2011;207;50-64;75;62;137;SEC_207
2011;106;03-11;72;58;130;SEC_106
2011;319;25-34;138;153;291;SEC_319
2011;234;03-11;27;41;68;SEC_234
2011;140;03-11;35;45;80;SEC_140
2011;529;25-34;116;99;215;SEC_529
2011;227;03-11;32;18;50;SEC_227
2011;613;65-74;126;119;245;SEC_613
2011;116;50-64;153;126;279;SEC_116
2011;308;16-17;18;21;39;SEC_308
2011;129;03-11;39;54;93;SEC_129
2011;628;35-49;104;96;200;SEC_628
2011;302;75 i +;71;37;108;SEC_302
2011;308;35-49;274;247;521;SEC_308
2011;527;35-49;135;153;288;SEC_527
2011;127;12-15;10;10;20;SEC_127
2011;534;25-34;77;86;163;SEC_534
2011;611;16-17;8;17;25;SEC_611
2011;619;12-15;15;22;37;SEC_619
2011;203;25-34;88;109;197;SEC_203
2011;420;65-74;73;43;116;SEC_420
2011;214;16-17;9;3;12;SEC_214
2011;134;16-17;13;19;32;SEC_134
2011;123;75 i +;98;63;161;SEC_123
2011;428;50-64;52;44;96;SEC_428
2011;303;16-17;6;9;15;SEC_303
2011;312;18-24;63;55;118;SEC_312
2011;236;65-74;63;41;104;SEC_236
2011;409;25-34;65;56;121;SEC_409
2011;114;35-49;174;200;374;SEC_114
2011;509;18-24;34;49;83;SEC_509
2011;433;35-49;148;173;321;SEC_433
2011;238;03-11;30;32;62;SEC_238
2011;615;35-49;87;106;193;SEC_615
2011;408;50-64;76;77;153;SEC_408
2011;530;03-11;46;66;112;SEC_530
2011;130;18-24;25;39;64;SEC_130
2011;615;18-24;22;24;46;SEC_615
2011;506;03-11;62;81;143;SEC_506
2011;518;12-15;16;19;35;SEC_518
2011;228;18-24;46;39;85;SEC_228
2011;118;12-15;35;23;58;SEC_118
2011;223;25-34;118;107;225;SEC_223
2011;630;03-11;28;32;60;SEC_630
2011;412;16-17;17;20;37;SEC_412
2011;203;12-15;10;11;21;SEC_203
2011;425;03-11;33;39;72;SEC_425
2011;231;12-15;19;21;40;SEC_231
2011;121;18-24;25;29;54;SEC_121
2011;131;18-24;50;48;98;SEC_131
