AnyPadro;Seccio;GrupEdat;Dones;Homes;Total;IdSeccio
2009;602;65-74;58;62;120;SEC_602
2009;516;00-02;19;12;31;SEC_516
2009;408;00-02;27;14;41;SEC_408
2009;605;12-15;4;7;11;SEC_605
2009;125;35-49;207;237;444;SEC_125
2009;110;35-49;119;102;221;SEC_110
2009;311;50-64;115;95;210;SEC_311
2009;619;50-64;140;124;264;SEC_619
2009;612;18-24;27;32;59;SEC_612
2009;534;16-17;13;9;22;SEC_534
2009;430;25-34;115;133;248;SEC_430
2009;428;03-11;35;23;58;SEC_428
2009;214;03-11;45;25;70;SEC_214
2009;632;16-17;4;9;13;SEC_632
2009;138;65-74;43;40;83;SEC_138
2009;439;75 i +;52;42;94;SEC_439
2009;511;50-64;50;45;95;SEC_511
2009;219;18-24;58;52;110;SEC_219
2009;437;65-74;45;31;76;SEC_437
2009;247;18-24;56;65;121;SEC_247
2009;118;16-17;17;12;29;SEC_118
2009;402;65-74;48;41;89;SEC_402
2009;418;00-02;25;14;39;SEC_418
2009;220;50-64;63;58;121;SEC_220
2009;532;16-17;16;7;23;SEC_532
2009;104;25-34;54;66;120;SEC_104
2009;209;50-64;81;74;155;SEC_209
2009;623;50-64;177;146;323;SEC_623
2009;137;18-24;62;50;112;SEC_137
2009;417;12-15;13;15;28;SEC_417
2009;303;16-17;12;9;21;SEC_303
2009;310;75 i +;39;28;67;SEC_310
2009;433;65-74;37;31;68;SEC_433
2009;601;03-11;41;43;84;SEC_601
2009;233;25-34;100;128;228;SEC_233
2009;423;03-11;46;31;77;SEC_423
2009;210;75 i +;109;52;161;SEC_210
2009;306;12-15;29;31;60;SEC_306
2009;127;00-02;5;11;16;SEC_127
2009;225;25-34;47;59;106;SEC_225
2009;620;12-15;5;9;14;SEC_620
2009;512;00-02;13;16;29;SEC_512
2009;512;75 i +;46;25;71;SEC_512
2009;436;65-74;34;19;53;SEC_436
2009;533;25-34;122;145;267;SEC_533
2009;217;25-34;72;97;169;SEC_217
2009;435;50-64;79;78;157;SEC_435
2009;609;16-17;4;7;11;SEC_609
2009;305;18-24;86;78;164;SEC_305
2009;112;03-11;61;56;117;SEC_112
2009;606;65-74;73;59;132;SEC_606
2009;323;35-49;328;344;672;SEC_323
2009;325;75 i +;174;94;268;SEC_325
2009;233;75 i +;50;26;76;SEC_233
2009;308;75 i +;93;46;139;SEC_308
2009;315;12-15;25;24;49;SEC_315
2009;435;18-24;64;55;119;SEC_435
2009;508;03-11;27;22;49;SEC_508
2009;136;25-34;115;109;224;SEC_136
2009;207;65-74;34;29;63;SEC_207
2009;512;03-11;29;50;79;SEC_512
2009;308;50-64;202;189;391;SEC_308
2009;249;50-64;89;76;165;SEC_249
2009;229;12-15;18;19;37;SEC_229
2009;617;65-74;69;41;110;SEC_617
2009;104;75 i +;84;43;127;SEC_104
2009;522;18-24;61;45;106;SEC_522
2009;227;16-17;7;3;10;SEC_227
2009;134;03-11;53;58;111;SEC_134
2009;439;65-74;61;47;108;SEC_439
2009;129;75 i +;58;36;94;SEC_129
2009;616;35-49;330;338;668;SEC_616
2009;102;16-17;14;17;31;SEC_102
2009;137;00-02;30;19;49;SEC_137
2009;538;00-02;18;22;40;SEC_538
2009;532;03-11;52;49;101;SEC_532
2009;304;03-11;101;104;205;SEC_304
2009;217;16-17;6;4;10;SEC_217
2009;631;65-74;74;75;149;SEC_631
2009;207;35-49;77;69;146;SEC_207
2009;424;03-11;19;29;48;SEC_424
2009;628;00-02;14;11;25;SEC_628
2009;412;65-74;108;88;196;SEC_412
2009;528;75 i +;60;40;100;SEC_528
2009;415;65-74;22;25;47;SEC_415
2009;224;65-74;22;13;35;SEC_224
2009;510;00-02;12;12;24;SEC_510
2009;132;75 i +;81;65;146;SEC_132
2009;322;65-74;54;44;98;SEC_322
2009;249;25-34;111;115;226;SEC_249
2009;419;03-11;45;58;103;SEC_419
2009;243;00-02;18;26;44;SEC_243
2009;248;12-15;29;24;53;SEC_248
2009;101;12-15;30;27;57;SEC_101
2009;534;03-11;35;39;74;SEC_534
2009;303;50-64;134;108;242;SEC_303
2009;242;03-11;37;29;66;SEC_242
2009;308;00-02;34;21;55;SEC_308
2009;133;18-24;28;31;59;SEC_133
2009;115;65-74;50;46;96;SEC_115
2009;325;03-11;68;67;135;SEC_325
2009;603;18-24;15;26;41;SEC_603
2009;620;35-49;61;63;124;SEC_620
2009;243;75 i +;100;65;165;SEC_243
2009;107;00-02;38;36;74;SEC_107
2009;619;65-74;113;90;203;SEC_619
2009;209;00-02;7;14;21;SEC_209
2009;525;12-15;18;18;36;SEC_525
2009;305;25-34;123;136;259;SEC_305
2009;324;00-02;23;14;37;SEC_324
2009;519;50-64;40;27;67;SEC_519
2009;618;16-17;5;4;9;SEC_618
2009;202;00-02;16;23;39;SEC_202
2009;428;65-74;21;12;33;SEC_428
2009;512;25-34;87;98;185;SEC_512
2009;612;16-17;7;13;20;SEC_612
2009;622;50-64;101;86;187;SEC_622
2009;404;35-49;162;184;346;SEC_404
2009;605;75 i +;42;31;73;SEC_605
2009;530;35-49;173;165;338;SEC_530
2009;534;12-15;10;17;27;SEC_534
2009;220;75 i +;53;36;89;SEC_220
2009;527;65-74;46;32;78;SEC_527
2009;603;16-17;6;6;12;SEC_603
2009;233;16-17;8;6;14;SEC_233
2009;509;65-74;38;33;71;SEC_509
2009;119;00-02;10;15;25;SEC_119
2009;314;16-17;14;32;46;SEC_314
2009;133;50-64;99;85;184;SEC_133
2009;317;35-49;135;149;284;SEC_317
2009;604;18-24;26;48;74;SEC_604
2009;123;50-64;109;111;220;SEC_123
2009;630;75 i +;38;22;60;SEC_630
2009;241;25-34;80;79;159;SEC_241
2009;429;65-74;31;25;56;SEC_429
2009;129;50-64;102;89;191;SEC_129
2009;623;35-49;143;158;301;SEC_623
2009;227;35-49;85;95;180;SEC_227
2009;232;12-15;23;10;33;SEC_232
2009;123;35-49;160;170;330;SEC_123
2009;532;75 i +;78;59;137;SEC_532
2009;627;65-74;51;49;100;SEC_627
2009;317;25-34;111;130;241;SEC_317
2009;303;75 i +;99;88;187;SEC_303
2009;428;18-24;32;28;60;SEC_428
2009;624;18-24;38;26;64;SEC_624
2009;407;65-74;58;36;94;SEC_407
2009;536;35-49;99;111;210;SEC_536
2009;209;18-24;42;53;95;SEC_209
2009;607;18-24;42;36;78;SEC_607
2009;242;25-34;87;116;203;SEC_242
2009;129;16-17;11;5;16;SEC_129
2009;136;00-02;18;17;35;SEC_136
2009;115;16-17;13;11;24;SEC_115
2009;135;75 i +;71;43;114;SEC_135
2009;128;18-24;36;36;72;SEC_128
2009;102;35-49;164;182;346;SEC_102
2009;618;03-11;36;40;76;SEC_618
2009;512;18-24;39;44;83;SEC_512
2009;632;03-11;55;43;98;SEC_632
2009;314;12-15;34;46;80;SEC_314
2009;108;00-02;24;21;45;SEC_108
2009;138;25-34;74;70;144;SEC_138
2009;129;18-24;32;38;70;SEC_129
2009;505;00-02;14;15;29;SEC_505
2009;105;75 i +;61;36;97;SEC_105
2009;409;65-74;38;33;71;SEC_409
2009;204;35-49;68;80;148;SEC_204
2009;226;65-74;54;38;92;SEC_226
2009;520;12-15;17;11;28;SEC_520
2009;211;65-74;65;38;103;SEC_211
2009;509;35-49;96;113;209;SEC_509
2009;431;35-49;188;230;418;SEC_431
2009;219;25-34;125;146;271;SEC_219
2009;249;00-02;23;17;40;SEC_249
2009;421;75 i +;83;61;144;SEC_421
2009;618;75 i +;24;16;40;SEC_618
2009;124;25-34;62;80;142;SEC_124
2009;532;25-34;137;139;276;SEC_532
2009;514;18-24;45;24;69;SEC_514
2009;101;00-02;41;52;93;SEC_101
2009;116;35-49;167;181;348;SEC_116
2009;508;35-49;68;93;161;SEC_508
2009;124;50-64;98;82;180;SEC_124
2009;433;50-64;80;76;156;SEC_433
2009;623;12-15;19;30;49;SEC_623
2009;522;35-49;101;118;219;SEC_522
2009;212;65-74;71;51;122;SEC_212
2009;109;50-64;124;121;245;SEC_109
2009;518;00-02;15;17;32;SEC_518
2009;521;18-24;34;26;60;SEC_521
2009;206;16-17;9;13;22;SEC_206
2009;231;65-74;60;37;97;SEC_231
2009;605;03-11;26;22;48;SEC_605
2009;410;35-49;176;167;343;SEC_410
2009;631;50-64;134;98;232;SEC_631
2009;521;35-49;88;103;191;SEC_521
2009;406;65-74;82;55;137;SEC_406
2009;119;25-34;95;99;194;SEC_119
2009;210;25-34;67;67;134;SEC_210
2009;221;03-11;41;39;80;SEC_221
2009;428;12-15;9;10;19;SEC_428
2009;436;75 i +;33;22;55;SEC_436
2009;324;18-24;42;55;97;SEC_324
2009;620;25-34;42;45;87;SEC_620
2009;242;18-24;36;53;89;SEC_242
2009;226;18-24;56;59;115;SEC_226
2009;111;00-02;10;9;19;SEC_111
2009;117;25-34;147;182;329;SEC_117
2009;422;50-64;77;81;158;SEC_422
2009;323;75 i +;82;29;111;SEC_323
2009;519;16-17;5;11;16;SEC_519
2009;139;65-74;38;37;75;SEC_139
2009;211;03-11;49;59;108;SEC_211
2009;207;00-02;14;8;22;SEC_207
2009;531;16-17;10;7;17;SEC_531
2009;605;65-74;65;69;134;SEC_605
2009;204;50-64;41;36;77;SEC_204
2009;417;16-17;7;6;13;SEC_417
2009;134;25-34;113;135;248;SEC_134
2009;125;16-17;19;9;28;SEC_125
2009;241;65-74;35;40;75;SEC_241
2009;441;35-49;182;203;385;SEC_441
2009;405;03-11;25;29;54;SEC_405
2009;105;35-49;141;139;280;SEC_105
2009;503;03-11;28;27;55;SEC_503
2009;409;25-34;52;76;128;SEC_409
2009;420;00-02;28;28;56;SEC_420
2009;110;18-24;42;46;88;SEC_110
2009;314;18-24;80;133;213;SEC_314
2009;206;00-02;15;14;29;SEC_206
2009;203;18-24;29;36;65;SEC_203
2009;625;18-24;58;72;130;SEC_625
2009;211;12-15;19;26;45;SEC_211
2009;429;03-11;21;21;42;SEC_429
2009;118;03-11;79;59;138;SEC_118
2009;241;00-02;12;12;24;SEC_241
2009;305;00-02;26;26;52;SEC_305
2009;309;16-17;5;4;9;SEC_309
2009;619;16-17;10;11;21;SEC_619
2009;239;75 i +;95;61;156;SEC_239
2009;227;50-64;68;55;123;SEC_227
2009;427;00-02;19;18;37;SEC_427
2009;248;03-11;52;44;96;SEC_248
2009;213;03-11;34;55;89;SEC_213
2009;316;18-24;125;119;244;SEC_316
2009;422;18-24;53;59;112;SEC_422
2009;420;12-15;25;29;54;SEC_420
2009;428;25-34;61;71;132;SEC_428
2009;614;18-24;26;34;60;SEC_614
2009;139;35-49;103;130;233;SEC_139
2009;109;75 i +;71;41;112;SEC_109
2009;507;03-11;35;43;78;SEC_507
2009;416;25-34;54;81;135;SEC_416
2009;237;18-24;59;50;109;SEC_237
2009;304;16-17;21;10;31;SEC_304
2009;509;25-34;85;110;195;SEC_509
2009;239;12-15;20;13;33;SEC_239
2009;506;12-15;34;27;61;SEC_506
2009;524;65-74;64;42;106;SEC_524
2009;416;00-02;16;10;26;SEC_416
2009;501;50-64;147;144;291;SEC_501
2009;408;18-24;41;34;75;SEC_408
2009;511;00-02;14;7;21;SEC_511
2009;631;00-02;15;15;30;SEC_631
2009;306;50-64;160;140;300;SEC_306
2009;531;25-34;92;117;209;SEC_531
2009;510;25-34;81;92;173;SEC_510
2009;215;00-02;9;10;19;SEC_215
2009;401;12-15;24;24;48;SEC_401
2009;304;12-15;50;30;80;SEC_304
2009;515;00-02;7;8;15;SEC_515
2009;209;75 i +;79;61;140;SEC_209
2009;521;12-15;12;11;23;SEC_521
2009;318;03-11;28;38;66;SEC_318
2009;527;18-24;64;46;110;SEC_527
2009;422;25-34;104;128;232;SEC_422
2009;503;50-64;116;103;219;SEC_503
2009;407;03-11;45;39;84;SEC_407
2009;229;50-64;60;54;114;SEC_229
2009;614;16-17;7;11;18;SEC_614
2009;119;16-17;10;13;23;SEC_119
2009;318;00-02;10;11;21;SEC_318
2009;625;75 i +;44;24;68;SEC_625
2009;202;25-34;100;117;217;SEC_202
2009;401;16-17;21;4;25;SEC_401
2009;525;16-17;8;11;19;SEC_525
2009;418;35-49;172;171;343;SEC_418
2009;620;16-17;11;5;16;SEC_620
2009;226;03-11;42;39;81;SEC_226
2009;427;12-15;21;22;43;SEC_427
2009;411;16-17;9;7;16;SEC_411
2009;418;12-15;27;35;62;SEC_418
2009;303;03-11;42;50;92;SEC_303
2009;233;18-24;41;40;81;SEC_233
2009;303;00-02;31;27;58;SEC_303
2009;218;00-02;8;7;15;SEC_218
2009;123;00-02;25;19;44;SEC_123
2009;109;16-17;9;11;20;SEC_109
2009;222;50-64;77;62;139;SEC_222
2009;412;12-15;30;27;57;SEC_412
2009;114;00-02;14;23;37;SEC_114
2009;106;65-74;59;58;117;SEC_106
2009;504;25-34;99;91;190;SEC_504
2009;124;18-24;27;28;55;SEC_124
2009;205;25-34;87;81;168;SEC_205
2009;320;25-34;64;69;133;SEC_320
2009;315;50-64;161;158;319;SEC_315
2009;201;16-17;5;7;12;SEC_201
2009;512;12-15;17;13;30;SEC_512
2009;224;12-15;12;13;25;SEC_224
2009;306;18-24;59;71;130;SEC_306
2009;631;03-11;32;40;72;SEC_631
2009;127;18-24;31;39;70;SEC_127
2009;231;16-17;5;9;14;SEC_231
2009;620;50-64;66;60;126;SEC_620
2009;411;18-24;42;36;78;SEC_411
2009;202;50-64;63;59;122;SEC_202
2009;435;12-15;15;22;37;SEC_435
2009;118;65-74;65;70;135;SEC_118
2009;404;65-74;71;59;130;SEC_404
2009;612;03-11;41;41;82;SEC_612
2009;237;00-02;27;21;48;SEC_237
2009;616;75 i +;52;36;88;SEC_616
2009;225;50-64;49;36;85;SEC_225
2009;207;18-24;20;22;42;SEC_207
2009;132;16-17;20;22;42;SEC_132
2009;225;18-24;18;23;41;SEC_225
2009;517;00-02;28;18;46;SEC_517
2009;620;75 i +;21;18;39;SEC_620
2009;628;50-64;113;88;201;SEC_628
2009;122;12-15;18;8;26;SEC_122
2009;114;50-64;178;127;305;SEC_114
2009;216;03-11;50;34;84;SEC_216
2009;241;50-64;55;52;107;SEC_241
2009;604;65-74;50;38;88;SEC_604
2009;224;16-17;7;3;10;SEC_224
2009;431;18-24;57;67;124;SEC_431
2009;429;16-17;7;4;11;SEC_429
2009;243;35-49;204;195;399;SEC_243
2009;126;18-24;36;22;58;SEC_126
2009;106;00-02;20;23;43;SEC_106
2009;205;12-15;13;17;30;SEC_205
2009;632;75 i +;40;28;68;SEC_632
2009;528;35-49;171;140;311;SEC_528
2009;401;00-02;16;21;37;SEC_401
2009;426;03-11;54;47;101;SEC_426
2009;415;03-11;31;50;81;SEC_415
2009;440;25-34;80;79;159;SEC_440
2009;437;75 i +;41;29;70;SEC_437
2009;308;03-11;98;120;218;SEC_308
2009;117;50-64;236;226;462;SEC_117
2009;113;03-11;48;74;122;SEC_113
2009;516;65-74;38;23;61;SEC_516
2009;430;18-24;40;49;89;SEC_430
2009;201;25-34;102;98;200;SEC_201
2009;535;12-15;13;15;28;SEC_535
2009;501;75 i +;30;18;48;SEC_501
2009;527;75 i +;57;31;88;SEC_527
2009;112;16-17;16;20;36;SEC_112
2009;518;18-24;53;57;110;SEC_518
2009;532;35-49;155;164;319;SEC_532
2009;508;16-17;6;8;14;SEC_508
2009;321;65-74;88;99;187;SEC_321
2009;432;35-49;118;127;245;SEC_432
2009;520;00-02;19;9;28;SEC_520
2009;136;75 i +;63;36;99;SEC_136
2009;630;25-34;80;100;180;SEC_630
2009;505;75 i +;60;48;108;SEC_505
2009;128;35-49;133;137;270;SEC_128
2009;442;12-15;16;15;31;SEC_442
2009;224;75 i +;40;22;62;SEC_224
2009;520;35-49;95;92;187;SEC_520
2009;537;18-24;60;42;102;SEC_537
2009;628;03-11;35;49;84;SEC_628
2009;101;18-24;48;45;93;SEC_101
2009;524;25-34;143;147;290;SEC_524
2009;228;18-24;41;55;96;SEC_228
2009;438;12-15;10;15;25;SEC_438
2009;301;00-02;57;57;114;SEC_301
2009;602;35-49;70;71;141;SEC_602
2009;614;50-64;101;87;188;SEC_614
2009;618;00-02;3;7;10;SEC_618
2009;429;75 i +;51;24;75;SEC_429
2009;511;75 i +;52;31;83;SEC_511
2009;608;50-64;82;57;139;SEC_608
2009;211;50-64;78;75;153;SEC_211
2009;129;12-15;21;14;35;SEC_129
2009;415;12-15;14;19;33;SEC_415
2009;621;00-02;21;15;36;SEC_621
2009;442;35-49;74;76;150;SEC_442
2009;505;18-24;39;18;57;SEC_505
2009;204;25-34;60;70;130;SEC_204
2009;525;03-11;37;34;71;SEC_525
2009;515;03-11;23;28;51;SEC_515
2009;602;25-34;35;41;76;SEC_602
2009;411;35-49;116;126;242;SEC_411
2009;123;12-15;17;24;41;SEC_123
2009;123;03-11;50;54;104;SEC_123
2009;416;16-17;6;8;14;SEC_416
2009;437;25-34;72;113;185;SEC_437
2009;318;25-34;65;63;128;SEC_318
2009;320;50-64;96;79;175;SEC_320
2009;425;25-34;87;91;178;SEC_425
2009;507;00-02;13;17;30;SEC_507
2009;131;18-24;50;59;109;SEC_131
2009;422;75 i +;81;47;128;SEC_422
2009;138;03-11;34;22;56;SEC_138
2009;244;12-15;12;11;23;SEC_244
2009;402;18-24;41;28;69;SEC_402
2009;248;16-17;13;13;26;SEC_248
2009;231;18-24;33;29;62;SEC_231
2009;111;50-64;95;68;163;SEC_111
2009;621;18-24;45;50;95;SEC_621
2009;308;25-34;141;136;277;SEC_308
2009;246;35-49;130;190;320;SEC_246
2009;438;75 i +;40;29;69;SEC_438
2009;409;35-49;88;93;181;SEC_409
2009;236;75 i +;88;57;145;SEC_236
2009;219;35-49;170;147;317;SEC_219
2009;241;12-15;18;13;31;SEC_241
2009;324;25-34;119;104;223;SEC_324
2009;322;00-02;23;22;45;SEC_322
2009;402;00-02;13;17;30;SEC_402
2009;605;16-17;4;2;6;SEC_605
2009;249;03-11;41;42;83;SEC_249
2009;136;03-11;56;49;105;SEC_136
2009;111;16-17;9;5;14;SEC_111
2009;617;16-17;9;8;17;SEC_617
2009;231;75 i +;82;53;135;SEC_231
2009;524;03-11;58;49;107;SEC_524
2009;631;25-34;95;93;188;SEC_631
2009;128;50-64;93;70;163;SEC_128
2009;128;25-34;98;99;197;SEC_128
2009;509;12-15;20;26;46;SEC_509
2009;511;16-17;8;9;17;SEC_511
2009;534;35-49;123;108;231;SEC_534
2009;122;65-74;79;68;147;SEC_122
2009;537;35-49;126;121;247;SEC_537
2009;535;75 i +;41;33;74;SEC_535
2009;237;50-64;99;103;202;SEC_237
2009;429;25-34;52;61;113;SEC_429
2009;125;75 i +;46;37;83;SEC_125
2009;505;12-15;11;8;19;SEC_505
2009;238;75 i +;65;37;102;SEC_238
2009;232;00-02;13;15;28;SEC_232
2009;519;12-15;8;12;20;SEC_519
2009;322;25-34;150;133;283;SEC_322
2009;220;12-15;18;15;33;SEC_220
2009;311;35-49;165;198;363;SEC_311
2009;213;65-74;50;44;94;SEC_213
2009;323;16-17;23;24;47;SEC_323
2009;224;35-49;87;93;180;SEC_224
2009;516;03-11;27;39;66;SEC_516
2009;423;16-17;4;9;13;SEC_423
2009;613;12-15;17;18;35;SEC_613
2009;528;50-64;86;72;158;SEC_528
2009;426;12-15;14;23;37;SEC_426
2009;511;35-49;87;100;187;SEC_511
2009;114;16-17;12;8;20;SEC_114
2009;130;25-34;63;65;128;SEC_130
2009;222;16-17;7;12;19;SEC_222
2009;420;65-74;76;60;136;SEC_420
2009;133;35-49;98;95;193;SEC_133
2009;502;00-02;26;21;47;SEC_502
2009;110;50-64;166;127;293;SEC_110
2009;424;50-64;54;46;100;SEC_424
2009;224;00-02;18;11;29;SEC_224
2009;514;25-34;73;90;163;SEC_514
2009;322;50-64;106;98;204;SEC_322
2009;131;12-15;16;18;34;SEC_131
2009;440;12-15;21;11;32;SEC_440
2009;139;18-24;25;28;53;SEC_139
2009;319;35-49;256;262;518;SEC_319
2009;609;03-11;33;30;63;SEC_609
2009;418;50-64;108;92;200;SEC_418
2009;107;50-64;159;144;303;SEC_107
2009;533;12-15;10;16;26;SEC_533
2009;321;35-49;258;247;505;SEC_321
2009;533;18-24;49;48;97;SEC_533
2009;240;03-11;30;23;53;SEC_240
2009;438;03-11;28;31;59;SEC_438
2009;401;75 i +;92;41;133;SEC_401
2009;315;75 i +;65;28;93;SEC_315
2009;109;35-49;119;116;235;SEC_109
2009;413;12-15;19;10;29;SEC_413
2009;219;50-64;96;87;183;SEC_219
2009;626;12-15;17;18;35;SEC_626
2009;236;18-24;47;56;103;SEC_236
2009;233;35-49;115;133;248;SEC_233
2009;601;35-49;119;168;287;SEC_601
2009;504;18-24;27;44;71;SEC_504
2009;312;25-34;160;179;339;SEC_312
2009;506;18-24;63;77;140;SEC_506
2009;230;75 i +;55;28;83;SEC_230
2009;121;65-74;37;21;58;SEC_121
2009;501;18-24;34;32;66;SEC_501
2009;622;65-74;35;38;73;SEC_622
2009;442;16-17;6;8;14;SEC_442
2009;632;65-74;62;46;108;SEC_632
2009;406;00-02;22;22;44;SEC_406
2009;622;16-17;4;9;13;SEC_622
2009;248;50-64;98;88;186;SEC_248
2009;621;75 i +;43;25;68;SEC_621
2009;404;25-34;127;130;257;SEC_404
2009;302;00-02;19;25;44;SEC_302
2009;221;50-64;93;86;179;SEC_221
2009;632;00-02;19;26;45;SEC_632
2009;238;35-49;113;133;246;SEC_238
2009;403;50-64;117;91;208;SEC_403
2009;206;65-74;51;32;83;SEC_206
2009;123;18-24;44;38;82;SEC_123
2009;127;16-17;7;9;16;SEC_127
2009;225;65-74;29;20;49;SEC_225
2009;417;18-24;35;33;68;SEC_417
2009;413;00-02;7;7;14;SEC_413
2009;235;18-24;71;66;137;SEC_235
2009;608;16-17;7;7;14;SEC_608
2009;321;16-17;16;19;35;SEC_321
2009;436;12-15;18;22;40;SEC_436
2009;440;75 i +;57;42;99;SEC_440
2009;213;00-02;20;24;44;SEC_213
2009;135;50-64;152;150;302;SEC_135
2009;214;25-34;110;128;238;SEC_214
2009;238;12-15;8;16;24;SEC_238
2009;120;00-02;24;26;50;SEC_120
2009;526;16-17;5;7;12;SEC_526
2009;130;75 i +;80;57;137;SEC_130
2009;510;50-64;88;78;166;SEC_510
2009;440;50-64;97;78;175;SEC_440
2009;518;16-17;9;12;21;SEC_518
2009;603;03-11;33;48;81;SEC_603
2009;427;03-11;57;56;113;SEC_427
2009;324;75 i +;50;27;77;SEC_324
2009;238;50-64;70;65;135;SEC_238
2009;316;00-02;16;10;26;SEC_316
2009;427;18-24;42;36;78;SEC_427
2009;136;16-17;11;13;24;SEC_136
2009;426;75 i +;51;28;79;SEC_426
2009;424;16-17;6;7;13;SEC_424
2009;203;50-64;63;55;118;SEC_203
2009;121;25-34;65;73;138;SEC_121
2009;230;12-15;15;25;40;SEC_230
2009;523;25-34;139;179;318;SEC_523
2009;222;03-11;45;40;85;SEC_222
2009;609;18-24;31;25;56;SEC_609
2009;611;65-74;132;132;264;SEC_611
2009;628;16-17;9;8;17;SEC_628
2009;231;12-15;20;25;45;SEC_231
2009;307;50-64;217;169;386;SEC_307
2009;624;16-17;11;11;22;SEC_624
2009;525;75 i +;60;42;102;SEC_525
2009;439;00-02;28;34;62;SEC_439
2009;442;18-24;29;32;61;SEC_442
2009;433;75 i +;40;24;64;SEC_433
2009;538;03-11;57;55;112;SEC_538
2009;524;16-17;12;14;26;SEC_524
2009;535;18-24;43;42;85;SEC_535
2009;135;18-24;60;56;116;SEC_135
2009;238;25-34;77;93;170;SEC_238
2009;525;50-64;62;71;133;SEC_525
2009;423;18-24;31;49;80;SEC_423
2009;419;65-74;48;35;83;SEC_419
2009;248;18-24;55;48;103;SEC_248
2009;509;16-17;7;12;19;SEC_509
2009;214;16-17;13;8;21;SEC_214
2009;436;35-49;123;161;284;SEC_436
2009;121;12-15;19;16;35;SEC_121
2009;527;25-34;154;127;281;SEC_527
2009;227;00-02;12;10;22;SEC_227
2009;617;35-49;104;113;217;SEC_617
2009;603;75 i +;21;22;43;SEC_603
2009;228;65-74;45;35;80;SEC_228
2009;202;18-24;36;36;72;SEC_202
2009;624;25-34;87;108;195;SEC_624
2009;325;25-34;113;131;244;SEC_325
2009;418;25-34;110;136;246;SEC_418
2009;407;25-34;84;100;184;SEC_407
2009;434;16-17;9;8;17;SEC_434
2009;424;65-74;33;25;58;SEC_424
2009;630;12-15;5;16;21;SEC_630
2009;503;18-24;33;33;66;SEC_503
2009;216;75 i +;72;46;118;SEC_216
2009;412;50-64;174;156;330;SEC_412
2009;244;75 i +;53;31;84;SEC_244
2009;119;35-49;125;145;270;SEC_119
2009;125;12-15;23;32;55;SEC_125
2009;312;75 i +;66;35;101;SEC_312
2009;125;03-11;73;76;149;SEC_125
2009;241;16-17;7;5;12;SEC_241
2009;215;50-64;87;81;168;SEC_215
2009;629;16-17;4;4;8;SEC_629
2009;139;16-17;6;5;11;SEC_139
2009;604;35-49;83;118;201;SEC_604
2009;318;50-64;98;99;197;SEC_318
2009;532;65-74;81;66;147;SEC_532
2009;602;12-15;10;12;22;SEC_602
2009;626;35-49;103;108;211;SEC_626
2009;221;00-02;14;14;28;SEC_221
2009;523;18-24;56;61;117;SEC_523
2009;216;65-74;72;57;129;SEC_216
2009;414;25-34;97;117;214;SEC_414
2009;317;16-17;11;11;22;SEC_317
2009;104;35-49;104;125;229;SEC_104
2009;118;25-34;138;163;301;SEC_118
2009;608;12-15;16;13;29;SEC_608
2009;522;16-17;6;5;11;SEC_522
2009;626;03-11;37;41;78;SEC_626
2009;409;00-02;11;17;28;SEC_409
2009;609;35-49;90;95;185;SEC_609
2009;408;12-15;17;21;38;SEC_408
2009;128;16-17;5;11;16;SEC_128
2009;435;25-34;125;123;248;SEC_435
2009;624;12-15;14;18;32;SEC_624
2009;111;03-11;20;40;60;SEC_111
2009;108;50-64;132;120;252;SEC_108
2009;506;25-34;122;130;252;SEC_506
2009;606;25-34;90;101;191;SEC_606
2009;224;18-24;24;23;47;SEC_224
2009;439;25-34;119;148;267;SEC_439
2009;217;03-11;25;37;62;SEC_217
2009;413;50-64;44;39;83;SEC_413
2009;241;03-11;33;27;60;SEC_241
2009;117;75 i +;73;35;108;SEC_117
2009;517;75 i +;59;32;91;SEC_517
2009;105;03-11;37;55;92;SEC_105
2009;438;16-17;5;12;17;SEC_438
2009;433;25-34;127;168;295;SEC_433
2009;312;65-74;109;102;211;SEC_312
2009;122;50-64;74;46;120;SEC_122
2009;525;65-74;61;36;97;SEC_525
2009;140;03-11;35;42;77;SEC_140
2009;402;03-11;31;38;69;SEC_402
2009;126;35-49;89;117;206;SEC_126
2009;230;16-17;7;10;17;SEC_230
2009;209;65-74;56;39;95;SEC_209
2009;108;35-49;192;160;352;SEC_108
2009;222;65-74;38;37;75;SEC_222
2009;602;03-11;17;17;34;SEC_602
2009;231;35-49;158;166;324;SEC_231
2009;111;18-24;37;33;70;SEC_111
2009;108;18-24;46;45;91;SEC_108
2009;618;12-15;8;14;22;SEC_618
2009;236;12-15;25;16;41;SEC_236
2009;632;12-15;17;25;42;SEC_632
2009;420;50-64;91;90;181;SEC_420
2009;204;18-24;37;25;62;SEC_204
2009;430;65-74;52;50;102;SEC_430
2009;606;16-17;13;8;21;SEC_606
2009;127;75 i +;47;26;73;SEC_127
2009;522;00-02;23;14;37;SEC_522
2009;211;25-34;137;147;284;SEC_211
2009;401;25-34;101;98;199;SEC_401
2009;324;50-64;76;70;146;SEC_324
2009;409;18-24;33;33;66;SEC_409
2009;247;00-02;24;23;47;SEC_247
2009;235;12-15;25;29;54;SEC_235
2009;502;65-74;78;82;160;SEC_502
2009;512;35-49;122;124;246;SEC_512
2009;246;25-34;134;121;255;SEC_246
2009;535;25-34;55;60;115;SEC_535
2009;538;65-74;71;50;121;SEC_538
2009;219;16-17;14;9;23;SEC_219
2009;414;00-02;23;16;39;SEC_414
2009;213;25-34;96;145;241;SEC_213
2009;442;65-74;29;31;60;SEC_442
2009;307;16-17;6;10;16;SEC_307
2009;609;65-74;55;64;119;SEC_609
2009;536;18-24;35;24;59;SEC_536
2009;212;03-11;64;63;127;SEC_212
2009;214;18-24;38;45;83;SEC_214
2009;112;75 i +;64;34;98;SEC_112
2009;411;65-74;60;61;121;SEC_411
2009;410;18-24;57;54;111;SEC_410
2009;606;03-11;49;49;98;SEC_606
2009;232;18-24;43;44;87;SEC_232
2009;113;50-64;216;186;402;SEC_113
2009;313;35-49;226;213;439;SEC_313
2009;102;00-02;14;11;25;SEC_102
2009;602;00-02;7;6;13;SEC_602
2009;410;12-15;20;31;51;SEC_410
2009;607;50-64;85;78;163;SEC_607
2009;245;18-24;47;44;91;SEC_245
2009;432;16-17;13;15;28;SEC_432
2009;415;50-64;56;47;103;SEC_415
2009;306;03-11;63;55;118;SEC_306
2009;526;35-49;77;100;177;SEC_526
2009;413;18-24;26;33;59;SEC_413
2009;232;75 i +;74;40;114;SEC_232
2009;236;35-49;137;135;272;SEC_236
2009;223;12-15;24;21;45;SEC_223
2009;104;12-15;16;13;29;SEC_104
2009;130;50-64;64;61;125;SEC_130
2009;302;18-24;45;34;79;SEC_302
2009;135;35-49;178;171;349;SEC_135
2009;322;18-24;38;48;86;SEC_322
2009;227;18-24;15;12;27;SEC_227
2009;406;16-17;15;15;30;SEC_406
2009;318;12-15;13;17;30;SEC_318
2009;442;03-11;29;27;56;SEC_442
2009;140;00-02;11;19;30;SEC_140
2009;101;50-64;135;129;264;SEC_101
2009;137;03-11;79;58;137;SEC_137
2009;307;35-49;134;113;247;SEC_307
2009;312;16-17;21;12;33;SEC_312
2009;631;12-15;16;14;30;SEC_631
2009;312;00-02;25;33;58;SEC_312
2009;440;65-74;87;86;173;SEC_440
2009;522;75 i +;38;24;62;SEC_522
2009;138;50-64;101;89;190;SEC_138
2009;223;18-24;50;50;100;SEC_223
2009;110;65-74;64;73;137;SEC_110
2009;607;00-02;15;15;30;SEC_607
2009;607;25-34;68;98;166;SEC_607
2009;516;16-17;9;8;17;SEC_516
2009;238;00-02;18;12;30;SEC_238
2009;127;65-74;38;34;72;SEC_127
2009;402;50-64;61;62;123;SEC_402
2009;535;50-64;137;108;245;SEC_535
2009;529;16-17;18;18;36;SEC_529
2009;436;50-64;48;66;114;SEC_436
2009;403;35-49;114;127;241;SEC_403
2009;620;03-11;17;25;42;SEC_620
2009;202;35-49;87;111;198;SEC_202
2009;128;00-02;14;14;28;SEC_128
2009;609;50-64;101;60;161;SEC_609
2009;422;35-49;132;150;282;SEC_422
2009;206;25-34;80;121;201;SEC_206
2009;629;65-74;36;34;70;SEC_629
2009;528;65-74;60;58;118;SEC_528
2009;416;12-15;14;11;25;SEC_416
2009;534;50-64;86;77;163;SEC_534
2009;127;50-64;70;71;141;SEC_127
2009;105;12-15;12;16;28;SEC_105
2009;201;03-11;35;43;78;SEC_201
2009;305;65-74;50;51;101;SEC_305
2009;214;12-15;21;12;33;SEC_214
2009;211;18-24;55;59;114;SEC_211
2009;530;16-17;13;12;25;SEC_530
2009;104;03-11;37;40;77;SEC_104
2009;417;25-34;78;63;141;SEC_417
2009;427;75 i +;55;33;88;SEC_427
2009;208;03-11;50;54;104;SEC_208
2009;222;35-49;130;148;278;SEC_222
2009;615;00-02;12;13;25;SEC_615
2009;514;00-02;14;16;30;SEC_514
2009;528;16-17;9;12;21;SEC_528
2009;604;12-15;15;15;30;SEC_604
2009;615;12-15;10;19;29;SEC_615
2009;632;25-34;66;74;140;SEC_632
2009;103;75 i +;40;27;67;SEC_103
2009;622;75 i +;38;10;48;SEC_622
2009;221;18-24;47;49;96;SEC_221
2009;431;75 i +;83;39;122;SEC_431
2009;410;00-02;20;17;37;SEC_410
2009;411;03-11;30;30;60;SEC_411
2009;302;25-34;128;143;271;SEC_302
2009;522;12-15;10;22;32;SEC_522
2009;245;12-15;12;26;38;SEC_245
2009;241;75 i +;76;26;102;SEC_241
2009;216;00-02;16;15;31;SEC_216
2009;422;16-17;10;17;27;SEC_422
2009;240;75 i +;61;33;94;SEC_240
2009;629;12-15;5;8;13;SEC_629
2009;502;50-64;146;136;282;SEC_502
2009;501;03-11;41;47;88;SEC_501
2009;429;50-64;63;58;121;SEC_429
2009;203;75 i +;50;27;77;SEC_203
2009;139;00-02;13;13;26;SEC_139
2009;135;12-15;29;18;47;SEC_135
2009;525;18-24;39;38;77;SEC_525
2009;622;00-02;6;13;19;SEC_622
2009;505;03-11;29;35;64;SEC_505
2009;106;18-24;72;73;145;SEC_106
2009;213;35-49;126;131;257;SEC_213
2009;108;25-34;120;114;234;SEC_108
2009;424;12-15;6;14;20;SEC_424
2009;245;75 i +;79;38;117;SEC_245
2009;628;25-34;65;78;143;SEC_628
2009;408;03-11;33;39;72;SEC_408
2009;206;18-24;38;33;71;SEC_206
2009;406;03-11;41;59;100;SEC_406
2009;404;00-02;31;30;61;SEC_404
2009;222;00-02;21;16;37;SEC_222
2009;308;18-24;66;72;138;SEC_308
2009;438;25-34;74;89;163;SEC_438
2009;249;18-24;48;54;102;SEC_249
2009;523;00-02;19;31;50;SEC_523
2009;235;65-74;84;58;142;SEC_235
2009;537;25-34;96;116;212;SEC_537
2009;114;25-34;124;120;244;SEC_114
2009;304;75 i +;100;53;153;SEC_304
2009;407;12-15;12;14;26;SEC_407
2009;321;50-64;309;284;593;SEC_321
2009;611;25-34;144;165;309;SEC_611
2009;442;00-02;11;8;19;SEC_442
2009;103;50-64;69;60;129;SEC_103
2009;618;25-34;33;37;70;SEC_618
2009;418;16-17;11;12;23;SEC_418
2009;403;03-11;39;30;69;SEC_403
2009;249;12-15;18;22;40;SEC_249
2009;533;00-02;25;16;41;SEC_533
2009;319;03-11;107;97;204;SEC_319
2009;228;12-15;10;13;23;SEC_228
2009;520;50-64;79;62;141;SEC_520
2009;240;12-15;13;14;27;SEC_240
2009;203;25-34;90;113;203;SEC_203
2009;112;50-64;177;175;352;SEC_112
2009;130;65-74;74;51;125;SEC_130
2009;246;03-11;42;53;95;SEC_246
2009;240;16-17;7;8;15;SEC_240
2009;437;16-17;12;20;32;SEC_437
2009;229;00-02;14;12;26;SEC_229
2009;129;25-34;105;97;202;SEC_129
2009;134;00-02;16;22;38;SEC_134
2009;204;03-11;19;16;35;SEC_204
2009;201;50-64;63;40;103;SEC_201
2009;434;75 i +;57;29;86;SEC_434
2009;323;18-24;115;101;216;SEC_323
2009;216;35-49;136;147;283;SEC_216
2009;403;65-74;83;82;165;SEC_403
2009;613;50-64;122;72;194;SEC_613
2009;406;12-15;24;28;52;SEC_406
2009;235;16-17;12;8;20;SEC_235
2009;618;18-24;19;20;39;SEC_618
2009;434;65-74;28;11;39;SEC_434
2009;111;25-34;65;54;119;SEC_111
2009;613;03-11;43;47;90;SEC_613
2009;244;16-17;8;7;15;SEC_244
2009;240;25-34;73;73;146;SEC_240
2009;604;03-11;29;41;70;SEC_604
2009;120;75 i +;63;26;89;SEC_120
2009;104;50-64;80;56;136;SEC_104
2009;136;12-15;20;19;39;SEC_136
2009;237;12-15;32;21;53;SEC_237
2009;405;00-02;15;12;27;SEC_405
2009;522;25-34;82;111;193;SEC_522
2009;601;65-74;100;93;193;SEC_601
2009;615;65-74;82;81;163;SEC_615
2009;119;65-74;74;71;145;SEC_119
2009;201;00-02;16;24;40;SEC_201
2009;625;16-17;5;10;15;SEC_625
2009;531;65-74;50;43;93;SEC_531
2009;438;50-64;62;67;129;SEC_438
2009;133;00-02;13;11;24;SEC_133
2009;223;25-34;110;118;228;SEC_223
2009;320;00-02;20;18;38;SEC_320
2009;203;12-15;12;8;20;SEC_203
2009;625;12-15;14;12;26;SEC_625
2009;130;00-02;16;15;31;SEC_130
2009;138;16-17;6;8;14;SEC_138
2009;239;16-17;9;10;19;SEC_239
2009;513;18-24;27;21;48;SEC_513
2009;531;50-64;86;77;163;SEC_531
2009;441;00-02;22;19;41;SEC_441
2009;518;75 i +;67;49;116;SEC_518
2009;605;35-49;70;81;151;SEC_605
2009;304;25-34;201;204;405;SEC_304
2009;426;25-34;100;143;243;SEC_426
2009;521;65-74;72;89;161;SEC_521
2009;628;18-24;33;34;67;SEC_628
2009;212;75 i +;67;49;116;SEC_212
2009;208;35-49;154;171;325;SEC_208
2009;201;18-24;25;36;61;SEC_201
2009;419;12-15;17;20;37;SEC_419
2009;532;18-24;63;55;118;SEC_532
2009;230;65-74;37;29;66;SEC_230
2009;305;12-15;34;30;64;SEC_305
2009;247;16-17;15;10;25;SEC_247
2009;121;00-02;12;16;28;SEC_121
2009;114;35-49;170;179;349;SEC_114
2009;441;50-64;252;219;471;SEC_441
2009;408;65-74;51;31;82;SEC_408
2009;432;03-11;46;37;83;SEC_432
2009;232;16-17;10;6;16;SEC_232
2009;628;12-15;18;14;32;SEC_628
2009;529;03-11;52;62;114;SEC_529
2009;411;75 i +;95;60;155;SEC_411
2009;524;35-49;167;183;350;SEC_524
2009;521;16-17;5;4;9;SEC_521
2009;416;03-11;35;42;77;SEC_416
2009;506;00-02;10;25;35;SEC_506
2009;116;00-02;18;24;42;SEC_116
2009;134;12-15;24;27;51;SEC_134
2009;314;35-49;282;283;565;SEC_314
2009;422;03-11;43;47;90;SEC_422
2009;514;16-17;7;6;13;SEC_514
2009;115;03-11;39;44;83;SEC_115
2009;528;00-02;25;23;48;SEC_528
2009;624;65-74;72;73;145;SEC_624
2009;249;75 i +;74;49;123;SEC_249
2009;433;00-02;30;24;54;SEC_433
2009;114;03-11;56;59;115;SEC_114
2009;223;50-64;101;91;192;SEC_223
2009;118;50-64;208;197;405;SEC_118
2009;240;50-64;61;35;96;SEC_240
2009;215;65-74;45;26;71;SEC_215
2009;321;18-24;88;92;180;SEC_321
2009;309;00-02;25;19;44;SEC_309
2009;238;18-24;32;40;72;SEC_238
2009;603;12-15;13;11;24;SEC_603
2009;529;12-15;22;20;42;SEC_529
2009;140;16-17;3;7;10;SEC_140
2009;515;25-34;61;77;138;SEC_515
2009;405;65-74;76;57;133;SEC_405
2009;102;50-64;171;148;319;SEC_102
2009;232;03-11;28;39;67;SEC_232
2009;530;65-74;78;67;145;SEC_530
2009;106;03-11;71;73;144;SEC_106
2009;436;25-34;110;139;249;SEC_436
2009;223;35-49;141;160;301;SEC_223
2009;504;35-49;103;117;220;SEC_504
2009;430;50-64;63;53;116;SEC_430
2009;220;65-74;41;23;64;SEC_220
2009;617;18-24;37;33;70;SEC_617
2009;229;03-11;31;23;54;SEC_229
2009;239;03-11;46;53;99;SEC_239
2009;509;75 i +;32;20;52;SEC_509
2009;226;00-02;19;16;35;SEC_226
2009;442;50-64;51;51;102;SEC_442
2009;403;18-24;43;48;91;SEC_403
2009;441;12-15;36;28;64;SEC_441
2009;316;16-17;22;26;48;SEC_316
2009;129;03-11;47;64;111;SEC_129
2009;504;12-15;10;18;28;SEC_504
2009;505;35-49;124;115;239;SEC_505
2009;239;50-64;82;77;159;SEC_239
2009;611;00-02;29;37;66;SEC_611
2009;627;75 i +;41;27;68;SEC_627
2009;408;50-64;81;78;159;SEC_408
2009;538;12-15;17;25;42;SEC_538
2009;432;18-24;46;57;103;SEC_432
2009;311;25-34;106;146;252;SEC_311
2009;230;03-11;41;34;75;SEC_230
2009;122;75 i +;47;29;76;SEC_122
2009;310;50-64;87;100;187;SEC_310
2009;429;00-02;8;5;13;SEC_429
2009;435;16-17;6;10;16;SEC_435
2009;420;18-24;63;70;133;SEC_420
2009;622;12-15;11;18;29;SEC_622
2009;423;75 i +;68;45;113;SEC_423
2009;601;18-24;44;52;96;SEC_601
2009;504;03-11;40;31;71;SEC_504
2009;310;25-34;97;98;195;SEC_310
2009;428;75 i +;36;24;60;SEC_428
2009;102;12-15;23;28;51;SEC_102
2009;409;03-11;29;22;51;SEC_409
2009;217;65-74;21;14;35;SEC_217
2009;222;75 i +;38;24;62;SEC_222
2009;607;35-49;140;133;273;SEC_607
2009;219;75 i +;91;52;143;SEC_219
2009;617;75 i +;43;31;74;SEC_617
2009;429;35-49;57;78;135;SEC_429
2009;608;25-34;56;57;113;SEC_608
2009;621;50-64;193;171;364;SEC_621
2009;513;12-15;16;11;27;SEC_513
2009;411;00-02;10;13;23;SEC_411
2009;106;16-17;16;16;32;SEC_106
2009;409;16-17;6;8;14;SEC_409
2009;321;00-02;19;18;37;SEC_321
2009;510;65-74;57;57;114;SEC_510
2009;217;00-02;19;12;31;SEC_217
2009;249;65-74;63;29;92;SEC_249
2009;108;16-17;10;14;24;SEC_108
2009;430;00-02;16;25;41;SEC_430
2009;508;75 i +;37;23;60;SEC_508
2009;502;25-34;147;161;308;SEC_502
2009;218;18-24;31;48;79;SEC_218
2009;134;50-64;125;110;235;SEC_134
2009;433;12-15;27;22;49;SEC_433
2009;513;00-02;15;10;25;SEC_513
2009;133;65-74;45;37;82;SEC_133
2009;424;75 i +;24;27;51;SEC_424
2009;318;65-74;35;26;61;SEC_318
2009;533;35-49;119;149;268;SEC_533
2009;207;50-64;68;60;128;SEC_207
2009;534;00-02;10;14;24;SEC_534
2009;526;00-02;13;8;21;SEC_526
2009;229;65-74;43;29;72;SEC_229
2009;205;65-74;49;42;91;SEC_205
2009;115;00-02;15;25;40;SEC_115
2009;313;50-64;226;182;408;SEC_313
2009;521;03-11;25;32;57;SEC_521
2009;305;03-11;72;52;124;SEC_305
2009;430;03-11;40;53;93;SEC_430
2009;108;75 i +;114;72;186;SEC_108
2009;107;18-24;59;67;126;SEC_107
2009;615;03-11;36;22;58;SEC_615
2009;208;65-74;132;95;227;SEC_208
2009;309;75 i +;39;22;61;SEC_309
2009;325;16-17;19;17;36;SEC_325
2009;617;25-34;68;82;150;SEC_617
2009;430;12-15;22;22;44;SEC_430
2009;233;03-11;26;43;69;SEC_233
2009;204;12-15;12;10;22;SEC_204
2009;243;03-11;63;76;139;SEC_243
2009;305;16-17;23;15;38;SEC_305
2009;537;50-64;124;97;221;SEC_537
2009;528;18-24;54;42;96;SEC_528
2009;314;50-64;253;258;511;SEC_314
2009;241;18-24;41;41;82;SEC_241
2009;217;18-24;28;38;66;SEC_217
2009;314;00-02;30;40;70;SEC_314
2009;412;75 i +;87;76;163;SEC_412
2009;247;65-74;65;53;118;SEC_247
2009;406;18-24;70;53;123;SEC_406
2009;509;03-11;40;36;76;SEC_509
2009;603;50-64;58;42;100;SEC_603
2009;441;25-34;151;154;305;SEC_441
2009;607;12-15;18;15;33;SEC_607
2009;403;25-34;98;111;209;SEC_403
2009;511;18-24;18;30;48;SEC_511
2009;537;65-74;74;72;146;SEC_537
2009;537;03-11;46;35;81;SEC_537
2009;322;03-11;60;59;119;SEC_322
2009;437;00-02;15;17;32;SEC_437
2009;117;00-02;22;19;41;SEC_117
2009;204;75 i +;40;19;59;SEC_204
2009;235;75 i +;81;55;136;SEC_235
2009;234;65-74;47;33;80;SEC_234
2009;113;12-15;19;30;49;SEC_113
2009;505;16-17;8;6;14;SEC_505
2009;613;25-34;80;105;185;SEC_613
2009;503;75 i +;34;18;52;SEC_503
2009;404;50-64;103;94;197;SEC_404
2009;310;00-02;13;14;27;SEC_310
2009;515;35-49;79;109;188;SEC_515
2009;310;35-49;112;119;231;SEC_310
2009;226;16-17;10;6;16;SEC_226
2009;319;12-15;26;27;53;SEC_319
2009;611;03-11;76;83;159;SEC_611
2009;139;25-34;81;114;195;SEC_139
2009;605;00-02;8;13;21;SEC_605
2009;104;65-74;53;37;90;SEC_104
2009;407;50-64;80;72;152;SEC_407
2009;120;03-11;63;93;156;SEC_120
2009;423;12-15;10;17;27;SEC_423
2009;309;50-64;82;74;156;SEC_309
2009;604;50-64;60;51;111;SEC_604
2009;417;35-49;92;85;177;SEC_417
2009;426;00-02;12;16;28;SEC_426
2009;604;16-17;4;7;11;SEC_604
2009;426;50-64;70;67;137;SEC_426
2009;223;16-17;16;14;30;SEC_223
2009;425;50-64;77;72;149;SEC_425
2009;419;16-17;8;9;17;SEC_419
2009;609;12-15;12;18;30;SEC_609
2009;228;35-49;91;102;193;SEC_228
2009;131;25-34;115;142;257;SEC_131
2009;216;12-15;27;19;46;SEC_216
2009;213;12-15;17;16;33;SEC_213
2009;608;18-24;22;35;57;SEC_608
2009;228;25-34;78;109;187;SEC_228
2009;301;25-34;220;214;434;SEC_301
2009;436;00-02;24;22;46;SEC_436
2009;403;75 i +;81;51;132;SEC_403
2009;133;75 i +;56;40;96;SEC_133
2009;536;25-34;70;82;152;SEC_536
2009;230;35-49;117;157;274;SEC_230
2009;130;16-17;6;7;13;SEC_130
2009;133;25-34;82;88;170;SEC_133
2009;421;16-17;8;12;20;SEC_421
2009;514;50-64;57;53;110;SEC_514
2009;505;50-64;157;106;263;SEC_505
2009;315;25-34;152;170;322;SEC_315
2009;113;00-02;24;29;53;SEC_113
2009;117;16-17;17;17;34;SEC_117
2009;210;16-17;6;1;7;SEC_210
2009;503;25-34;83;76;159;SEC_503
2009;220;35-49;124;135;259;SEC_220
2009;432;00-02;17;24;41;SEC_432
2009;130;35-49;139;142;281;SEC_130
2009;111;12-15;11;16;27;SEC_111
2009;242;12-15;17;12;29;SEC_242
2009;428;00-02;15;13;28;SEC_428
2009;109;65-74;49;48;97;SEC_109
2009;245;35-49;139;156;295;SEC_245
2009;435;00-02;19;24;43;SEC_435
2009;238;16-17;6;7;13;SEC_238
2009;420;25-34;151;185;336;SEC_420
2009;530;50-64;91;82;173;SEC_530
2009;602;18-24;15;18;33;SEC_602
2009;606;18-24;45;56;101;SEC_606
2009;517;18-24;50;64;114;SEC_517
2009;529;25-34;127;115;242;SEC_529
2009;320;75 i +;36;13;49;SEC_320
2009;520;18-24;39;48;87;SEC_520
2009;135;03-11;50;63;113;SEC_135
2009;523;35-49;190;192;382;SEC_523
2009;514;12-15;17;13;30;SEC_514
2009;323;65-74;79;93;172;SEC_323
2009;119;12-15;13;17;30;SEC_119
2009;404;12-15;28;33;61;SEC_404
2009;434;00-02;7;15;22;SEC_434
2009;103;16-17;8;5;13;SEC_103
2009;134;16-17;7;7;14;SEC_134
2009;509;00-02;26;24;50;SEC_509
2009;621;03-11;42;64;106;SEC_621
2009;225;00-02;15;9;24;SEC_225
2009;410;50-64;161;147;308;SEC_410
2009;307;12-15;14;18;32;SEC_307
2009;242;75 i +;86;51;137;SEC_242
2009;119;18-24;45;43;88;SEC_119
2009;246;50-64;76;71;147;SEC_246
2009;133;03-11;46;38;84;SEC_133
2009;225;75 i +;49;20;69;SEC_225
2009;531;03-11;31;39;70;SEC_531
2009;124;00-02;15;9;24;SEC_124
2009;218;75 i +;40;20;60;SEC_218
2009;302;50-64;170;149;319;SEC_302
2009;603;00-02;15;9;24;SEC_603
2009;626;50-64;94;87;181;SEC_626
2009;309;18-24;33;33;66;SEC_309
2009;322;12-15;24;26;50;SEC_322
2009;107;03-11;60;66;126;SEC_107
2009;302;35-49;127;159;286;SEC_302
2009;138;35-49;92;68;160;SEC_138
2009;224;03-11;18;27;45;SEC_224
2009;507;50-64;86;65;151;SEC_507
2009;210;65-74;56;42;98;SEC_210
2009;235;50-64;112;99;211;SEC_235
2009;101;65-74;58;46;104;SEC_101
2009;511;03-11;30;29;59;SEC_511
2009;438;18-24;31;34;65;SEC_438
2009;235;25-34;160;174;334;SEC_235
2009;229;75 i +;52;39;91;SEC_229
2009;520;75 i +;52;39;91;SEC_520
2009;205;50-64;94;83;177;SEC_205
2009;219;03-11;49;53;102;SEC_219
2009;611;16-17;22;16;38;SEC_611
2009;625;03-11;33;42;75;SEC_625
2009;234;12-15;19;18;37;SEC_234
2009;514;35-49;101;116;217;SEC_514
2009;244;00-02;12;14;26;SEC_244
2009;606;12-15;18;23;41;SEC_606
2009;306;16-17;22;9;31;SEC_306
2009;126;25-34;84;65;149;SEC_126
2009;242;65-74;67;65;132;SEC_242
2009;521;75 i +;50;36;86;SEC_521
2009;140;35-49;115;144;259;SEC_140
2009;517;65-74;53;49;102;SEC_517
2009;616;03-11;113;136;249;SEC_616
2009;133;16-17;2;6;8;SEC_133
2009;426;65-74;42;40;82;SEC_426
2009;515;18-24;25;45;70;SEC_515
2009;431;16-17;13;13;26;SEC_431
2009;526;03-11;23;27;50;SEC_526
2009;101;75 i +;45;39;84;SEC_101
2009;140;25-34;95;119;214;SEC_140
2009;242;00-02;9;18;27;SEC_242
2009;502;75 i +;133;59;192;SEC_502
2009;508;25-34;73;60;133;SEC_508
2009;538;18-24;48;47;95;SEC_538
2009;502;35-49;164;201;365;SEC_502
2009;221;25-34;86;105;191;SEC_221
2009;421;03-11;50;34;84;SEC_421
2009;613;65-74;102;119;221;SEC_613
2009;244;03-11;23;23;46;SEC_244
2009;245;00-02;10;17;27;SEC_245
2009;113;25-34;153;155;308;SEC_113
2009;203;03-11;26;50;76;SEC_203
2009;627;18-24;35;47;82;SEC_627
2009;613;18-24;37;34;71;SEC_613
2009;306;75 i +;102;70;172;SEC_306
2009;418;18-24;48;63;111;SEC_418
2009;205;75 i +;80;48;128;SEC_205
2009;325;12-15;28;26;54;SEC_325
2009;237;25-34;132;154;286;SEC_237
2009;246;16-17;11;4;15;SEC_246
2009;243;12-15;24;24;48;SEC_243
2009;613;16-17;8;15;23;SEC_613
2009;614;75 i +;49;32;81;SEC_614
2009;138;00-02;9;11;20;SEC_138
2009;613;75 i +;69;40;109;SEC_613
2009;325;50-64;203;168;371;SEC_325
2009;519;18-24;27;31;58;SEC_519
2009;321;03-11;95;92;187;SEC_321
2009;223;65-74;64;48;112;SEC_223
2009;430;75 i +;60;31;91;SEC_430
2009;435;65-74;49;34;83;SEC_435
2009;535;03-11;23;33;56;SEC_535
2009;604;25-34;53;78;131;SEC_604
2009;610;50-64;136;79;215;SEC_610
2009;434;03-11;24;24;48;SEC_434
2009;120;25-34;117;130;247;SEC_120
2009;321;12-15;32;35;67;SEC_321
2009;402;35-49;110;103;213;SEC_402
2009;623;75 i +;57;30;87;SEC_623
2009;212;00-02;21;26;47;SEC_212
2009;403;16-17;7;12;19;SEC_403
2009;614;00-02;15;20;35;SEC_614
2009;305;75 i +;101;58;159;SEC_305
2009;140;18-24;29;37;66;SEC_140
2009;324;35-49;137;143;280;SEC_324
2009;405;18-24;23;27;50;SEC_405
2009;518;35-49;146;149;295;SEC_518
2009;439;12-15;19;15;34;SEC_439
2009;611;18-24;59;62;121;SEC_611
2009;408;16-17;7;5;12;SEC_408
2009;517;16-17;15;12;27;SEC_517
2009;225;12-15;5;4;9;SEC_225
2009;507;12-15;8;22;30;SEC_507
2009;228;00-02;14;13;27;SEC_228
2009;235;35-49;205;207;412;SEC_235
2009;241;35-49;107;111;218;SEC_241
2009;105;16-17;8;11;19;SEC_105
2009;215;18-24;47;36;83;SEC_215
2009;126;75 i +;66;31;97;SEC_126
2009;304;50-64;117;122;239;SEC_304
2009;536;50-64;79;58;137;SEC_536
2009;514;75 i +;40;31;71;SEC_514
2009;106;75 i +;66;34;100;SEC_106
2009;416;50-64;53;52;105;SEC_416
2009;427;16-17;7;12;19;SEC_427
2009;419;25-34;92;111;203;SEC_419
2009;301;35-49;327;320;647;SEC_301
2009;103;25-34;67;90;157;SEC_103
2009;105;00-02;24;18;42;SEC_105
2009;243;16-17;14;21;35;SEC_243
2009;232;35-49;117;135;252;SEC_232
2009;110;00-02;16;13;29;SEC_110
2009;318;75 i +;26;14;40;SEC_318
2009;502;16-17;15;7;22;SEC_502
2009;234;35-49;140;138;278;SEC_234
2009;227;03-11;34;21;55;SEC_227
2009;538;16-17;11;7;18;SEC_538
2009;516;75 i +;39;20;59;SEC_516
2009;615;18-24;21;23;44;SEC_615
2009;501;25-34;87;87;174;SEC_501
2009;240;65-74;35;33;68;SEC_240
2009;235;00-02;31;26;57;SEC_235
2009;617;03-11;35;41;76;SEC_617
2009;234;16-17;8;9;17;SEC_234
2009;314;25-34;221;227;448;SEC_314
2009;206;12-15;13;19;32;SEC_206
2009;220;16-17;12;8;20;SEC_220
2009;421;12-15;24;23;47;SEC_421
2009;627;03-11;36;22;58;SEC_627
2009;240;35-49;96;108;204;SEC_240
2009;244;65-74;26;20;46;SEC_244
2009;501;35-49;105;103;208;SEC_501
2009;245;25-34;101;122;223;SEC_245
2009;317;12-15;20;24;44;SEC_317
2009;243;25-34;141;133;274;SEC_243
2009;117;03-11;65;81;146;SEC_117
2009;211;35-49;174;201;375;SEC_211
2009;515;16-17;10;7;17;SEC_515
2009;121;03-11;26;36;62;SEC_121
2009;219;65-74;61;40;101;SEC_219
2009;529;00-02;31;24;55;SEC_529
2009;116;16-17;14;15;29;SEC_116
2009;132;50-64;227;215;442;SEC_132
2009;307;65-74;79;75;154;SEC_307
2009;236;65-74;66;47;113;SEC_236
2009;124;35-49;92;75;167;SEC_124
2009;311;00-02;18;30;48;SEC_311
2009;221;16-17;17;8;25;SEC_221
2009;302;75 i +;61;36;97;SEC_302
2009;310;16-17;6;11;17;SEC_310
2009;202;75 i +;45;30;75;SEC_202
2009;538;75 i +;86;55;141;SEC_538
2009;232;50-64;92;81;173;SEC_232
2009;427;35-49;121;137;258;SEC_427
2009;608;35-49;82;105;187;SEC_608
2009;230;00-02;19;23;42;SEC_230
2009;118;00-02;22;26;48;SEC_118
2009;302;03-11;31;39;70;SEC_302
2009;434;35-49;74;93;167;SEC_434
2009;625;25-34;104;126;230;SEC_625
2009;113;18-24;74;75;149;SEC_113
2009;246;00-02;13;28;41;SEC_246
2009;320;03-11;65;52;117;SEC_320
2009;405;25-34;66;64;130;SEC_405
2009;508;18-24;21;25;46;SEC_508
2009;512;16-17;10;7;17;SEC_512
2009;504;50-64;105;78;183;SEC_504
2009;415;16-17;9;7;16;SEC_415
2009;218;50-64;76;63;139;SEC_218
2009;404;03-11;52;62;114;SEC_404
2009;522;65-74;25;22;47;SEC_522
2009;529;65-74;65;63;128;SEC_529
2009;317;50-64;57;77;134;SEC_317
2009;508;50-64;40;44;84;SEC_508
2009;243;50-64;128;111;239;SEC_243
2009;248;75 i +;64;40;104;SEC_248
2009;609;25-34;56;57;113;SEC_609
2009;132;00-02;31;32;63;SEC_132
2009;424;35-49;66;87;153;SEC_424
2009;616;16-17;37;33;70;SEC_616
2009;120;12-15;37;36;73;SEC_120
2009;609;75 i +;32;29;61;SEC_609
2009;503;12-15;7;16;23;SEC_503
2009;309;35-49;118;125;243;SEC_309
2009;605;18-24;17;10;27;SEC_605
2009;530;18-24;57;50;107;SEC_530
2009;425;35-49;115;144;259;SEC_425
2009;612;25-34;67;81;148;SEC_612
2009;610;00-02;8;12;20;SEC_610
2009;513;35-49;97;100;197;SEC_513
2009;440;18-24;25;35;60;SEC_440
2009;307;75 i +;82;60;142;SEC_307
2009;107;75 i +;89;47;136;SEC_107
2009;110;75 i +;66;32;98;SEC_110
2009;245;16-17;9;12;21;SEC_245
2009;501;12-15;13;21;34;SEC_501
2009;310;12-15;14;11;25;SEC_310
2009;227;65-74;37;36;73;SEC_227
2009;213;18-24;52;50;102;SEC_213
2009;206;50-64;75;68;143;SEC_206
2009;205;18-24;29;43;72;SEC_205
2009;621;16-17;13;8;21;SEC_621
2009;132;12-15;28;44;72;SEC_132
2009;234;03-11;32;40;72;SEC_234
2009;319;65-74;39;43;82;SEC_319
2009;110;16-17;10;8;18;SEC_110
2009;218;16-17;10;7;17;SEC_218
2009;428;16-17;5;7;12;SEC_428
2009;120;50-64;189;191;380;SEC_120
2009;106;35-49;183;188;371;SEC_106
2009;514;03-11;40;37;77;SEC_514
2009;308;35-49;275;256;531;SEC_308
2009;136;18-24;44;31;75;SEC_136
2009;311;75 i +;100;57;157;SEC_311
2009;507;75 i +;42;22;64;SEC_507
2009;304;18-24;69;62;131;SEC_304
2009;210;50-64;82;84;166;SEC_210
2009;620;00-02;4;4;8;SEC_620
2009;215;12-15;17;13;30;SEC_215
2009;630;00-02;9;13;22;SEC_630
2009;218;35-49;87;93;180;SEC_218
2009;302;65-74;67;65;132;SEC_302
2009;232;65-74;51;53;104;SEC_232
2009;432;75 i +;66;51;117;SEC_432
2009;610;16-17;5;12;17;SEC_610
2009;101;25-34;140;124;264;SEC_101
2009;408;35-49;115;118;233;SEC_408
2009;115;75 i +;74;42;116;SEC_115
2009;308;12-15;35;42;77;SEC_308
2009;126;00-02;10;13;23;SEC_126
2009;627;25-34;83;81;164;SEC_627
2009;621;25-34;120;148;268;SEC_621
2009;222;12-15;20;14;34;SEC_222
2009;311;03-11;61;71;132;SEC_311
2009;130;03-11;48;37;85;SEC_130
2009;504;65-74;94;90;184;SEC_504
2009;404;18-24;62;70;132;SEC_404
2009;421;35-49;155;177;332;SEC_421
2009;221;12-15;23;19;42;SEC_221
2009;316;12-15;35;38;73;SEC_316
2009;236;25-34;93;95;188;SEC_236
2009;438;00-02;15;13;28;SEC_438
2009;616;18-24;110;136;246;SEC_616
2009;525;00-02;23;16;39;SEC_525
2009;309;65-74;35;28;63;SEC_309
2009;402;16-17;8;7;15;SEC_402
2009;610;35-49;139;145;284;SEC_610
2009;425;03-11;29;39;68;SEC_425
2009;610;12-15;17;25;42;SEC_610
2009;518;50-64;86;60;146;SEC_518
2009;301;75 i +;120;71;191;SEC_301
2009;311;16-17;10;13;23;SEC_311
2009;211;16-17;8;14;22;SEC_211
2009;242;35-49;118;148;266;SEC_242
2009;208;25-34;128;139;267;SEC_208
2009;227;12-15;11;17;28;SEC_227
2009;222;18-24;42;55;97;SEC_222
2009;611;75 i +;80;51;131;SEC_611
2009;610;25-34;80;90;170;SEC_610
2009;315;00-02;35;22;57;SEC_315
2009;421;00-02;8;20;28;SEC_421
2009;312;50-64;151;146;297;SEC_312
2009;103;18-24;23;20;43;SEC_103
2009;124;65-74;30;34;64;SEC_124
2009;414;18-24;37;30;67;SEC_414
2009;216;16-17;14;13;27;SEC_216
2009;230;25-34;112;114;226;SEC_230
2009;630;18-24;29;35;64;SEC_630
2009;301;12-15;34;41;75;SEC_301
2009;131;03-11;44;46;90;SEC_131
2009;323;50-64;391;347;738;SEC_323
2009;238;03-11;34;33;67;SEC_238
2009;413;03-11;15;24;39;SEC_413
2009;520;65-74;49;46;95;SEC_520
2009;530;12-15;18;24;42;SEC_530
2009;135;65-74;79;66;145;SEC_135
2009;126;16-17;8;3;11;SEC_126
2009;113;65-74;55;56;111;SEC_113
2009;118;35-49;187;181;368;SEC_118
2009;313;65-74;78;75;153;SEC_313
2009;622;18-24;30;33;63;SEC_622
2009;231;03-11;56;59;115;SEC_231
2009;109;18-24;45;30;75;SEC_109
2009;140;50-64;85;74;159;SEC_140
2009;607;65-74;103;92;195;SEC_607
2009;228;50-64;42;43;85;SEC_228
2009;440;03-11;41;34;75;SEC_440
2009;304;00-02;35;43;78;SEC_304
2009;225;35-49;51;53;104;SEC_225
2009;132;65-74;108;87;195;SEC_132
2009;310;65-74;42;28;70;SEC_310
2009;316;50-64;376;361;737;SEC_316
2009;303;18-24;45;41;86;SEC_303
2009;535;35-49;93;100;193;SEC_535
2009;429;12-15;14;10;24;SEC_429
2009;122;03-11;35;43;78;SEC_122
2009;134;35-49;167;169;336;SEC_134
2009;418;75 i +;69;48;117;SEC_418
2009;527;12-15;25;13;38;SEC_527
2009;527;16-17;10;7;17;SEC_527
2009;103;00-02;10;6;16;SEC_103
2009;104;16-17;9;7;16;SEC_104
2009;209;03-11;33;39;72;SEC_209
2009;110;25-34;97;111;208;SEC_110
2009;414;12-15;17;16;33;SEC_414
2009;435;03-11;52;46;98;SEC_435
2009;507;35-49;108;123;231;SEC_507
2009;116;25-34;109;120;229;SEC_116
2009;207;75 i +;69;24;93;SEC_207
2009;233;00-02;25;14;39;SEC_233
2009;632;35-49;104;109;213;SEC_632
2009;421;50-64;89;71;160;SEC_421
2009;204;16-17;7;7;14;SEC_204
2009;613;00-02;19;19;38;SEC_613
2009;513;65-74;54;42;96;SEC_513
2009;414;03-11;41;41;82;SEC_414
2009;434;50-64;55;55;110;SEC_434
2009;527;00-02;19;23;42;SEC_527
2009;226;12-15;16;18;34;SEC_226
2009;113;16-17;9;12;21;SEC_113
2009;537;00-02;16;10;26;SEC_537
2009;429;18-24;26;37;63;SEC_429
2009;441;18-24;94;96;190;SEC_441
2009;137;75 i +;54;31;85;SEC_137
2009;413;65-74;21;23;44;SEC_413
2009;131;00-02;17;19;36;SEC_131
2009;410;16-17;15;19;34;SEC_410
2009;313;16-17;21;12;33;SEC_313
2009;521;25-34;64;72;136;SEC_521
2009;125;18-24;69;59;128;SEC_125
2009;538;35-49;146;149;295;SEC_538
2009;214;75 i +;31;24;55;SEC_214
2009;439;18-24;44;57;101;SEC_439
2009;531;18-24;46;48;94;SEC_531
2009;412;35-49;162;192;354;SEC_412
2009;420;75 i +;79;46;125;SEC_420
2009;502;03-11;43;77;120;SEC_502
2009;518;12-15;18;24;42;SEC_518
2009;615;16-17;5;4;9;SEC_615
2009;427;25-34;107;112;219;SEC_427
2009;117;65-74;80;83;163;SEC_117
2009;516;35-49;105;107;212;SEC_516
2009;312;03-11;52;56;108;SEC_312
2009;413;16-17;13;6;19;SEC_413
2009;315;16-17;12;14;26;SEC_315
2009;532;50-64;109;83;192;SEC_532
2009;524;00-02;28;27;55;SEC_524
2009;414;35-49;113;134;247;SEC_414
2009;426;16-17;14;14;28;SEC_426
2009;510;12-15;15;21;36;SEC_510
2009;249;16-17;6;11;17;SEC_249
2009;409;50-64;58;54;112;SEC_409
2009;517;50-64;89;79;168;SEC_517
2009;511;12-15;11;16;27;SEC_511
2009;526;50-64;54;50;104;SEC_526
2009;303;25-34;149;151;300;SEC_303
2009;120;35-49;231;228;459;SEC_120
2009;520;25-34;69;72;141;SEC_520
2009;438;65-74;62;49;111;SEC_438
2009;624;75 i +;43;29;72;SEC_624
2009;206;03-11;37;40;77;SEC_206
2009;322;75 i +;64;41;105;SEC_322
2009;114;18-24;39;39;78;SEC_114
2009;106;25-34;183;178;361;SEC_106
2009;423;35-49;105;124;229;SEC_423
2009;437;18-24;43;40;83;SEC_437
2009;116;75 i +;71;44;115;SEC_116
2009;421;65-74;79;64;143;SEC_421
2009;102;65-74;105;107;212;SEC_102
2009;425;00-02;20;16;36;SEC_425
2009;220;25-34;78;111;189;SEC_220
2009;413;35-49;67;105;172;SEC_413
2009;631;35-49;110;119;229;SEC_631
2009;206;35-49;111;125;236;SEC_206
2009;301;03-11;117;110;227;SEC_301
2009;121;35-49;116;112;228;SEC_121
2009;108;03-11;52;53;105;SEC_108
2009;234;25-34;104;106;210;SEC_234
2009;239;18-24;44;49;93;SEC_239
2009;203;35-49;106;117;223;SEC_203
2009;123;25-34;105;93;198;SEC_123
2009;137;16-17;19;13;32;SEC_137
2009;131;50-64;187;177;364;SEC_131
2009;624;00-02;17;20;37;SEC_624
2009;406;50-64;122;118;240;SEC_406
2009;630;03-11;31;29;60;SEC_630
2009;248;35-49;179;173;352;SEC_248
2009;215;35-49;133;127;260;SEC_215
2009;243;18-24;72;66;138;SEC_243
2009;205;35-49;108;106;214;SEC_205
2009;506;75 i +;86;68;154;SEC_506
2009;236;00-02;13;18;31;SEC_236
2009;215;16-17;11;8;19;SEC_215
2009;409;75 i +;29;23;52;SEC_409
2009;629;03-11;29;14;43;SEC_629
2009;421;25-34;91;116;207;SEC_421
2009;132;35-49;215;267;482;SEC_132
2009;314;03-11;81;93;174;SEC_314
2009;104;18-24;17;21;38;SEC_104
2009;510;16-17;5;10;15;SEC_510
2009;139;03-11;33;45;78;SEC_139
2009;422;65-74;50;41;91;SEC_422
2009;518;03-11;56;43;99;SEC_518
2009;410;03-11;59;84;143;SEC_410
2009;526;65-74;29;31;60;SEC_526
2009;129;65-74;63;69;132;SEC_129
2009;117;35-49;210;207;417;SEC_117
2009;312;12-15;24;26;50;SEC_312
2009;532;00-02;22;24;46;SEC_532
2009;508;00-02;9;10;19;SEC_508
2009;215;75 i +;65;30;95;SEC_215
2009;436;03-11;45;53;98;SEC_436
2009;313;25-34;176;165;341;SEC_313
2009;406;35-49;141;151;292;SEC_406
2009;120;18-24;77;83;160;SEC_120
2009;225;16-17;1;1;2;SEC_225
2009;607;16-17;10;15;25;SEC_607
2009;208;12-15;20;26;46;SEC_208
2009;620;65-74;55;52;107;SEC_620
2009;626;75 i +;49;43;92;SEC_626
2009;622;03-11;26;38;64;SEC_622
2009;126;50-64;108;83;191;SEC_126
2009;401;03-11;52;62;114;SEC_401
2009;433;35-49;140;186;326;SEC_433
2009;207;16-17;2;5;7;SEC_207
2009;116;18-24;46;53;99;SEC_116
2009;123;16-17;11;18;29;SEC_123
2009;317;03-11;61;51;112;SEC_317
2009;103;03-11;31;38;69;SEC_103
2009;324;12-15;27;26;53;SEC_324
2009;425;65-74;52;39;91;SEC_425
2009;405;50-64;57;54;111;SEC_405
2009;430;35-49;123;160;283;SEC_430
2009;231;50-64;78;59;137;SEC_231
2009;102;18-24;47;49;96;SEC_102
2009;621;65-74;71;78;149;SEC_621
2009;417;75 i +;33;23;56;SEC_417
2009;509;50-64;59;62;121;SEC_509
2009;101;16-17;11;17;28;SEC_101
2009;247;35-49;161;183;344;SEC_247
2009;213;50-64;83;90;173;SEC_213
2009;314;75 i +;85;49;134;SEC_314
2009;229;18-24;34;44;78;SEC_229
2009;201;12-15;11;16;27;SEC_201
2009;404;75 i +;81;42;123;SEC_404
2009;132;18-24;79;87;166;SEC_132
2009;439;35-49;150;172;322;SEC_439
2009;513;03-11;37;36;73;SEC_513
2009;430;16-17;8;11;19;SEC_430
2009;631;75 i +;49;29;78;SEC_631
2009;245;03-11;47;39;86;SEC_245
2009;307;03-11;35;40;75;SEC_307
2009;614;35-49;103;108;211;SEC_614
2009;236;03-11;41;42;83;SEC_236
2009;521;50-64;149;114;263;SEC_521
2009;313;18-24;72;69;141;SEC_313
2009;617;12-15;11;22;33;SEC_617
2009;111;35-49;99;98;197;SEC_111
2009;437;35-49;105;136;241;SEC_437
2009;112;12-15;30;29;59;SEC_112
2009;313;03-11;94;93;187;SEC_313
2009;435;35-49;106;141;247;SEC_435
2009;132;25-34;179;210;389;SEC_132
2009;301;16-17;27;22;49;SEC_301
2009;419;00-02;22;23;45;SEC_419
2009;217;75 i +;42;28;70;SEC_217
2009;133;12-15;8;15;23;SEC_133
2009;124;12-15;9;10;19;SEC_124
2009;125;25-34;117;139;256;SEC_125
2009;214;00-02;10;10;20;SEC_214
2009;315;03-11;73;69;142;SEC_315
2009;201;75 i +;56;35;91;SEC_201
2009;627;00-02;12;13;25;SEC_627
2009;629;50-64;52;45;97;SEC_629
2009;319;50-64;146;143;289;SEC_319
2009;536;65-74;50;42;92;SEC_536
2009;529;50-64;86;87;173;SEC_529
2009;434;18-24;29;31;60;SEC_434
2009;632;50-64;83;74;157;SEC_632
2009;306;35-49;189;201;390;SEC_306
2009;317;75 i +;63;20;83;SEC_317
2009;218;03-11;18;27;45;SEC_218
2009;134;75 i +;73;37;110;SEC_134
2009;405;35-49;90;108;198;SEC_405
2009;628;35-49;102;98;200;SEC_628
2009;309;12-15;13;21;34;SEC_309
2009;626;18-24;34;24;58;SEC_626
2009;611;35-49;223;277;500;SEC_611
2009;128;12-15;17;13;30;SEC_128
2009;236;50-64;94;77;171;SEC_236
2009;237;75 i +;77;49;126;SEC_237
2009;507;16-17;9;6;15;SEC_507
2009;205;00-02;7;8;15;SEC_205
2009;606;35-49;137;135;272;SEC_606
2009;527;50-64;81;79;160;SEC_527
2009;102;25-34;95;100;195;SEC_102
2009;121;18-24;20;26;46;SEC_121
2009;120;65-74;51;58;109;SEC_120
2009;437;12-15;14;10;24;SEC_437
2009;244;18-24;28;24;52;SEC_244
2009;121;16-17;9;7;16;SEC_121
2009;627;35-49;84;92;176;SEC_627
2009;310;03-11;35;39;74;SEC_310
2009;323;03-11;142;138;280;SEC_323
2009;125;65-74;57;71;128;SEC_125
2009;617;50-64;82;81;163;SEC_617
2009;239;65-74;67;43;110;SEC_239
2009;626;16-17;2;6;8;SEC_626
2009;227;25-34;74;61;135;SEC_227
2009;226;75 i +;82;46;128;SEC_226
2009;119;75 i +;77;47;124;SEC_119
2009;537;12-15;18;15;33;SEC_537
2009;303;35-49;164;191;355;SEC_303
2009;320;35-49;147;151;298;SEC_320
2009;625;35-49;111;125;236;SEC_625
2009;515;75 i +;31;11;42;SEC_515
2009;512;65-74;70;56;126;SEC_512
2009;627;50-64;162;147;309;SEC_627
2009;110;12-15;15;15;30;SEC_110
2009;530;03-11;50;50;100;SEC_530
2009;318;18-24;38;33;71;SEC_318
2009;131;75 i +;58;42;100;SEC_131
2009;208;00-02;10;16;26;SEC_208
2009;507;25-34;73;78;151;SEC_507
2009;209;35-49;133;124;257;SEC_209
2009;411;25-34;73;93;166;SEC_411
2009;605;25-34;53;59;112;SEC_605
2009;210;35-49;103;90;193;SEC_210
2009;246;18-24;47;51;98;SEC_246
2009;118;18-24;77;64;141;SEC_118
2009;222;25-34;92;102;194;SEC_222
2009;212;12-15;15;38;53;SEC_212
2009;314;65-74;77;73;150;SEC_314
2009;431;25-34;164;189;353;SEC_431
2009;212;18-24;53;64;117;SEC_212
2009;416;75 i +;47;39;86;SEC_416
2009;235;03-11;69;86;155;SEC_235
2009;131;65-74;68;62;130;SEC_131
2009;127;12-15;10;11;21;SEC_127
2009;530;25-34;131;143;274;SEC_530
2009;107;12-15;11;30;41;SEC_107
2009;439;16-17;9;11;20;SEC_439
2009;418;65-74;70;58;128;SEC_418
2009;311;65-74;73;63;136;SEC_311
2009;517;25-34;132;147;279;SEC_517
2009;137;35-49;180;171;351;SEC_137
2009;304;35-49;225;222;447;SEC_304
2009;626;00-02;8;11;19;SEC_626
2009;519;35-49;80;110;190;SEC_519
2009;140;75 i +;55;41;96;SEC_140
2009;511;25-34;66;73;139;SEC_511
2009;523;12-15;24;23;47;SEC_523
2009;318;16-17;5;15;20;SEC_318
2009;306;00-02;32;22;54;SEC_306
2009;433;16-17;10;12;22;SEC_433
2009;614;25-34;57;86;143;SEC_614
2009;227;75 i +;52;33;85;SEC_227
2009;134;65-74;56;45;101;SEC_134
2009;415;00-02;11;23;34;SEC_415
2009;504;00-02;13;17;30;SEC_504
2009;129;00-02;20;19;39;SEC_129
2009;631;16-17;8;10;18;SEC_631
2009;112;65-74;70;45;115;SEC_112
2009;216;25-34;113;114;227;SEC_216
2009;628;65-74;66;61;127;SEC_628
2009;139;75 i +;36;23;59;SEC_139
2009;320;16-17;7;7;14;SEC_320
2009;421;18-24;38;48;86;SEC_421
2009;312;35-49;209;229;438;SEC_312
2009;209;25-34;75;99;174;SEC_209
2009;316;65-74;69;61;130;SEC_316
2009;410;25-34;115;126;241;SEC_410
2009;616;25-34;215;208;423;SEC_616
2009;137;65-74;62;64;126;SEC_137
2009;116;65-74;85;89;174;SEC_116
2009;201;35-49;108;118;226;SEC_201
2009;207;12-15;6;11;17;SEC_207
2009;233;65-74;56;36;92;SEC_233
2009;629;75 i +;32;18;50;SEC_629
2009;510;03-11;34;34;68;SEC_510
2009;242;50-64;93;91;184;SEC_242
2009;427;50-64;66;55;121;SEC_427
2009;212;16-17;20;15;35;SEC_212
2009;606;00-02;14;14;28;SEC_606
2009;531;75 i +;41;32;73;SEC_531
2009;506;16-17;16;22;38;SEC_506
2009;435;75 i +;89;40;129;SEC_435
2009;301;50-64;187;180;367;SEC_301
2009;208;18-24;59;43;102;SEC_208
2009;247;25-34;128;125;253;SEC_247
2009;109;00-02;16;14;30;SEC_109
2009;412;16-17;13;16;29;SEC_412
2009;105;50-64;141;108;249;SEC_105
2009;306;25-34;134;149;283;SEC_306
2009;401;18-24;51;68;119;SEC_401
2009;220;18-24;39;43;82;SEC_220
2009;516;12-15;12;21;33;SEC_516
2009;226;25-34;122;129;251;SEC_226
2009;431;12-15;29;36;65;SEC_431
2009;534;18-24;39;41;80;SEC_534
2009;436;16-17;10;9;19;SEC_436
2009;306;65-74;70;49;119;SEC_306
2009;108;12-15;23;23;46;SEC_108
2009;423;50-64;70;55;125;SEC_423
2009;615;25-34;60;60;120;SEC_615
2009;629;25-34;37;56;93;SEC_629
2009;415;75 i +;40;22;62;SEC_415
2009;434;25-34;48;56;104;SEC_434
2009;508;65-74;35;25;60;SEC_508
2009;233;50-64;65;68;133;SEC_233
2009;303;65-74;133;115;248;SEC_303
2009;325;18-24;50;59;109;SEC_325
2009;433;18-24;69;64;133;SEC_433
2009;431;03-11;75;69;144;SEC_431
2009;126;03-11;38;41;79;SEC_126
2009;536;16-17;8;10;18;SEC_536
2009;122;16-17;4;4;8;SEC_122
2009;441;16-17;17;19;36;SEC_441
2009;239;35-49;153;175;328;SEC_239
2009;604;75 i +;27;18;45;SEC_604
2009;114;65-74;101;96;197;SEC_114
2009;246;12-15;31;20;51;SEC_246
2009;619;12-15;10;24;34;SEC_619
2009;417;03-11;22;31;53;SEC_417
2009;525;25-34;88;117;205;SEC_525
2009;307;00-02;10;15;25;SEC_307
2009;225;03-11;13;19;32;SEC_225
2009;613;35-49;146;150;296;SEC_613
2009;609;00-02;14;8;22;SEC_609
2009;204;65-74;28;17;45;SEC_204
2009;325;35-49;202;167;369;SEC_325
2009;213;16-17;8;9;17;SEC_213
2009;513;75 i +;43;28;71;SEC_513
2009;325;65-74;98;82;180;SEC_325
2009;516;25-34;57;66;123;SEC_516
2009;620;18-24;21;26;47;SEC_620
2009;512;50-64;56;60;116;SEC_512
2009;325;00-02;15;14;29;SEC_325
2009;612;50-64;101;67;168;SEC_612
2009;105;65-74;39;48;87;SEC_105
2009;101;35-49;267;279;546;SEC_101
2009;526;25-34;83;83;166;SEC_526
2009;116;12-15;31;19;50;SEC_116
2009;211;75 i +;84;48;132;SEC_211
2009;124;16-17;5;11;16;SEC_124
2009;111;65-74;66;46;112;SEC_111
2009;401;65-74;58;52;110;SEC_401
2009;623;16-17;7;7;14;SEC_623
2009;632;18-24;31;38;69;SEC_632
2009;515;50-64;45;32;77;SEC_515
2009;536;00-02;9;16;25;SEC_536
2009;621;35-49;155;155;310;SEC_621
2009;236;16-17;10;15;25;SEC_236
2009;115;25-34;116;111;227;SEC_115
2009;531;35-49;103;130;233;SEC_531
2009;105;18-24;46;58;104;SEC_105
2009;107;16-17;13;15;28;SEC_107
2009;202;16-17;6;8;14;SEC_202
2009;205;16-17;10;8;18;SEC_205
2009;606;75 i +;77;48;125;SEC_606
2009;126;12-15;16;16;32;SEC_126
2009;433;03-11;43;55;98;SEC_433
2009;204;00-02;11;12;23;SEC_204
2009;523;75 i +;96;49;145;SEC_523
2009;226;50-64;95;83;178;SEC_226
2009;423;65-74;66;67;133;SEC_423
2009;519;03-11;27;39;66;SEC_519
2009;205;03-11;30;26;56;SEC_205
2009;428;35-49;78;101;179;SEC_428
2009;624;35-49;104;132;236;SEC_624
2009;614;03-11;34;29;63;SEC_614
2009;531;00-02;12;22;34;SEC_531
2009;131;35-49;138;166;304;SEC_131
2009;513;16-17;6;10;16;SEC_513
2009;138;12-15;14;12;26;SEC_138
2009;605;50-64;58;32;90;SEC_605
2009;237;03-11;59;68;127;SEC_237
2009;229;35-49;102;119;221;SEC_229
2009;619;25-34;84;88;172;SEC_619
2009;615;75 i +;31;27;58;SEC_615
2009;614;65-74;70;71;141;SEC_614
2009;519;00-02;4;9;13;SEC_519
2009;432;25-34;98;104;202;SEC_432
2009;502;12-15;22;23;45;SEC_502
2009;318;35-49;106;98;204;SEC_318
2009;136;35-49;131;158;289;SEC_136
2009;529;35-49;180;158;338;SEC_529
2009;122;00-02;11;11;22;SEC_122
2009;240;18-24;24;29;53;SEC_240
2009;119;50-64;176;137;313;SEC_119
2009;440;35-49;106;120;226;SEC_440
2009;531;12-15;16;22;38;SEC_531
2009;601;12-15;23;23;46;SEC_601
2009;122;18-24;34;12;46;SEC_122
2009;513;25-34;72;89;161;SEC_513
2009;301;18-24;67;89;156;SEC_301
2009;102;75 i +;97;53;150;SEC_102
2009;405;12-15;12;10;22;SEC_405
2009;509;18-24;39;45;84;SEC_509
2009;403;00-02;16;16;32;SEC_403
2009;412;00-02;20;27;47;SEC_412
2009;303;12-15;22;26;48;SEC_303
2009;201;65-74;48;43;91;SEC_201
2009;209;16-17;5;7;12;SEC_209
2009;309;03-11;33;65;98;SEC_309
2009;618;35-49;79;65;144;SEC_618
2009;538;50-64;99;83;182;SEC_538
2009;608;00-02;10;8;18;SEC_608
2009;321;75 i +;112;56;168;SEC_321
2009;411;12-15;15;16;31;SEC_411
2009;601;00-02;19;23;42;SEC_601
2009;630;35-49;82;97;179;SEC_630
2009;522;50-64;66;58;124;SEC_522
2009;112;35-49;191;161;352;SEC_112
2009;234;00-02;10;17;27;SEC_234
2009;117;18-24;82;67;149;SEC_117
2009;630;65-74;48;43;91;SEC_630
2009;202;03-11;31;33;64;SEC_202
2009;518;65-74;75;51;126;SEC_518
2009;116;50-64;169;142;311;SEC_116
2009;517;35-49;154;204;358;SEC_517
2009;123;75 i +;83;60;143;SEC_123
2009;211;00-02;26;22;48;SEC_211
2009;323;00-02;44;49;93;SEC_323
2009;419;75 i +;40;29;69;SEC_419
2009;426;18-24;36;49;85;SEC_426
2009;520;03-11;32;42;74;SEC_520
2009;138;18-24;31;46;77;SEC_138
2009;629;18-24;21;14;35;SEC_629
2009;119;03-11;37;42;79;SEC_119
2009;602;75 i +;27;22;49;SEC_602
2009;407;16-17;6;11;17;SEC_407
2009;619;00-02;17;16;33;SEC_619
2009;131;16-17;13;14;27;SEC_131
2009;202;12-15;11;13;24;SEC_202
2009;423;00-02;11;18;29;SEC_423
2009;140;65-74;62;59;121;SEC_140
2009;616;65-74;79;76;155;SEC_616
2009;625;65-74;69;55;124;SEC_625
2009;244;35-49;102;110;212;SEC_244
2009;412;03-11;64;41;105;SEC_412
2009;324;16-17;10;11;21;SEC_324
2009;534;65-74;55;54;109;SEC_534
2009;218;65-74;37;29;66;SEC_218
2009;610;18-24;39;38;77;SEC_610
2009;304;65-74;71;50;121;SEC_304
2009;138;75 i +;35;27;62;SEC_138
2009;130;18-24;29;36;65;SEC_130
2009;535;65-74;72;84;156;SEC_535
2009;208;50-64;183;145;328;SEC_208
2009;322;35-49;157;158;315;SEC_322
2009;139;50-64;89;87;176;SEC_139
2009;210;18-24;20;20;40;SEC_210
2009;210;00-02;8;6;14;SEC_210
2009;413;25-34;55;61;116;SEC_413
2009;127;03-11;29;34;63;SEC_127
2009;602;16-17;1;6;7;SEC_602
2009;113;35-49;167;179;346;SEC_113
2009;432;50-64;150;140;290;SEC_432
2009;419;50-64;56;51;107;SEC_419
2009;234;18-24;42;39;81;SEC_234
2009;526;75 i +;39;21;60;SEC_526
2009;401;35-49;135;130;265;SEC_401
2009;607;75 i +;56;39;95;SEC_607
2009;523;65-74;82;78;160;SEC_523
2009;424;25-34;65;63;128;SEC_424
2009;136;65-74;62;42;104;SEC_136
2009;247;75 i +;68;48;116;SEC_247
2009;230;50-64;45;40;85;SEC_230
2009;134;18-24;54;52;106;SEC_134
2009;317;65-74;30;29;59;SEC_317
2009;510;75 i +;63;32;95;SEC_510
2009;527;35-49;130;152;282;SEC_527
2009;217;50-64;38;53;91;SEC_217
2009;228;16-17;19;7;26;SEC_228
2009;528;12-15;30;25;55;SEC_528
2009;244;50-64;56;44;100;SEC_244
2009;230;18-24;48;50;98;SEC_230
2009;103;65-74;42;36;78;SEC_103
2009;221;75 i +;62;49;111;SEC_221
2009;441;75 i +;94;59;153;SEC_441
2009;324;65-74;30;35;65;SEC_324
2009;516;18-24;37;41;78;SEC_516
2009;126;65-74;67;85;152;SEC_126
2009;535;00-02;8;11;19;SEC_535
2009;320;12-15;11;13;24;SEC_320
2009;501;00-02;11;12;23;SEC_501
2009;611;50-64;120;86;206;SEC_611
2009;441;03-11;63;76;139;SEC_441
2009;612;65-74;92;88;180;SEC_612
2009;249;35-49;146;150;296;SEC_249
2009;506;50-64;237;204;441;SEC_506
2009;522;03-11;36;49;85;SEC_522
2009;207;25-34;77;81;158;SEC_207
2009;232;25-34;103;92;195;SEC_232
2009;510;35-49;111;137;248;SEC_510
2009;414;50-64;70;51;121;SEC_414
2009;424;00-02;11;12;23;SEC_424
2009;517;03-11;57;71;128;SEC_517
2009;114;75 i +;74;44;118;SEC_114
2009;323;25-34;238;280;518;SEC_323
2009;137;50-64;169;131;300;SEC_137
2009;125;50-64;173;147;320;SEC_125
2009;135;00-02;24;18;42;SEC_135
2009;316;35-49;175;133;308;SEC_316
2009;305;35-49;193;186;379;SEC_305
2009;221;65-74;60;53;113;SEC_221
2009;313;00-02;20;34;54;SEC_313
2009;607;03-11;48;31;79;SEC_607
2009;219;12-15;34;23;57;SEC_219
2009;601;75 i +;60;50;110;SEC_601
2009;424;18-24;21;29;50;SEC_424
2009;321;25-34;175;155;330;SEC_321
2009;323;12-15;61;54;115;SEC_323
2009;622;35-49;101;89;190;SEC_622
2009;602;50-64;45;30;75;SEC_602
2009;123;65-74;63;51;114;SEC_123
2009;112;18-24;57;65;122;SEC_112
2009;519;65-74;38;24;62;SEC_519
2009;631;18-24;33;24;57;SEC_631
2009;122;35-49;97;108;205;SEC_122
2009;311;18-24;54;69;123;SEC_311
2009;240;00-02;14;11;25;SEC_240
2009;510;18-24;45;48;93;SEC_510
2009;302;12-15;18;23;41;SEC_302
2009;111;75 i +;47;46;93;SEC_111
2009;216;18-24;44;48;92;SEC_216
2009;534;25-34;78;95;173;SEC_534
2009;109;03-11;52;32;84;SEC_109
2009;246;75 i +;80;47;127;SEC_246
2009;115;18-24;35;52;87;SEC_115
2009;406;75 i +;61;54;115;SEC_406
2009;432;65-74;73;59;132;SEC_432
2009;212;25-34;146;171;317;SEC_212
2009;247;03-11;58;58;116;SEC_247
2009;524;75 i +;69;40;109;SEC_524
2009;307;25-34;117;107;224;SEC_307
2009;305;50-64;191;172;363;SEC_305
2009;210;12-15;14;10;24;SEC_210
2009;109;12-15;11;16;27;SEC_109
2009;409;12-15;7;17;24;SEC_409
2009;501;65-74;52;54;106;SEC_501
2009;608;65-74;62;45;107;SEC_608
2009;408;25-34;107;124;231;SEC_408
2009;603;35-49;79;79;158;SEC_603
2009;625;50-64;200;175;375;SEC_625
2009;139;12-15;12;22;34;SEC_139
2009;436;18-24;45;44;89;SEC_436
2009;106;12-15;21;27;48;SEC_106
2009;313;75 i +;94;55;149;SEC_313
2009;137;12-15;24;22;46;SEC_137
2009;215;25-34;84;96;180;SEC_215
2009;629;00-02;6;3;9;SEC_629
2009;420;16-17;16;11;27;SEC_420
2009;432;12-15;13;19;32;SEC_432
2009;231;25-34;110;110;220;SEC_231
2009;103;12-15;10;9;19;SEC_103
2009;618;65-74;36;41;77;SEC_618
2009;214;35-49;133;136;269;SEC_214
2009;615;35-49;85;100;185;SEC_615
2009;616;50-64;258;236;494;SEC_616
2009;502;18-24;63;79;142;SEC_502
2009;525;35-49;95;127;222;SEC_525
2009;422;12-15;15;19;34;SEC_422
2009;217;35-49;91;132;223;SEC_217
2009;524;50-64;99;92;191;SEC_524
2009;202;65-74;32;33;65;SEC_202
2009;503;65-74;41;36;77;SEC_503
2009;229;16-17;7;4;11;SEC_229
2009;245;50-64;78;64;142;SEC_245
2009;322;16-17;18;8;26;SEC_322
2009;401;50-64;104;94;198;SEC_401
2009;239;25-34;114;136;250;SEC_239
2009;442;25-34;50;65;115;SEC_442
2009;243;65-74;73;62;135;SEC_243
2009;425;75 i +;72;49;121;SEC_425
2009;413;75 i +;44;30;74;SEC_413
2009;208;75 i +;217;112;329;SEC_208
2009;536;75 i +;71;48;119;SEC_536
2009;533;50-64;56;67;123;SEC_533
2009;212;35-49;188;194;382;SEC_212
2009;104;00-02;11;12;23;SEC_104
2009;107;35-49;185;212;397;SEC_107
2009;503;35-49;79;56;135;SEC_503
2009;520;16-17;6;8;14;SEC_520
2009;237;16-17;10;13;23;SEC_237
2009;127;35-49;99;105;204;SEC_127
2009;312;18-24;76;57;133;SEC_312
2009;529;75 i +;87;58;145;SEC_529
2009;315;18-24;70;64;134;SEC_315
2009;210;03-11;34;27;61;SEC_210
2009;247;12-15;23;27;50;SEC_247
2009;319;16-17;8;16;24;SEC_319
2009;324;03-11;59;56;115;SEC_324
2009;621;12-15;28;26;54;SEC_621
2009;234;50-64;59;56;115;SEC_234
2009;115;50-64;136;138;274;SEC_115
2009;514;65-74;43;29;72;SEC_514
2009;419;18-24;37;51;88;SEC_419
2009;630;16-17;7;7;14;SEC_630
2009;124;03-11;29;30;59;SEC_124
2009;416;18-24;36;39;75;SEC_416
2009;239;00-02;15;25;40;SEC_239
2009;601;50-64;135;109;244;SEC_601
2009;127;25-34;60;60;120;SEC_127
2009;619;03-11;49;47;96;SEC_619
2009;309;25-34;118;123;241;SEC_309
2009;533;03-11;45;48;93;SEC_533
2009;610;75 i +;52;33;85;SEC_610
2009;208;16-17;11;16;27;SEC_208
2009;623;00-02;21;18;39;SEC_623
2009;437;50-64;78;53;131;SEC_437
2009;412;25-34;121;163;284;SEC_412
2009;425;16-17;5;11;16;SEC_425
2009;105;25-34;96;101;197;SEC_105
2009;526;18-24;23;44;67;SEC_526
2009;122;25-34;74;72;146;SEC_122
2009;316;25-34;160;190;350;SEC_316
2009;112;25-34;135;91;226;SEC_112
2009;237;65-74;64;50;114;SEC_237
2009;217;12-15;12;13;25;SEC_217
2009;247;50-64;106;97;203;SEC_247
2009;519;25-34;68;70;138;SEC_519
2009;315;65-74;65;61;126;SEC_315
2009;535;16-17;9;5;14;SEC_535
2009;213;75 i +;57;30;87;SEC_213
2009;246;65-74;46;39;85;SEC_246
2009;414;65-74;47;43;90;SEC_414
2009;221;35-49;142;145;287;SEC_221
2009;532;12-15;31;15;46;SEC_532
2009;630;50-64;119;95;214;SEC_630
2009;320;18-24;27;31;58;SEC_320
2009;124;75 i +;39;32;71;SEC_124
2009;508;12-15;10;8;18;SEC_508
2009;203;16-17;3;12;15;SEC_203
2009;414;75 i +;61;47;108;SEC_414
2009;135;25-34;130;135;265;SEC_135
2009;618;50-64;62;46;108;SEC_618
2009;626;25-34;63;64;127;SEC_626
2009;229;25-34;89;70;159;SEC_229
2009;534;75 i +;59;39;98;SEC_534
2009;216;50-64;116;98;214;SEC_216
2009;530;00-02;18;36;54;SEC_530
2009;140;12-15;13;27;40;SEC_140
2009;106;50-64;265;236;501;SEC_106
2009;224;50-64;43;55;98;SEC_224
2009;431;50-64;109;110;219;SEC_431
2009;308;65-74;98;93;191;SEC_308
2009;428;50-64;42;42;84;SEC_428
2009;218;25-34;59;86;145;SEC_218
2009;537;75 i +;75;47;122;SEC_537
2009;610;65-74;105;119;224;SEC_610
2009;407;00-02;14;23;37;SEC_407
2009;319;25-34;163;199;362;SEC_319
2009;513;50-64;57;48;105;SEC_513
2009;410;75 i +;118;100;218;SEC_410
2009;603;65-74;44;48;92;SEC_603
2009;420;35-49;183;216;399;SEC_420
2009;102;03-11;50;66;116;SEC_102
2009;244;25-34;62;61;123;SEC_244
2009;612;12-15;10;18;28;SEC_612
2009;121;50-64;38;46;84;SEC_121
2009;311;12-15;26;30;56;SEC_311
2009;505;65-74;104;118;222;SEC_505
2009;431;00-02;28;30;58;SEC_431
2009;317;00-02;20;20;40;SEC_317
2009;619;35-49;135;151;286;SEC_619
2009;223;00-02;16;14;30;SEC_223
2009;533;16-17;8;12;20;SEC_533
2009;405;75 i +;74;47;121;SEC_405
2009;503;16-17;9;7;16;SEC_503
2009;110;03-11;29;36;65;SEC_110
2009;410;65-74;121;90;211;SEC_410
2009;115;35-49;141;141;282;SEC_115
2009;415;18-24;54;42;96;SEC_415
2009;611;12-15;20;32;52;SEC_611
2009;302;16-17;14;14;28;SEC_302
2009;117;12-15;37;25;62;SEC_117
2009;402;75 i +;52;45;97;SEC_402
2009;120;16-17;24;17;41;SEC_120
2009;416;35-49;97;103;200;SEC_416
2009;416;65-74;47;31;78;SEC_416
2009;408;75 i +;49;31;80;SEC_408
2009;533;75 i +;49;36;85;SEC_533
2009;616;12-15;59;79;138;SEC_616
2009;439;50-64;56;58;114;SEC_439
2009;231;00-02;15;15;30;SEC_231
2009;619;75 i +;61;40;101;SEC_619
2009;403;12-15;12;20;32;SEC_403
2009;128;65-74;49;54;103;SEC_128
2009;415;35-49;94;136;230;SEC_415
2009;319;75 i +;47;31;78;SEC_319
2009;320;65-74;51;55;106;SEC_320
2009;528;03-11;56;60;116;SEC_528
2009;242;16-17;9;5;14;SEC_242
2009;523;16-17;7;12;19;SEC_523
2009;101;03-11;111;96;207;SEC_101
2009;420;03-11;64;73;137;SEC_420
2009;506;65-74;101;108;209;SEC_506
2009;601;25-34;98;123;221;SEC_601
2009;125;00-02;31;19;50;SEC_125
2009;529;18-24;46;55;101;SEC_529
2009;523;50-64;104;101;205;SEC_523
2009;109;25-34;90;87;177;SEC_109
2009;310;18-24;40;37;77;SEC_310
2009;623;03-11;55;67;122;SEC_623
2009;625;00-02;8;14;22;SEC_625
2009;203;65-74;42;35;77;SEC_203
2009;441;65-74;84;94;178;SEC_441
2009;438;35-49;94;105;199;SEC_438
2009;434;12-15;15;15;30;SEC_434
2009;422;00-02;19;17;36;SEC_422
2009;206;75 i +;80;49;129;SEC_206
2009;537;16-17;11;13;24;SEC_537
2009;417;00-02;11;14;25;SEC_417
2009;414;16-17;17;6;23;SEC_414
2009;115;12-15;18;22;40;SEC_115
2009;507;18-24;34;37;71;SEC_507
2009;219;00-02;24;22;46;SEC_219
2009;506;03-11;62;71;133;SEC_506
2009;533;65-74;58;30;88;SEC_533
2009;425;18-24;52;49;101;SEC_425
2009;212;50-64;100;111;211;SEC_212
2009;316;75 i +;73;31;104;SEC_316
2009;624;50-64;132;106;238;SEC_624
2009;301;65-74;135;117;252;SEC_301
2009;103;35-49;91;94;185;SEC_103
2009;113;75 i +;55;38;93;SEC_113
2009;423;25-34;108;101;209;SEC_423
2009;238;65-74;41;38;79;SEC_238
2009;614;12-15;14;18;32;SEC_614
2009;615;50-64;104;61;165;SEC_615
2009;402;12-15;11;10;21;SEC_402
2009;114;12-15;27;23;50;SEC_114
2009;530;75 i +;97;60;157;SEC_530
2009;622;25-34;56;71;127;SEC_622
2009;427;65-74;48;25;73;SEC_427
2009;118;75 i +;56;32;88;SEC_118
2009;610;03-11;45;50;95;SEC_610
2009;128;03-11;27;35;62;SEC_128
2009;515;65-74;28;27;55;SEC_515
2009;612;35-49;110;137;247;SEC_612
2009;220;00-02;20;17;37;SEC_220
2009;308;16-17;18;19;37;SEC_308
2009;407;18-24;36;49;85;SEC_407
2009;518;25-34;97;107;204;SEC_518
2009;417;65-74;29;21;50;SEC_417
2009;616;00-02;44;39;83;SEC_616
2009;519;75 i +;35;25;60;SEC_519
2009;439;03-11;55;65;120;SEC_439
2009;121;75 i +;86;47;133;SEC_121
2009;523;03-11;50;45;95;SEC_523
2009;521;00-02;14;12;26;SEC_521
2009;516;50-64;36;48;84;SEC_516
2009;132;03-11;94;66;160;SEC_132
2009;624;03-11;33;40;73;SEC_624
2009;603;25-34;54;55;109;SEC_603
2009;137;25-34;129;118;247;SEC_137
2009;411;50-64;99;72;171;SEC_411
2009;228;75 i +;46;31;77;SEC_228
2009;315;35-49;211;230;441;SEC_315
2009;417;50-64;59;46;105;SEC_417
2009;319;00-02;42;51;93;SEC_319
2009;136;50-64;113;104;217;SEC_136
2009;425;12-15;11;19;30;SEC_425
2009;317;18-24;48;41;89;SEC_317
2009;526;12-15;12;20;32;SEC_526
2009;627;16-17;4;11;15;SEC_627
2009;116;03-11;62;62;124;SEC_116
2009;604;00-02;8;13;21;SEC_604
2009;511;65-74;43;27;70;SEC_511
2009;503;00-02;10;8;18;SEC_503
2009;218;12-15;18;8;26;SEC_218
2009;107;25-34;143;164;307;SEC_107
2009;313;12-15;26;26;52;SEC_313
2009;108;65-74;59;47;106;SEC_108
2009;504;75 i +;71;55;126;SEC_504
2009;419;35-49;116;157;273;SEC_419
2009;406;25-34;132;129;261;SEC_406
2009;214;50-64;48;51;99;SEC_214
2009;505;25-34;94;94;188;SEC_505
2009;405;16-17;5;5;10;SEC_405
2009;538;25-34;112;119;231;SEC_538
2009;112;00-02;18;21;39;SEC_112
2009;626;65-74;63;50;113;SEC_626
2009;307;18-24;47;64;111;SEC_307
2009;612;00-02;14;21;35;SEC_612
2009;612;75 i +;53;39;92;SEC_612
2009;442;75 i +;28;18;46;SEC_442
2009;623;65-74;90;89;179;SEC_623
2009;223;03-11;47;47;94;SEC_223
2009;407;75 i +;83;55;138;SEC_407
2009;506;35-49;191;187;378;SEC_506
2009;215;03-11;34;39;73;SEC_215
2009;440;00-02;7;20;27;SEC_440
2009;404;16-17;12;16;28;SEC_404
2009;233;12-15;13;21;34;SEC_233
2009;418;03-11;63;55;118;SEC_418
2009;128;75 i +;50;32;82;SEC_128
2009;629;35-49;57;67;124;SEC_629
2009;437;03-11;35;33;68;SEC_437
2009;129;35-49;133;149;282;SEC_129
2009;248;00-02;17;20;37;SEC_248
2009;234;75 i +;79;45;124;SEC_234
2009;223;75 i +;65;43;108;SEC_223
2009;245;65-74;53;37;90;SEC_245
2009;228;03-11;26;29;55;SEC_228
2009;107;65-74;98;89;187;SEC_107
2009;426;35-49;158;156;314;SEC_426
2009;617;00-02;16;18;34;SEC_617
2009;628;75 i +;46;39;85;SEC_628
2009;130;12-15;16;18;34;SEC_130
2009;135;16-17;4;8;12;SEC_135
2009;536;12-15;15;16;31;SEC_536
2009;319;18-24;59;67;126;SEC_319
2009;507;65-74;47;43;90;SEC_507
2009;501;16-17;10;7;17;SEC_501
2009;431;65-74;68;47;115;SEC_431
2009;601;16-17;15;11;26;SEC_601
2009;209;12-15;11;13;24;SEC_209
2009;528;25-34;126;146;272;SEC_528
2009;608;03-11;24;24;48;SEC_608
2009;504;16-17;7;3;10;SEC_504
2009;203;00-02;9;10;19;SEC_203
2009;623;25-34;92;137;229;SEC_623
2009;224;25-34;64;66;130;SEC_224
2009;118;12-15;24;35;59;SEC_118
2009;316;03-11;45;61;106;SEC_316
2009;536;03-11;38;35;73;SEC_536
2009;226;35-49;147;151;298;SEC_226
2009;415;25-34;106;116;222;SEC_415
2009;527;03-11;63;53;116;SEC_527
2009;412;18-24;56;69;125;SEC_412
2009;627;12-15;10;15;25;SEC_627
2009;248;65-74;43;48;91;SEC_248
2009;619;18-24;39;50;89;SEC_619
2009;220;03-11;35;35;70;SEC_220
2009;237;35-49;173;197;370;SEC_237
2009;248;25-34;111;111;222;SEC_248
2009;608;75 i +;50;31;81;SEC_608
2009;515;12-15;8;16;24;SEC_515
2009;402;25-34;85;83;168;SEC_402
2009;606;50-64;78;60;138;SEC_606
2009;517;12-15;18;21;39;SEC_517
2009;623;18-24;44;47;91;SEC_623
2009;524;12-15;20;26;46;SEC_524
2009;214;65-74;40;33;73;SEC_214
2009;207;03-11;27;28;55;SEC_207
2009;440;16-17;6;9;15;SEC_440
2009;524;18-24;41;49;90;SEC_524
2009;407;35-49;132;153;285;SEC_407
