AnyPadro;Seccio;GrupEdat;Dones;Homes;Total;IdSeccio
2018;129;00-02;8;16;24;SEC_129
2018;106;12-15;27;25;52;SEC_106
2018;308;16-17;19;19;38;SEC_308
2018;433;35-49;231;227;458;SEC_433
2018;214;50-64;191;190;381;SEC_214
2018;242;00-02;17;19;36;SEC_242
2018;526;35-49;282;276;558;SEC_526
2018;312;25-34;163;156;319;SEC_312
2018;210;35-49;101;93;194;SEC_210
2018;308;50-64;214;207;421;SEC_308
2018;131;65-74;127;117;244;SEC_131
2018;632;65-74;47;40;87;SEC_632
2018;130;50-64;99;91;190;SEC_130
2018;104;00-02;11;13;24;SEC_104
2018;615;50-64;50;47;97;SEC_615
2018;619;50-64;143;136;279;SEC_619
2018;139;16-17;10;10;20;SEC_139
2018;507;00-02;9;13;22;SEC_507
2018;402;75 i +;57;43;100;SEC_402
2018;436;03-11;83;63;146;SEC_436
2018;514;03-11;51;64;115;SEC_514
2018;513;65-74;50;35;85;SEC_513
2018;318;18-24;33;27;60;SEC_318
2018;322;12-15;30;22;52;SEC_322
2018;436;25-34;108;115;223;SEC_436
2018;303;25-34;100;96;196;SEC_303
2018;409;00-02;29;26;55;SEC_409
2018;112;12-15;36;32;68;SEC_112
2018;212;00-02;14;20;34;SEC_212
2018;622;25-34;49;35;84;SEC_622
2018;530;12-15;24;32;56;SEC_530
2018;121;03-11;32;49;81;SEC_121
2018;502;25-34;87;94;181;SEC_502
2018;430;03-11;59;57;116;SEC_430
2018;602;03-11;53;63;116;SEC_602
2018;316;35-49;170;183;353;SEC_316
2018;135;03-11;54;58;112;SEC_135
2018;216;75 i +;87;58;145;SEC_216
2018;229;18-24;101;88;189;SEC_229
2018;213;16-17;6;11;17;SEC_213
2018;612;16-17;7;14;21;SEC_612
2018;537;65-74;79;53;132;SEC_537
2018;131;03-11;60;46;106;SEC_131
2018;325;03-11;49;60;109;SEC_325
2018;207;50-64;182;154;336;SEC_207
2018;422;25-34;84;83;167;SEC_422
2018;249;00-02;15;10;25;SEC_249
2018;416;25-34;125;112;237;SEC_416
2018;606;12-15;19;20;39;SEC_606
2018;513;50-64;137;143;280;SEC_513
2018;233;18-24;32;54;86;SEC_233
2018;435;03-11;55;65;120;SEC_435
2018;607;75 i +;114;91;205;SEC_607
2018;224;25-34;121;107;228;SEC_224
2018;418;00-02;10;24;34;SEC_418
2018;625;50-64;144;114;258;SEC_625
2018;226;00-02;26;22;48;SEC_226
2018;308;00-02;27;26;53;SEC_308
2018;518;25-34;78;70;148;SEC_518
2018;325;25-34;84;80;164;SEC_325
2018;210;65-74;60;51;111;SEC_210
2018;236;16-17;4;13;17;SEC_236
2018;305;00-02;16;19;35;SEC_305
2018;130;35-49;139;133;272;SEC_130
2018;537;75 i +;89;61;150;SEC_537
2018;610;18-24;43;49;92;SEC_610
2018;406;35-49;164;151;315;SEC_406
2018;520;16-17;7;6;13;SEC_520
2018;609;03-11;36;38;74;SEC_609
2018;217;00-02;19;17;36;SEC_217
2018;523;00-02;16;18;34;SEC_523
2018;135;18-24;56;45;101;SEC_135
2018;411;00-02;9;16;25;SEC_411
2018;324;35-49;169;186;355;SEC_324
2018;117;16-17;18;23;41;SEC_117
2018;213;03-11;48;44;92;SEC_213
2018;521;75 i +;85;71;156;SEC_521
2018;120;25-34;98;114;212;SEC_120
2018;213;50-64;97;77;174;SEC_213
2018;141;16-17;7;11;18;SEC_141
2018;412;65-74;111;88;199;SEC_412
2018;308;12-15;49;50;99;SEC_308
2018;418;03-11;75;52;127;SEC_418
2018;533;16-17;13;15;28;SEC_533
2018;525;50-64;63;67;130;SEC_525
2018;436;35-49;202;222;424;SEC_436
2018;212;12-15;21;34;55;SEC_212
2018;318;50-64;113;89;202;SEC_318
2018;427;35-49;224;236;460;SEC_427
2018;614;50-64;82;78;160;SEC_614
2018;526;12-15;33;36;69;SEC_526
2018;420;12-15;44;36;80;SEC_420
2018;441;35-49;218;245;463;SEC_441
2018;123;75 i +;93;67;160;SEC_123
2018;328;12-15;53;43;96;SEC_328
2018;529;50-64;116;100;216;SEC_529
2018;106;50-64;216;151;367;SEC_106
2018;437;16-17;17;18;35;SEC_437
2018;504;35-49;137;125;262;SEC_504
2018;605;00-02;23;29;52;SEC_605
2018;531;03-11;42;40;82;SEC_531
2018;602;65-74;73;37;110;SEC_602
2018;528;75 i +;80;52;132;SEC_528
2018;102;12-15;22;30;52;SEC_102
2018;237;35-49;177;179;356;SEC_237
2018;324;25-34;84;81;165;SEC_324
2018;231;18-24;59;59;118;SEC_231
2018;601;75 i +;161;125;286;SEC_601
2018;611;18-24;47;57;104;SEC_611
2018;609;50-64;60;64;124;SEC_609
2018;320;35-49;54;72;126;SEC_320
2018;619;12-15;20;20;40;SEC_619
2018;609;12-15;13;15;28;SEC_609
2018;307;16-17;8;9;17;SEC_307
2018;140;18-24;37;44;81;SEC_140
2018;410;00-02;17;20;37;SEC_410
2018;115;50-64;127;134;261;SEC_115
2018;412;03-11;38;54;92;SEC_412
2018;517;16-17;22;30;52;SEC_517
2018;514;16-17;12;9;21;SEC_514
2018;502;16-17;16;12;28;SEC_502
2018;410;50-64;153;153;306;SEC_410
2018;108;00-02;15;18;33;SEC_108
2018;632;75 i +;58;33;91;SEC_632
2018;238;35-49;138;122;260;SEC_238
2018;302;50-64;131;108;239;SEC_302
2018;616;35-49;276;251;527;SEC_616
2018;535;75 i +;77;77;154;SEC_535
2018;237;12-15;21;36;57;SEC_237
2018;608;03-11;55;49;104;SEC_608
2018;625;18-24;25;35;60;SEC_625
2018;601;16-17;16;22;38;SEC_601
2018;240;16-17;13;18;31;SEC_240
2018;436;16-17;15;25;40;SEC_436
2018;210;50-64;81;79;160;SEC_210
2018;101;18-24;57;49;106;SEC_101
2018;320;12-15;4;2;6;SEC_320
2018;140;25-34;74;60;134;SEC_140
2018;625;25-34;59;63;122;SEC_625
2018;118;12-15;44;28;72;SEC_118
2018;223;12-15;26;26;52;SEC_223
2018;217;50-64;134;136;270;SEC_217
2018;414;25-34;179;154;333;SEC_414
2018;504;16-17;9;4;13;SEC_504
2018;421;12-15;30;17;47;SEC_421
2018;506;35-49;183;176;359;SEC_506
2018;311;00-02;22;22;44;SEC_311
2018;239;35-49;145;152;297;SEC_239
2018;310;12-15;19;17;36;SEC_310
2018;510;00-02;10;13;23;SEC_510
2018;234;12-15;13;10;23;SEC_234
2018;440;50-64;90;93;183;SEC_440
2018;325;65-74;136;111;247;SEC_325
2018;329;03-11;98;113;211;SEC_329
2018;133;25-34;61;54;115;SEC_133
2018;619;18-24;27;41;68;SEC_619
2018;107;00-02;26;14;40;SEC_107
2018;221;75 i +;115;73;188;SEC_221
2018;615;03-11;37;32;69;SEC_615
2018;405;18-24;84;92;176;SEC_405
2018;248;00-02;16;14;30;SEC_248
2018;104;35-49;108;109;217;SEC_104
2018;212;16-17;14;19;33;SEC_212
2018;506;03-11;50;57;107;SEC_506
2018;124;03-11;36;34;70;SEC_124
2018;122;12-15;24;20;44;SEC_122
2018;243;03-11;56;73;129;SEC_243
2018;621;03-11;55;56;111;SEC_621
2018;507;03-11;33;34;67;SEC_507
2018;105;00-02;18;12;30;SEC_105
2018;533;65-74;82;62;144;SEC_533
2018;107;12-15;28;37;65;SEC_107
2018;601;12-15;33;39;72;SEC_601
2018;221;18-24;79;91;170;SEC_221
2018;106;16-17;17;19;36;SEC_106
2018;247;16-17;18;14;32;SEC_247
2018;605;50-64;147;122;269;SEC_605
2018;423;65-74;45;31;76;SEC_423
2018;121;18-24;38;35;73;SEC_121
2018;501;25-34;33;40;73;SEC_501
2018;315;75 i +;68;60;128;SEC_315
2018;119;75 i +;109;73;182;SEC_119
2018;619;03-11;46;52;98;SEC_619
2018;513;03-11;69;76;145;SEC_513
2018;426;12-15;21;22;43;SEC_426
2018;627;35-49;89;100;189;SEC_627
2018;231;75 i +;84;39;123;SEC_231
2018;320;12-15;37;38;75;SEC_320
2018;301;75 i +;145;99;244;SEC_301
2018;517;65-74;78;57;135;SEC_517
2018;108;50-64;146;138;284;SEC_108
2018;614;16-17;11;6;17;SEC_614
2018;616;12-15;45;44;89;SEC_616
2018;530;25-34;150;124;274;SEC_530
2018;416;50-64;131;112;243;SEC_416
2018;229;65-74;46;31;77;SEC_229
2018;533;50-64;173;159;332;SEC_533
2018;208;65-74;124;88;212;SEC_208
2018;530;35-49;265;258;523;SEC_530
2018;313;65-74;130;103;233;SEC_313
2018;141;25-34;45;51;96;SEC_141
2018;510;50-64;105;96;201;SEC_510
2018;426;00-02;19;16;35;SEC_426
2018;437;75 i +;118;80;198;SEC_437
2018;104;50-64;83;88;171;SEC_104
2018;224;12-15;22;24;46;SEC_224
2018;524;50-64;117;102;219;SEC_524
2018;323;16-17;19;18;37;SEC_323
2018;117;25-34;106;104;210;SEC_117
2018;614;00-02;3;7;10;SEC_614
2018;602;18-24;43;55;98;SEC_602
2018;240;65-74;56;44;100;SEC_240
2018;243;35-49;190;202;392;SEC_243
2018;114;75 i +;114;88;202;SEC_114
2018;305;35-49;177;207;384;SEC_305
2018;631;03-11;39;49;88;SEC_631
2018;427;12-15;32;39;71;SEC_427
2018;403;18-24;38;45;83;SEC_403
2018;602;00-02;12;10;22;SEC_602
2018;313;50-64;197;162;359;SEC_313
2018;207;12-15;35;36;71;SEC_207
2018;306;16-17;21;16;37;SEC_306
2018;133;75 i +;66;31;97;SEC_133
2018;624;18-24;25;37;62;SEC_624
2018;323;50-64;193;161;354;SEC_323
2018;115;00-02;10;11;21;SEC_115
2018;531;65-74;43;24;67;SEC_531
2018;405;16-17;17;21;38;SEC_405
2018;605;25-34;76;76;152;SEC_605
2018;202;65-74;63;42;105;SEC_202
2018;307;12-15;16;20;36;SEC_307
2018;601;03-11;67;83;150;SEC_601
2018;229;12-15;35;38;73;SEC_229
2018;423;00-02;22;21;43;SEC_423
2018;431;12-15;45;40;85;SEC_431
2018;411;25-34;65;61;126;SEC_411
2018;202;25-34;148;158;306;SEC_202
2018;530;50-64;148;136;284;SEC_530
2018;411;50-64;92;74;166;SEC_411
2018;224;00-02;17;23;40;SEC_224
2018;114;03-11;45;60;105;SEC_114
2018;101;75 i +;61;40;101;SEC_101
2018;205;50-64;101;108;209;SEC_205
2018;631;12-15;12;17;29;SEC_631
2018;529;75 i +;89;60;149;SEC_529
2018;229;25-34;153;144;297;SEC_229
2018;133;16-17;8;8;16;SEC_133
2018;610;65-74;118;66;184;SEC_610
2018;121;75 i +;66;34;100;SEC_121
2018;249;65-74;45;32;77;SEC_249
2018;130;00-02;13;21;34;SEC_130
2018;129;25-34;63;59;122;SEC_129
2018;307;00-02;11;8;19;SEC_307
2018;525;35-49;128;122;250;SEC_525
2018;411;75 i +;100;71;171;SEC_411
2018;130;16-17;12;6;18;SEC_130
2018;320;03-11;62;58;120;SEC_320
2018;207;25-34;150;132;282;SEC_207
2018;224;35-49;170;152;322;SEC_224
2018;127;75 i +;38;32;70;SEC_127
2018;317;50-64;92;88;180;SEC_317
2018;123;25-34;78;61;139;SEC_123
2018;318;16-17;3;7;10;SEC_318
2018;111;25-34;47;34;81;SEC_111
2018;414;18-24;83;88;171;SEC_414
2018;409;50-64;167;156;323;SEC_409
2018;326;25-34;106;82;188;SEC_326
2018;120;12-15;18;43;61;SEC_120
2018;538;75 i +;102;60;162;SEC_538
2018;114;12-15;26;25;51;SEC_114
2018;427;25-34;144;130;274;SEC_427
2018;317;00-02;24;18;42;SEC_317
2018;422;18-24;58;53;111;SEC_422
2018;216;65-74;85;65;150;SEC_216
2018;128;00-02;17;17;34;SEC_128
2018;113;25-34;80;95;175;SEC_113
2018;221;12-15;31;37;68;SEC_221
2018;524;18-24;53;63;116;SEC_524
2018;134;65-74;71;62;133;SEC_134
2018;518;18-24;37;53;90;SEC_518
2018;210;03-11;30;36;66;SEC_210
2018;521;50-64;78;65;143;SEC_521
2018;320;03-11;20;13;33;SEC_320
2018;111;00-02;4;8;12;SEC_111
2018;406;03-11;59;48;107;SEC_406
2018;616;03-11;114;108;222;SEC_616
2018;317;65-74;24;31;55;SEC_317
2018;321;00-02;23;37;60;SEC_321
2018;211;03-11;59;71;130;SEC_211
2018;115;03-11;53;52;105;SEC_115
2018;507;50-64;77;79;156;SEC_507
2018;138;25-34;32;52;84;SEC_138
2018;427;00-02;27;28;55;SEC_427
2018;301;18-24;43;43;86;SEC_301
2018;412;00-02;17;26;43;SEC_412
2018;116;12-15;27;19;46;SEC_116
2018;131;50-64;128;117;245;SEC_131
2018;224;75 i +;69;30;99;SEC_224
2018;101;65-74;72;82;154;SEC_101
2018;131;12-15;15;18;33;SEC_131
2018;505;03-11;44;43;87;SEC_505
2018;535;12-15;14;19;33;SEC_535
2018;421;18-24;50;59;109;SEC_421
2018;208;03-11;30;43;73;SEC_208
2018;304;65-74;66;52;118;SEC_304
2018;611;35-49;222;244;466;SEC_611
2018;613;35-49;136;155;291;SEC_613
2018;405;03-11;84;81;165;SEC_405
2018;630;18-24;22;29;51;SEC_630
2018;242;75 i +;77;58;135;SEC_242
2018;103;50-64;72;68;140;SEC_103
2018;602;12-15;21;29;50;SEC_602
2018;411;16-17;10;10;20;SEC_411
2018;406;18-24;71;59;130;SEC_406
2018;320;50-64;126;122;248;SEC_320
2018;312;03-11;60;73;133;SEC_312
2018;245;25-34;96;83;179;SEC_245
2018;616;50-64;236;210;446;SEC_616
2018;501;00-02;11;7;18;SEC_501
2018;140;16-17;11;7;18;SEC_140
2018;538;35-49;166;163;329;SEC_538
2018;529;03-11;52;54;106;SEC_529
2018;303;50-64;119;134;253;SEC_303
2018;107;35-49;191;202;393;SEC_107
2018;108;18-24;56;52;108;SEC_108
2018;136;00-02;13;14;27;SEC_136
2018;521;03-11;37;33;70;SEC_521
2018;204;65-74;65;56;121;SEC_204
2018;531;75 i +;51;35;86;SEC_531
2018;621;12-15;24;27;51;SEC_621
2018;613;65-74;110;41;151;SEC_613
2018;232;03-11;48;47;95;SEC_232
2018;505;35-49;132;129;261;SEC_505
2018;305;12-15;25;28;53;SEC_305
2018;139;03-11;26;35;61;SEC_139
2018;325;16-17;12;24;36;SEC_325
2018;421;35-49;162;169;331;SEC_421
2018;608;25-34;47;64;111;SEC_608
2018;615;25-34;31;37;68;SEC_615
2018;212;75 i +;73;44;117;SEC_212
2018;137;12-15;38;26;64;SEC_137
2018;210;75 i +;77;43;120;SEC_210
2018;311;50-64;141;137;278;SEC_311
2018;506;16-17;17;20;37;SEC_506
2018;533;25-34;159;131;290;SEC_533
2018;421;25-34;84;88;172;SEC_421
2018;625;12-15;20;22;42;SEC_625
2018;233;50-64;99;80;179;SEC_233
2018;312;35-49;244;276;520;SEC_312
2018;532;03-11;64;71;135;SEC_532
2018;303;65-74;114;69;183;SEC_303
2018;329;00-02;31;42;73;SEC_329
2018;303;18-24;49;56;105;SEC_303
2018;221;35-49;251;267;518;SEC_221
2018;435;16-17;10;5;15;SEC_435
2018;528;25-34;80;80;160;SEC_528
2018;523;16-17;11;10;21;SEC_523
2018;242;12-15;17;16;33;SEC_242
2018;622;12-15;19;14;33;SEC_622
2018;520;03-11;39;30;69;SEC_520
2018;125;75 i +;74;69;143;SEC_125
2018;505;75 i +;106;98;204;SEC_505
2018;409;65-74;86;69;155;SEC_409
2018;113;18-24;46;63;109;SEC_113
2018;202;50-64;150;147;297;SEC_202
2018;503;35-49;85;77;162;SEC_503
2018;122;65-74;46;26;72;SEC_122
2018;420;75 i +;127;78;205;SEC_420
2018;421;03-11;44;50;94;SEC_421
2018;412;12-15;22;33;55;SEC_412
2018;216;25-34;84;86;170;SEC_216
2018;606;18-24;29;36;65;SEC_606
2018;419;65-74;64;45;109;SEC_419
2018;233;16-17;5;11;16;SEC_233
2018;406;12-15;19;35;54;SEC_406
2018;601;35-49;209;263;472;SEC_601
2018;329;25-34;74;69;143;SEC_329
2018;122;16-17;7;6;13;SEC_122
2018;513;25-34;110;112;222;SEC_513
2018;440;65-74;68;48;116;SEC_440
2018;526;50-64;149;146;295;SEC_526
2018;133;50-64;89;85;174;SEC_133
2018;328;16-17;53;10;63;SEC_328
2018;303;00-02;17;18;35;SEC_303
2018;425;03-11;44;40;84;SEC_425
2018;138;03-11;18;31;49;SEC_138
2018;246;50-64;96;104;200;SEC_246
2018;242;03-11;48;55;103;SEC_242
2018;405;35-49;228;223;451;SEC_405
2018;607;18-24;27;40;67;SEC_607
2018;306;12-15;27;32;59;SEC_306
2018;112;65-74;99;96;195;SEC_112
2018;226;03-11;76;93;169;SEC_226
2018;135;50-64;164;145;309;SEC_135
2018;321;75 i +;132;90;222;SEC_321
2018;418;25-34;91;112;203;SEC_418
2018;521;25-34;36;31;67;SEC_521
2018;441;12-15;33;40;73;SEC_441
2018;134;25-34;77;82;159;SEC_134
2018;605;16-17;17;14;31;SEC_605
2018;432;25-34;86;92;178;SEC_432
2018;130;12-15;21;18;39;SEC_130
2018;440;03-11;36;49;85;SEC_440
2018;123;18-24;33;46;79;SEC_123
2018;435;00-02;23;25;48;SEC_435
2018;132;18-24;60;74;134;SEC_132
2018;239;65-74;54;28;82;SEC_239
2018;611;12-15;36;45;81;SEC_611
2018;412;75 i +;126;96;222;SEC_412
2018;524;75 i +;69;30;99;SEC_524
2018;524;00-02;20;26;46;SEC_524
2018;616;65-74;130;108;238;SEC_616
2018;129;18-24;28;42;70;SEC_129
2018;630;00-02;15;7;22;SEC_630
2018;231;00-02;23;23;46;SEC_231
2018;216;35-49;159;168;327;SEC_216
2018;631;50-64;71;72;143;SEC_631
2018;528;50-64;115;93;208;SEC_528
2018;441;00-02;29;28;57;SEC_441
2018;316;12-15;30;30;60;SEC_316
2018;121;25-34;50;52;102;SEC_121
2018;405;65-74;79;53;132;SEC_405
2018;506;25-34;88;104;192;SEC_506
2018;234;75 i +;65;39;104;SEC_234
2018;248;65-74;43;37;80;SEC_248
2018;304;03-11;83;107;190;SEC_304
2018;414;12-15;31;33;64;SEC_414
2018;524;03-11;68;72;140;SEC_524
2018;124;18-24;24;21;45;SEC_124
2018;103;18-24;22;25;47;SEC_103
2018;134;03-11;63;54;117;SEC_134
2018;315;16-17;9;12;21;SEC_315
2018;526;00-02;30;21;51;SEC_526
2018;103;03-11;34;32;66;SEC_103
2018;627;50-64;105;74;179;SEC_627
2018;538;16-17;13;16;29;SEC_538
2018;529;18-24;56;68;124;SEC_529
2018;328;03-11;133;147;280;SEC_328
2018;238;03-11;53;43;96;SEC_238
2018;123;03-11;47;45;92;SEC_123
2018;630;16-17;8;5;13;SEC_630
2018;126;50-64;76;66;142;SEC_126
2018;504;12-15;11;18;29;SEC_504
2018;317;35-49;146;181;327;SEC_317
2018;129;35-49;128;142;270;SEC_129
2018;118;65-74;145;140;285;SEC_118
2018;601;00-02;26;20;46;SEC_601
2018;109;50-64;140;115;255;SEC_109
2018;128;16-17;5;9;14;SEC_128
2018;125;03-11;68;76;144;SEC_125
2018;141;00-02;32;28;60;SEC_141
2018;237;18-24;45;57;102;SEC_237
2018;311;25-34;115;120;235;SEC_311
2018;607;25-34;58;67;125;SEC_607
2018;426;25-34;116;92;208;SEC_426
2018;328;25-34;106;92;198;SEC_328
2018;320;16-17;24;17;41;SEC_320
2018;422;75 i +;81;41;122;SEC_422
2018;329;50-64;123;121;244;SEC_329
2018;118;25-34;90;67;157;SEC_118
2018;609;18-24;29;35;64;SEC_609
2018;121;16-17;5;9;14;SEC_121
2018;440;16-17;5;13;18;SEC_440
2018;106;65-74;140;137;277;SEC_106
2018;513;00-02;25;30;55;SEC_513
2018;416;12-15;25;38;63;SEC_416
2018;221;00-02;27;28;55;SEC_221
2018;318;03-11;23;28;51;SEC_318
2018;126;35-49;112;120;232;SEC_126
2018;138;75 i +;50;36;86;SEC_138
2018;216;00-02;14;13;27;SEC_216
2018;248;75 i +;65;47;112;SEC_248
2018;502;03-11;72;75;147;SEC_502
2018;503;12-15;6;4;10;SEC_503
2018;320;65-74;86;69;155;SEC_320
2018;602;50-64;107;103;210;SEC_602
2018;217;25-34;98;131;229;SEC_217
2018;412;18-24;54;54;108;SEC_412
2018;511;12-15;39;47;86;SEC_511
2018;109;75 i +;74;51;125;SEC_109
2018;605;12-15;35;31;66;SEC_605
2018;530;03-11;71;97;168;SEC_530
2018;418;65-74;52;46;98;SEC_418
2018;212;65-74;62;42;104;SEC_212
2018;410;18-24;60;88;148;SEC_410
2018;132;50-64;243;228;471;SEC_132
2018;320;75 i +;67;52;119;SEC_320
2018;405;25-34;177;114;291;SEC_405
2018;302;16-17;7;7;14;SEC_302
2018;328;50-64;79;99;178;SEC_328
2018;136;35-49;158;161;319;SEC_136
2018;229;03-11;74;95;169;SEC_229
2018;232;65-74;55;33;88;SEC_232
2018;401;03-11;44;53;97;SEC_401
2018;411;12-15;19;13;32;SEC_411
2018;630;75 i +;47;34;81;SEC_630
2018;311;03-11;55;79;134;SEC_311
2018;103;35-49;106;112;218;SEC_103
2018;507;75 i +;52;29;81;SEC_507
2018;212;18-24;57;64;121;SEC_212
2018;621;75 i +;63;55;118;SEC_621
2018;436;65-74;58;56;114;SEC_436
2018;407;03-11;49;53;102;SEC_407
2018;210;25-34;42;42;84;SEC_210
2018;211;00-02;18;20;38;SEC_211
2018;618;50-64;117;119;236;SEC_618
2018;440;00-02;15;13;28;SEC_440
2018;326;50-64;52;68;120;SEC_326
2018;320;65-74;3;5;8;SEC_320
2018;325;50-64;214;156;370;SEC_325
2018;110;12-15;18;12;30;SEC_110
2018;122;18-24;32;26;58;SEC_122
2018;320;50-64;24;29;53;SEC_320
2018;242;65-74;56;41;97;SEC_242
2018;610;00-02;13;13;26;SEC_610
2018;410;03-11;59;51;110;SEC_410
2018;425;18-24;48;47;95;SEC_425
2018;517;18-24;89;108;197;SEC_517
2018;226;12-15;39;32;71;SEC_226
2018;626;25-34;48;44;92;SEC_626
2018;208;12-15;23;23;46;SEC_208
2018;507;12-15;18;14;32;SEC_507
2018;609;16-17;4;8;12;SEC_609
2018;313;03-11;71;73;144;SEC_313
2018;533;75 i +;130;69;199;SEC_533
2018;117;12-15;37;37;74;SEC_117
2018;538;12-15;25;36;61;SEC_538
2018;302;75 i +;73;54;127;SEC_302
2018;313;25-34;111;118;229;SEC_313
2018;608;75 i +;105;67;172;SEC_608
2018;101;03-11;70;67;137;SEC_101
2018;632;35-49;108;130;238;SEC_632
2018;205;35-49;106;109;215;SEC_205
2018;616;18-24;77;96;173;SEC_616
2018;526;18-24;86;75;161;SEC_526
2018;314;00-02;23;28;51;SEC_314
2018;138;65-74;57;53;110;SEC_138
2018;307;18-24;30;35;65;SEC_307
2018;614;12-15;25;16;41;SEC_614
2018;234;03-11;44;38;82;SEC_234
2018;107;65-74;101;72;173;SEC_107
2018;223;18-24;62;59;121;SEC_223
2018;247;50-64;125;108;233;SEC_247
2018;418;35-49;171;188;359;SEC_418
2018;529;65-74;40;30;70;SEC_529
2018;632;50-64;94;80;174;SEC_632
2018;223;25-34;112;112;224;SEC_223
2018;631;75 i +;77;64;141;SEC_631
2018;242;50-64;112;101;213;SEC_242
2018;106;25-34;88;106;194;SEC_106
2018;327;75 i +;39;26;65;SEC_327
2018;208;75 i +;210;118;328;SEC_208
2018;247;25-34;103;104;207;SEC_247
2018;223;35-49;147;151;298;SEC_223
2018;201;75 i +;59;40;99;SEC_201
2018;212;50-64;105;117;222;SEC_212
2018;507;18-24;25;48;73;SEC_507
2018;615;00-02;8;4;12;SEC_615
2018;132;16-17;21;18;39;SEC_132
2018;216;18-24;52;46;98;SEC_216
2018;248;18-24;46;60;106;SEC_248
2018;508;00-02;20;27;47;SEC_508
2018;502;50-64;140;140;280;SEC_502
2018;214;16-17;14;31;45;SEC_214
2018;224;03-11;68;67;135;SEC_224
2018;139;12-15;14;19;33;SEC_139
2018;616;25-34;103;134;237;SEC_616
2018;229;50-64;168;163;331;SEC_229
2018;425;25-34;86;78;164;SEC_425
2018;223;00-02;27;15;42;SEC_223
2018;318;00-02;8;8;16;SEC_318
2018;326;75 i +;6;7;13;SEC_326
2018;104;18-24;38;33;71;SEC_104
2018;319;00-02;20;26;46;SEC_319
2018;440;12-15;17;16;33;SEC_440
2018;402;25-34;81;63;144;SEC_402
2018;139;25-34;64;61;125;SEC_139
2018;231;12-15;13;33;46;SEC_231
2018;107;18-24;51;53;104;SEC_107
2018;517;03-11;109;101;210;SEC_517
2018;308;65-74;123;103;226;SEC_308
2018;501;50-64;109;88;197;SEC_501
2018;401;12-15;26;20;46;SEC_401
2018;301;12-15;22;21;43;SEC_301
2018;507;65-74;52;40;92;SEC_507
2018;614;65-74;87;61;148;SEC_614
2018;220;16-17;16;9;25;SEC_220
2018;430;75 i +;54;37;91;SEC_430
2018;309;65-74;53;41;94;SEC_309
2018;621;35-49;158;189;347;SEC_621
2018;524;65-74;50;40;90;SEC_524
2018;137;18-24;56;52;108;SEC_137
2018;114;65-74;117;77;194;SEC_114
2018;535;35-49;88;88;176;SEC_535
2018;618;65-74;91;59;150;SEC_618
2018;307;50-64;157;108;265;SEC_307
2018;632;00-02;7;15;22;SEC_632
2018;242;16-17;8;10;18;SEC_242
2018;403;16-17;9;6;15;SEC_403
2018;102;03-11;54;43;97;SEC_102
2018;418;12-15;31;29;60;SEC_418
2018;401;50-64;144;116;260;SEC_401
2018;112;75 i +;83;42;125;SEC_112
2018;135;65-74;89;85;174;SEC_135
2018;514;00-02;17;27;44;SEC_514
2018;129;03-11;33;55;88;SEC_129
2018;209;12-15;17;22;39;SEC_209
2018;326;65-74;17;16;33;SEC_326
2018;531;50-64;85;83;168;SEC_531
2018;626;75 i +;72;41;113;SEC_626
2018;538;25-34;87;87;174;SEC_538
2018;521;35-49;90;111;201;SEC_521
2018;440;18-24;43;37;80;SEC_440
2018;327;03-11;49;59;108;SEC_327
2018;318;35-49;83;75;158;SEC_318
2018;329;12-15;37;33;70;SEC_329
2018;422;35-49;165;168;333;SEC_422
2018;431;03-11;94;87;181;SEC_431
2018;322;25-34;98;95;193;SEC_322
2018;120;75 i +;64;52;116;SEC_120
2018;127;00-02;7;8;15;SEC_127
2018;106;00-02;14;16;30;SEC_106
2018;602;16-17;14;14;28;SEC_602
2018;302;25-34;113;101;214;SEC_302
2018;520;50-64;79;67;146;SEC_520
2018;134;35-49;158;178;336;SEC_134
2018;538;18-24;49;57;106;SEC_538
2018;416;16-17;21;12;33;SEC_416
2018;305;03-11;63;64;127;SEC_305
2018;105;35-49;144;137;281;SEC_105
2018;623;16-17;15;12;27;SEC_623
2018;526;03-11;86;91;177;SEC_526
2018;113;50-64;180;151;331;SEC_113
2018;301;50-64;132;103;235;SEC_301
2018;425;50-64;94;102;196;SEC_425
2018;127;35-49;98;80;178;SEC_127
2018;111;18-24;28;27;55;SEC_111
2018;123;35-49;146;130;276;SEC_123
2018;524;25-34;116;116;232;SEC_524
2018;205;00-02;8;8;16;SEC_205
2018;403;03-11;48;57;105;SEC_403
2018;416;00-02;25;25;50;SEC_416
2018;611;65-74;89;59;148;SEC_611
2018;114;25-34;67;69;136;SEC_114
2018;102;25-34;71;70;141;SEC_102
2018;623;00-02;15;16;31;SEC_623
2018;632;25-34;40;51;91;SEC_632
2018;534;75 i +;69;51;120;SEC_534
2018;201;00-02;30;47;77;SEC_201
2018;414;00-02;38;30;68;SEC_414
2018;511;03-11;100;116;216;SEC_511
2018;234;65-74;34;28;62;SEC_234
2018;326;18-24;27;26;53;SEC_326
2018;245;35-49;139;159;298;SEC_245
2018;309;03-11;65;61;126;SEC_309
2018;313;16-17;20;25;45;SEC_313
2018;109;16-17;9;7;16;SEC_109
2018;514;12-15;30;40;70;SEC_514
2018;423;75 i +;78;59;137;SEC_423
2018;502;65-74;88;83;171;SEC_502
2018;630;25-34;47;43;90;SEC_630
2018;420;03-11;89;89;178;SEC_420
2018;508;50-64;141;138;279;SEC_508
2018;306;18-24;67;64;131;SEC_306
2018;534;12-15;21;17;38;SEC_534
2018;606;03-11;38;51;89;SEC_606
2018;119;65-74;133;111;244;SEC_119
2018;302;65-74;122;106;228;SEC_302
2018;110;16-17;9;9;18;SEC_110
2018;238;25-34;82;90;172;SEC_238
2018;631;16-17;5;8;13;SEC_631
2018;101;25-34;105;101;206;SEC_101
2018;613;16-17;13;8;21;SEC_613
2018;214;75 i +;117;63;180;SEC_214
2018;129;75 i +;108;64;172;SEC_129
2018;306;75 i +;91;55;146;SEC_306
2018;236;12-15;21;20;41;SEC_236
2018;122;03-11;50;54;104;SEC_122
2018;534;25-34;85;70;155;SEC_534
2018;407;00-02;16;18;34;SEC_407
2018;128;12-15;19;20;39;SEC_128
2018;425;65-74;39;29;68;SEC_425
2018;110;35-49;130;116;246;SEC_110
2018;621;65-74;148;133;281;SEC_621
2018;306;50-64;164;161;325;SEC_306
2018;220;35-49;246;199;445;SEC_220
2018;630;35-49;98;110;208;SEC_630
2018;237;00-02;18;18;36;SEC_237
2018;612;00-02;7;9;16;SEC_612
2018;513;35-49;181;205;386;SEC_513
2018;441;25-34;160;158;318;SEC_441
2018;624;03-11;48;43;91;SEC_624
2018;130;75 i +;96;53;149;SEC_130
2018;528;18-24;54;40;94;SEC_528
2018;311;12-15;22;30;52;SEC_311
2018;221;50-64;191;172;363;SEC_221
2018;127;18-24;19;23;42;SEC_127
2018;615;18-24;22;24;46;SEC_615
2018;435;18-24;40;59;99;SEC_435
2018;234;00-02;16;19;35;SEC_234
2018;136;50-64;123;98;221;SEC_136
2018;303;12-15;23;26;49;SEC_303
2018;404;65-74;68;49;117;SEC_404
2018;431;65-74;56;53;109;SEC_431
2018;327;00-02;10;22;32;SEC_327
2018;623;35-49;152;155;307;SEC_623
2018;123;50-64;143;130;273;SEC_123
2018;533;18-24;88;78;166;SEC_533
2018;211;12-15;17;30;47;SEC_211
2018;313;35-49;220;215;435;SEC_313
2018;622;00-02;10;7;17;SEC_622
2018;630;65-74;79;63;142;SEC_630
2018;407;65-74;51;24;75;SEC_407
2018;538;03-11;50;45;95;SEC_538
2018;304;35-49;303;284;587;SEC_304
2018;126;65-74;86;63;149;SEC_126
2018;505;16-17;9;7;16;SEC_505
2018;137;50-64;161;147;308;SEC_137
2018;217;65-74;67;63;130;SEC_217
2018;602;75 i +;93;98;191;SEC_602
2018;240;35-49;235;213;448;SEC_240
2018;526;75 i +;95;59;154;SEC_526
2018;506;75 i +;120;97;217;SEC_506
2018;503;50-64;107;67;174;SEC_503
2018;508;12-15;31;30;61;SEC_508
2018;437;65-74;75;56;131;SEC_437
2018;110;25-34;62;60;122;SEC_110
2018;208;18-24;49;58;107;SEC_208
2018;319;16-17;13;19;32;SEC_319
2018;304;16-17;8;13;21;SEC_304
2018;316;25-34;161;150;311;SEC_316
2018;606;16-17;6;7;13;SEC_606
2018;525;75 i +;71;36;107;SEC_525
2018;220;03-11;69;63;132;SEC_220
2018;320;16-17;3;2;5;SEC_320
2018;315;18-24;64;60;124;SEC_315
2018;207;35-49;252;231;483;SEC_207
2018;236;18-24;39;38;77;SEC_236
2018;430;65-74;32;23;55;SEC_430
2018;523;12-15;26;24;50;SEC_523
2018;420;25-34;163;156;319;SEC_420
2018;430;50-64;105;95;200;SEC_430
2018;102;35-49;147;165;312;SEC_102
2018;118;03-11;54;81;135;SEC_118
2018;608;18-24;41;37;78;SEC_608
2018;504;75 i +;106;83;189;SEC_504
2018;526;16-17;15;15;30;SEC_526
2018;132;25-34;137;142;279;SEC_132
2018;209;18-24;39;36;75;SEC_209
2018;114;35-49;173;184;357;SEC_114
2018;324;50-64;94;89;183;SEC_324
2018;409;75 i +;116;83;199;SEC_409
2018;320;25-34;41;43;84;SEC_320
2018;104;75 i +;73;40;113;SEC_104
2018;140;35-49;128;132;260;SEC_140
2018;616;75 i +;64;39;103;SEC_616
2018;420;16-17;22;27;49;SEC_420
2018;323;18-24;74;61;135;SEC_323
2018;111;65-74;63;40;103;SEC_111
2018;327;65-74;82;77;159;SEC_327
2018;309;50-64;105;94;199;SEC_309
2018;141;12-15;44;52;96;SEC_141
2018;324;12-15;24;24;48;SEC_324
2018;514;65-74;49;35;84;SEC_514
2018;116;25-34;67;71;138;SEC_116
2018;132;03-11;91;75;166;SEC_132
2018;632;18-24;37;33;70;SEC_632
2018;140;65-74;55;40;95;SEC_140
2018;407;25-34;67;67;134;SEC_407
2018;607;00-02;9;5;14;SEC_607
2018;524;35-49;175;186;361;SEC_524
2018;622;65-74;62;42;104;SEC_622
2018;132;00-02;17;22;39;SEC_132
2018;233;25-34;95;86;181;SEC_233
2018;116;03-11;55;53;108;SEC_116
2018;301;03-11;63;49;112;SEC_301
2018;405;75 i +;145;89;234;SEC_405
2018;433;03-11;99;102;201;SEC_433
2018;232;35-49;127;136;263;SEC_232
2018;123;65-74;61;65;126;SEC_123
2018;404;75 i +;84;58;142;SEC_404
2018;141;65-74;11;14;25;SEC_141
2018;328;00-02;45;48;93;SEC_328
2018;246;00-02;16;17;33;SEC_246
2018;129;12-15;22;19;41;SEC_129
2018;306;25-34;122;129;251;SEC_306
2018;226;25-34;138;175;313;SEC_226
2018;116;35-49;161;166;327;SEC_116
2018;501;35-49;103;117;220;SEC_501
2018;426;50-64;92;86;178;SEC_426
2018;208;16-17;8;17;25;SEC_208
2018;118;16-17;16;7;23;SEC_118
2018;427;03-11;80;108;188;SEC_427
2018;317;03-11;60;60;120;SEC_317
2018;131;16-17;3;15;18;SEC_131
2018;401;35-49;127;120;247;SEC_401
2018;102;00-02;17;18;35;SEC_102
2018;312;75 i +;110;72;182;SEC_312
2018;529;35-49;194;167;361;SEC_529
2018;245;16-17;10;15;25;SEC_245
2018;624;12-15;17;18;35;SEC_624
2018;537;25-34;98;95;193;SEC_537
2018;517;00-02;27;36;63;SEC_517
2018;108;03-11;64;65;129;SEC_108
2018;311;65-74;69;42;111;SEC_311
2018;531;12-15;20;13;33;SEC_531
2018;531;16-17;10;8;18;SEC_531
2018;109;12-15;19;17;36;SEC_109
2018;210;18-24;36;31;67;SEC_210
2018;137;75 i +;63;55;118;SEC_137
2018;605;35-49;189;184;373;SEC_605
2018;621;16-17;6;10;16;SEC_621
2018;615;16-17;9;4;13;SEC_615
2018;124;65-74;50;28;78;SEC_124
2018;613;00-02;12;8;20;SEC_613
2018;328;65-74;25;17;42;SEC_328
2018;316;75 i +;90;56;146;SEC_316
2018;523;18-24;54;60;114;SEC_523
2018;506;00-02;12;16;28;SEC_506
2018;517;12-15;44;39;83;SEC_517
2018;108;12-15;21;18;39;SEC_108
2018;115;35-49;154;155;309;SEC_115
2018;134;16-17;6;11;17;SEC_134
2018;205;12-15;17;22;39;SEC_205
2018;312;16-17;13;13;26;SEC_312
2018;109;65-74;74;66;140;SEC_109
2018;511;65-74;101;61;162;SEC_511
2018;607;03-11;37;39;76;SEC_607
2018;141;35-49;250;250;500;SEC_141
2018;606;65-74;56;29;85;SEC_606
2018;320;35-49;176;189;365;SEC_320
2018;630;50-64;79;61;140;SEC_630
2018;618;18-24;38;59;97;SEC_618
2018;410;16-17;12;20;32;SEC_410
2018;402;03-11;39;55;94;SEC_402
2018;311;16-17;16;19;35;SEC_311
2018;606;35-49;124;111;235;SEC_606
2018;118;35-49;186;188;374;SEC_118
2018;430;00-02;24;17;41;SEC_430
2018;304;12-15;33;20;53;SEC_304
2018;617;50-64;79;82;161;SEC_617
2018;626;12-15;17;13;30;SEC_626
2018;621;50-64;145;84;229;SEC_621
2018;130;25-34;60;65;125;SEC_130
2018;201;35-49;259;266;525;SEC_201
2018;228;03-11;100;100;200;SEC_228
2018;135;25-34;90;97;187;SEC_135
2018;201;16-17;9;10;19;SEC_201
2018;322;75 i +;78;39;117;SEC_322
2018;120;00-02;21;21;42;SEC_120
2018;316;00-02;22;24;46;SEC_316
2018;111;50-64;93;76;169;SEC_111
2018;532;16-17;18;9;27;SEC_532
2018;107;50-64;145;134;279;SEC_107
2018;505;25-34;63;40;103;SEC_505
2018;325;00-02;16;25;41;SEC_325
2018;404;03-11;68;68;136;SEC_404
2018;314;03-11;102;100;202;SEC_314
2018;315;25-34;113;130;243;SEC_315
2018;239;00-02;11;13;24;SEC_239
2018;112;50-64;170;144;314;SEC_112
2018;238;65-74;41;30;71;SEC_238
2018;410;12-15;30;32;62;SEC_410
2018;402;16-17;6;8;14;SEC_402
2018;138;16-17;3;7;10;SEC_138
2018;125;18-24;49;64;113;SEC_125
2018;223;50-64;119;107;226;SEC_223
2018;612;03-11;44;29;73;SEC_612
2018;309;18-24;37;40;77;SEC_309
2018;323;12-15;39;43;82;SEC_323
2018;245;00-02;19;19;38;SEC_245
2018;122;25-34;64;56;120;SEC_122
2018;622;35-49;96;109;205;SEC_622
2018;207;18-24;70;72;142;SEC_207
2018;229;75 i +;83;43;126;SEC_229
2018;236;00-02;13;10;23;SEC_236
2018;304;00-02;40;31;71;SEC_304
2018;624;16-17;7;13;20;SEC_624
2018;506;18-24;51;58;109;SEC_506
2018;310;50-64;104;72;176;SEC_310
2018;249;16-17;13;5;18;SEC_249
2018;403;75 i +;103;83;186;SEC_403
2018;404;50-64;122;122;244;SEC_404
2018;124;75 i +;51;42;93;SEC_124
2018;511;50-64;205;159;364;SEC_511
2018;508;75 i +;81;49;130;SEC_508
2018;403;50-64;108;107;215;SEC_403
2018;328;75 i +;33;10;43;SEC_328
2018;318;75 i +;50;27;77;SEC_318
2018;521;00-02;7;6;13;SEC_521
2018;238;00-02;13;8;21;SEC_238
2018;101;16-17;17;12;29;SEC_101
2018;248;35-49;166;164;330;SEC_248
2018;619;35-49;121;130;251;SEC_619
2018;432;16-17;12;7;19;SEC_432
2018;319;03-11;75;105;180;SEC_319
2018;502;12-15;19;34;53;SEC_502
2018;423;25-34;78;70;148;SEC_423
2018;118;75 i +;76;68;144;SEC_118
2018;117;18-24;65;55;120;SEC_117
2018;309;35-49;178;184;362;SEC_309
2018;329;35-49;257;249;506;SEC_329
2018;613;18-24;23;39;62;SEC_613
2018;112;35-49;209;204;413;SEC_112
2018;524;16-17;10;10;20;SEC_524
2018;407;12-15;15;17;32;SEC_407
2018;228;25-34;198;189;387;SEC_228
2018;245;18-24;50;60;110;SEC_245
2018;625;75 i +;77;54;131;SEC_625
2018;435;25-34;109;107;216;SEC_435
2018;105;25-34;71;85;156;SEC_105
2018;402;35-49;123;120;243;SEC_402
2018;617;00-02;11;10;21;SEC_617
2018;423;16-17;15;14;29;SEC_423
2018;303;03-11;69;61;130;SEC_303
2018;433;00-02;30;43;73;SEC_433
2018;426;18-24;51;41;92;SEC_426
2018;411;03-11;37;31;68;SEC_411
2018;321;18-24;80;74;154;SEC_321
2018;402;12-15;22;13;35;SEC_402
2018;133;00-02;11;13;24;SEC_133
2018;316;50-64;304;229;533;SEC_316
2018;248;12-15;30;13;43;SEC_248
2018;615;35-49;101;99;200;SEC_615
2018;110;65-74;124;80;204;SEC_110
2018;209;03-11;41;40;81;SEC_209
2018;422;65-74;41;30;71;SEC_422
2018;625;16-17;12;14;26;SEC_625
2018;610;25-34;52;63;115;SEC_610
2018;105;03-11;52;55;107;SEC_105
2018;320;18-24;44;49;93;SEC_320
2018;107;75 i +;109;75;184;SEC_107
2018;208;25-34;115;131;246;SEC_208
2018;105;12-15;24;22;46;SEC_105
2018;201;50-64;109;94;203;SEC_201
2018;503;00-02;4;5;9;SEC_503
2018;236;50-64;94;86;180;SEC_236
2018;207;16-17;15;18;33;SEC_207
2018;236;03-11;43;54;97;SEC_236
2018;310;16-17;9;5;14;SEC_310
2018;420;18-24;94;97;191;SEC_420
2018;410;35-49;198;179;377;SEC_410
2018;120;18-24;70;64;134;SEC_120
2018;609;35-49;108;89;197;SEC_609
2018;518;65-74;59;40;99;SEC_518
2018;120;35-49;191;182;373;SEC_120
2018;618;75 i +;96;86;182;SEC_618
2018;109;35-49;124;123;247;SEC_109
2018;135;12-15;17;26;43;SEC_135
2018;506;50-64;168;154;322;SEC_506
2018;109;18-24;34;39;73;SEC_109
2018;533;03-11;101;91;192;SEC_533
2018;508;25-34;128;119;247;SEC_508
2018;138;50-64;90;64;154;SEC_138
2018;115;12-15;23;21;44;SEC_115
2018;315;12-15;24;43;67;SEC_315
2018;503;75 i +;43;27;70;SEC_503
2018;601;50-64;184;172;356;SEC_601
2018;323;35-49;232;226;458;SEC_323
2018;305;50-64;201;173;374;SEC_305
2018;501;03-11;28;29;57;SEC_501
2018;247;75 i +;72;50;122;SEC_247
2018;127;12-15;20;17;37;SEC_127
2018;221;16-17;24;21;45;SEC_221
2018;503;65-74;69;69;138;SEC_503
2018;320;00-02;14;4;18;SEC_320
2018;214;65-74;81;49;130;SEC_214
2018;220;25-34;144;162;306;SEC_220
2018;107;16-17;10;19;29;SEC_107
2018;323;03-11;67;99;166;SEC_323
2018;210;00-02;5;8;13;SEC_210
2018;605;75 i +;141;126;267;SEC_605
2018;119;00-02;16;10;26;SEC_119
2018;506;65-74;180;123;303;SEC_506
2018;616;00-02;28;22;50;SEC_616
2018;238;18-24;42;58;100;SEC_238
2018;436;18-24;88;92;180;SEC_436
2018;528;12-15;21;26;47;SEC_528
2018;416;03-11;61;75;136;SEC_416
2018;402;18-24;38;35;73;SEC_402
2018;623;03-11;57;49;106;SEC_623
2018;316;18-24;62;61;123;SEC_316
2018;243;18-24;68;81;149;SEC_243
2018;412;25-34;112;103;215;SEC_412
2018;437;12-15;32;29;61;SEC_437
2018;624;50-64;72;85;157;SEC_624
2018;318;12-15;14;17;31;SEC_318
2018;329;18-24;35;37;72;SEC_329
2018;402;00-02;13;20;33;SEC_402
2018;518;00-02;14;17;31;SEC_518
2018;437;35-49;221;191;412;SEC_437
2018;207;00-02;25;22;47;SEC_207
2018;113;03-11;67;84;151;SEC_113
2018;411;35-49;103;112;215;SEC_411
2018;231;25-34;111;93;204;SEC_231
2018;213;65-74;54;38;92;SEC_213
2018;223;03-11;66;56;122;SEC_223
2018;328;35-49;293;272;565;SEC_328
2018;420;65-74;96;69;165;SEC_420
2018;126;16-17;11;12;23;SEC_126
2018;317;16-17;7;12;19;SEC_317
2018;228;50-64;177;179;356;SEC_228
2018;431;00-02;31;30;61;SEC_431
2018;216;03-11;55;65;120;SEC_216
2018;214;03-11;111;117;228;SEC_214
2018;239;25-34;88;98;186;SEC_239
2018;504;50-64;74;78;152;SEC_504
2018;118;18-24;64;53;117;SEC_118
2018;226;65-74;87;71;158;SEC_226
2018;614;25-34;41;50;91;SEC_614
2018;513;12-15;26;29;55;SEC_513
2018;233;75 i +;58;26;84;SEC_233
2018;135;00-02;14;24;38;SEC_135
2018;131;18-24;39;36;75;SEC_131
2018;623;18-24;38;46;84;SEC_623
2018;116;16-17;9;8;17;SEC_116
2018;139;65-74;63;51;114;SEC_139
2018;403;00-02;10;11;21;SEC_403
2018;313;00-02;28;14;42;SEC_313
2018;406;25-34;123;94;217;SEC_406
2018;239;18-24;45;45;90;SEC_239
2018;510;16-17;10;9;19;SEC_510
2018;619;75 i +;117;87;204;SEC_619
2018;303;16-17;9;14;23;SEC_303
2018;106;35-49;184;189;373;SEC_106
2018;205;16-17;12;13;25;SEC_205
2018;237;50-64;141;115;256;SEC_237
2018;617;18-24;28;39;67;SEC_617
2018;426;75 i +;44;22;66;SEC_426
2018;242;25-34;95;90;185;SEC_242
2018;618;25-34;46;50;96;SEC_618
2018;419;03-11;87;116;203;SEC_419
2018;236;75 i +;91;50;141;SEC_236
2018;236;65-74;55;30;85;SEC_236
2018;240;00-02;30;23;53;SEC_240
2018;517;35-49;258;290;548;SEC_517
2018;624;35-49;103;131;234;SEC_624
2018;107;25-34;90;103;193;SEC_107
2018;122;00-02;14;13;27;SEC_122
2018;136;25-34;74;69;143;SEC_136
2018;302;00-02;26;19;45;SEC_302
2018;133;03-11;35;31;66;SEC_133
2018;223;65-74;54;31;85;SEC_223
2018;312;50-64;164;159;323;SEC_312
2018;326;35-49;247;279;526;SEC_326
2018;608;00-02;15;10;25;SEC_608
2018;510;65-74;64;40;104;SEC_510
2018;312;65-74;119;64;183;SEC_312
2018;441;65-74;140;121;261;SEC_441
2018;507;35-49;104;102;206;SEC_507
2018;119;25-34;70;60;130;SEC_119
2018;102;65-74;127;112;239;SEC_102
2018;108;75 i +;89;52;141;SEC_108
2018;510;18-24;46;36;82;SEC_510
2018;525;25-34;64;46;110;SEC_525
2018;136;75 i +;80;43;123;SEC_136
2018;217;03-11;65;54;119;SEC_217
2018;202;00-02;29;28;57;SEC_202
2018;327;50-64;157;127;284;SEC_327
2018;322;50-64;108;98;206;SEC_322
2018;533;12-15;37;41;78;SEC_533
2018;306;35-49;189;176;365;SEC_306
2018;112;18-24;61;61;122;SEC_112
2018;412;35-49;148;192;340;SEC_412
2018;217;16-17;12;13;25;SEC_217
2018;140;00-02;10;14;24;SEC_140
2018;135;75 i +;94;55;149;SEC_135
2018;246;18-24;53;55;108;SEC_246
2018;140;50-64;99;83;182;SEC_140
2018;523;03-11;56;60;116;SEC_523
2018;124;35-49;96;92;188;SEC_124
2018;502;18-24;59;62;121;SEC_502
2018;113;75 i +;69;59;128;SEC_113
2018;406;75 i +;79;68;147;SEC_406
2018;423;50-64;97;75;172;SEC_423
2018;249;25-34;92;100;192;SEC_249
2018;419;12-15;33;47;80;SEC_419
2018;535;16-17;3;13;16;SEC_535
2018;201;18-24;25;53;78;SEC_201
2018;419;35-49;233;285;518;SEC_419
2018;310;75 i +;44;25;69;SEC_310
2018;101;50-64;192;186;378;SEC_101
2018;245;50-64;102;94;196;SEC_245
2018;245;03-11;50;55;105;SEC_245
2018;308;75 i +;113;91;204;SEC_308
2018;201;03-11;76;96;172;SEC_201
2018;427;75 i +;87;39;126;SEC_427
2018;105;50-64;132;106;238;SEC_105
2018;103;75 i +;55;33;88;SEC_103
2018;231;16-17;14;17;31;SEC_231
2018;128;18-24;28;23;51;SEC_128
2018;505;00-02;8;13;21;SEC_505
2018;412;16-17;16;19;35;SEC_412
2018;234;35-49;130;141;271;SEC_234
2018;305;18-24;56;66;122;SEC_305
2018;204;16-17;17;12;29;SEC_204
2018;134;00-02;12;20;32;SEC_134
2018;114;18-24;48;47;95;SEC_114
2018;433;16-17;16;23;39;SEC_433
2018;532;12-15;25;30;55;SEC_532
2018;243;65-74;52;50;102;SEC_243
2018;612;75 i +;100;71;171;SEC_612
2018;243;50-64;180;154;334;SEC_243
2018;315;65-74;86;85;171;SEC_315
2018;319;25-34;82;86;168;SEC_319
2018;621;00-02;17;17;34;SEC_621
2018;320;25-34;65;62;127;SEC_320
2018;421;50-64;113;97;210;SEC_421
2018;528;00-02;11;22;33;SEC_528
2018;537;16-17;16;5;21;SEC_537
2018;240;25-34;154;145;299;SEC_240
2018;119;50-64;124;94;218;SEC_119
2018;510;25-34;75;79;154;SEC_510
2018;243;75 i +;108;64;172;SEC_243
2018;115;16-17;9;13;22;SEC_115
2018;214;18-24;100;93;193;SEC_214
2018;624;75 i +;62;71;133;SEC_624
2018;209;65-74;37;35;72;SEC_209
2018;315;00-02;27;27;54;SEC_315
2018;537;50-64;131;111;242;SEC_537
2018;240;12-15;37;34;71;SEC_240
2018;612;65-74;76;54;130;SEC_612
2018;437;00-02;18;27;45;SEC_437
2018;529;16-17;8;17;25;SEC_529
2018;506;12-15;25;34;59;SEC_506
2018;132;65-74;141;125;266;SEC_132
2018;232;16-17;7;6;13;SEC_232
2018;423;35-49;135;138;273;SEC_423
2018;233;65-74;27;22;49;SEC_233
2018;430;12-15;23;22;45;SEC_430
2018;213;18-24;33;44;77;SEC_213
2018;105;18-24;30;30;60;SEC_105
2018;534;18-24;36;39;75;SEC_534
2018;210;16-17;4;8;12;SEC_210
2018;128;35-49;155;160;315;SEC_128
2018;505;65-74;138;86;224;SEC_505
2018;113;16-17;8;18;26;SEC_113
2018;214;35-49;324;307;631;SEC_214
2018;505;18-24;25;21;46;SEC_505
2018;525;65-74;36;37;73;SEC_525
2018;409;35-49;239;265;504;SEC_409
2018;425;00-02;13;10;23;SEC_425
2018;245;12-15;21;29;50;SEC_245
2018;132;35-49;218;254;472;SEC_132
2018;237;65-74;54;48;102;SEC_237
2018;404;35-49;168;175;343;SEC_404
2018;207;75 i +;104;57;161;SEC_207
2018;325;75 i +;179;104;283;SEC_325
2018;316;16-17;9;15;24;SEC_316
2018;520;12-15;17;22;39;SEC_520
2018;213;35-49;129;114;243;SEC_213
2018;607;16-17;4;4;8;SEC_607
2018;211;18-24;48;73;121;SEC_211
2018;432;03-11;55;58;113;SEC_432
2018;538;65-74;66;27;93;SEC_538
2018;325;35-49;189;174;363;SEC_325
2018;521;16-17;6;8;14;SEC_521
2018;407;35-49;126;148;274;SEC_407
2018;610;16-17;10;13;23;SEC_610
2018;610;50-64;93;87;180;SEC_610
2018;605;65-74;128;85;213;SEC_605
2018;609;25-34;36;43;79;SEC_609
2018;621;18-24;39;50;89;SEC_621
2018;310;00-02;15;13;28;SEC_310
2018;623;50-64;111;113;224;SEC_623
2018;248;25-34;97;106;203;SEC_248
2018;213;25-34;80;70;150;SEC_213
2018;204;03-11;64;69;133;SEC_204
2018;137;03-11;76;51;127;SEC_137
2018;520;35-49;97;85;182;SEC_520
2018;120;16-17;11;24;35;SEC_120
2018;233;35-49;136;134;270;SEC_233
2018;209;35-49;144;105;249;SEC_209
2018;622;16-17;3;7;10;SEC_622
2018;520;25-34;66;77;143;SEC_520
2018;108;35-49;165;173;338;SEC_108
2018;113;00-02;18;19;37;SEC_113
2018;239;75 i +;92;47;139;SEC_239
2018;319;35-49;244;238;482;SEC_319
2018;517;50-64;201;173;374;SEC_517
2018;121;12-15;17;16;33;SEC_121
2018;615;75 i +;71;55;126;SEC_615
2018;249;12-15;14;17;31;SEC_249
2018;437;25-34;109;133;242;SEC_437
2018;301;35-49;168;166;334;SEC_301
2018;611;75 i +;110;105;215;SEC_611
2018;327;18-24;40;51;91;SEC_327
2018;624;25-34;51;46;97;SEC_624
2018;623;65-74;130;101;231;SEC_623
2018;630;12-15;12;15;27;SEC_630
2018;517;25-34;179;181;360;SEC_517
2018;404;16-17;14;17;31;SEC_404
2018;109;25-34;67;60;127;SEC_109
2018;523;25-34;102;114;216;SEC_523
2018;133;18-24;21;25;46;SEC_133
2018;237;25-34;105;119;224;SEC_237
2018;211;25-34;112;133;245;SEC_211
2018;518;16-17;10;8;18;SEC_518
2018;141;03-11;116;128;244;SEC_141
2018;308;03-11;80;71;151;SEC_308
2018;226;18-24;65;80;145;SEC_226
2018;106;75 i +;76;50;126;SEC_106
2018;324;18-24;37;50;87;SEC_324
2018;118;00-02;18;16;34;SEC_118
2018;126;12-15;18;14;32;SEC_126
2018;326;12-15;25;18;43;SEC_326
2018;426;16-17;5;7;12;SEC_426
2018;133;65-74;58;41;99;SEC_133
2018;309;00-02;17;21;38;SEC_309
2018;237;16-17;13;16;29;SEC_237
2018;432;18-24;56;47;103;SEC_432
2018;409;16-17;22;17;39;SEC_409
2018;311;35-49;191;217;408;SEC_311
2018;125;25-34;83;88;171;SEC_125
2018;537;12-15;22;23;45;SEC_537
2018;228;75 i +;143;90;233;SEC_228
2018;524;12-15;27;29;56;SEC_524
2018;616;16-17;22;26;48;SEC_616
2018;307;35-49;137;138;275;SEC_307
2018;532;00-02;17;21;38;SEC_532
2018;517;75 i +;88;59;147;SEC_517
2018;220;00-02;31;30;61;SEC_220
2018;234;50-64;95;86;181;SEC_234
2018;236;35-49;123;132;255;SEC_236
2018;401;16-17;9;10;19;SEC_401
2018;221;25-34;162;172;334;SEC_221
2018;520;00-02;13;14;27;SEC_520
2018;238;75 i +;50;35;85;SEC_238
2018;425;35-49;125;118;243;SEC_425
2018;322;65-74;61;58;119;SEC_322
2018;112;03-11;60;61;121;SEC_112
2018;521;65-74;110;88;198;SEC_521
2018;134;12-15;24;30;54;SEC_134
2018;302;03-11;54;53;107;SEC_302
2018;437;18-24;66;84;150;SEC_437
2018;322;03-11;54;59;113;SEC_322
2018;508;03-11;68;80;148;SEC_508
2018;130;65-74;42;25;67;SEC_130
2018;211;75 i +;77;40;117;SEC_211
2018;530;18-24;62;80;142;SEC_530
2018;232;75 i +;70;50;120;SEC_232
2018;319;18-24;56;54;110;SEC_319
2018;204;75 i +;109;59;168;SEC_204
2018;431;50-64;134;109;243;SEC_431
2018;139;75 i +;46;35;81;SEC_139
2018;212;35-49;210;196;406;SEC_212
2018;510;03-11;47;40;87;SEC_510
2018;124;16-17;7;6;13;SEC_124
2018;613;50-64;83;84;167;SEC_613
2018;615;12-15;12;10;22;SEC_615
2018;608;35-49;137;168;305;SEC_608
2018;126;03-11;29;40;69;SEC_126
2018;234;16-17;9;6;15;SEC_234
2018;405;50-64;166;167;333;SEC_405
2018;324;65-74;44;30;74;SEC_324
2018;328;18-24;52;41;93;SEC_328
2018;432;65-74;95;83;178;SEC_432
2018;610;03-11;37;45;82;SEC_610
2018;119;03-11;41;34;75;SEC_119
2018;537;35-49;156;135;291;SEC_537
2018;106;18-24;45;51;96;SEC_106
2018;534;50-64;76;74;150;SEC_534
2018;537;18-24;55;55;110;SEC_537
2018;237;03-11;72;62;134;SEC_237
2018;226;50-64;195;147;342;SEC_226
2018;129;50-64;101;100;201;SEC_129
2018;419;75 i +;121;69;190;SEC_419
2018;125;12-15;35;35;70;SEC_125
2018;208;00-02;14;18;32;SEC_208
2018;128;65-74;64;42;106;SEC_128
2018;115;65-74;82;74;156;SEC_115
2018;314;25-34;127;182;309;SEC_314
2018;110;50-64;107;86;193;SEC_110
2018;606;00-02;9;21;30;SEC_606
2018;412;50-64;173;129;302;SEC_412
2018;216;50-64;123;102;225;SEC_216
2018;405;00-02;23;29;52;SEC_405
2018;231;50-64;112;104;216;SEC_231
2018;513;18-24;61;67;128;SEC_513
2018;624;00-02;11;7;18;SEC_624
2018;621;25-34;69;68;137;SEC_621
2018;406;16-17;12;13;25;SEC_406
2018;106;03-11;61;69;130;SEC_106
2018;116;65-74;121;81;202;SEC_116
2018;614;03-11;32;48;80;SEC_614
2018;533;00-02;25;28;53;SEC_533
2018;233;03-11;49;61;110;SEC_233
2018;124;00-02;11;13;24;SEC_124
2018;406;65-74;66;58;124;SEC_406
2018;112;00-02;20;16;36;SEC_112
2018;501;75 i +;57;42;99;SEC_501
2018;625;35-49;116;109;225;SEC_625
2018;216;12-15;32;31;63;SEC_216
2018;535;00-02;6;4;10;SEC_535
2018;136;65-74;65;68;133;SEC_136
2018;125;50-64;140;140;280;SEC_125
2018;137;35-49;187;155;342;SEC_137
2018;326;03-11;88;97;185;SEC_326
2018;627;03-11;24;36;60;SEC_627
2018;127;03-11;28;27;55;SEC_127
2018;317;75 i +;42;24;66;SEC_317
2018;324;75 i +;41;28;69;SEC_324
2018;247;18-24;48;36;84;SEC_247
2018;612;25-34;46;42;88;SEC_612
2018;534;65-74;52;48;100;SEC_534
2018;319;12-15;46;46;92;SEC_319
2018;202;03-11;70;77;147;SEC_202
2018;124;50-64;95;75;170;SEC_124
2018;220;50-64;178;155;333;SEC_220
2018;105;65-74;82;70;152;SEC_105
2018;229;35-49;257;258;515;SEC_229
2018;310;03-11;43;46;89;SEC_310
2018;534;16-17;9;10;19;SEC_534
2018;631;25-34;50;52;102;SEC_631
2018;228;18-24;97;96;193;SEC_228
2018;315;03-11;82;75;157;SEC_315
2018;414;35-49;267;257;524;SEC_414
2018;135;35-49;163;189;352;SEC_135
2018;319;50-64;167;148;315;SEC_319
2018;201;12-15;34;36;70;SEC_201
2018;511;00-02;32;40;72;SEC_511
2018;622;03-11;27;27;54;SEC_622
2018;625;00-02;15;10;25;SEC_625
2018;238;16-17;7;4;11;SEC_238
2018;314;75 i +;87;66;153;SEC_314
2018;104;03-11;36;26;62;SEC_104
2018;307;03-11;56;41;97;SEC_307
2018;626;00-02;11;14;25;SEC_626
2018;518;03-11;51;44;95;SEC_518
2018;631;18-24;32;28;60;SEC_631
2018;618;12-15;37;27;64;SEC_618
2018;514;35-49;191;179;370;SEC_514
2018;531;18-24;52;51;103;SEC_531
2018;535;25-34;58;62;120;SEC_535
2018;624;65-74;116;79;195;SEC_624
2018;126;00-02;15;11;26;SEC_126
2018;511;16-17;20;16;36;SEC_511
2018;107;03-11;68;60;128;SEC_107
2018;611;03-11;77;96;173;SEC_611
2018;141;18-24;20;23;43;SEC_141
2018;419;50-64;161;175;336;SEC_419
2018;112;16-17;17;17;34;SEC_112
2018;322;16-17;15;18;33;SEC_322
2018;316;03-11;49;75;124;SEC_316
2018;138;00-02;7;10;17;SEC_138
2018;248;50-64;124;112;236;SEC_248
2018;426;35-49;120;162;282;SEC_426
2018;231;35-49;178;184;362;SEC_231
2018;529;00-02;16;16;32;SEC_529
2018;302;12-15;16;10;26;SEC_302
2018;126;18-24;34;31;65;SEC_126
2018;404;25-34;115;100;215;SEC_404
2018;115;18-24;40;54;94;SEC_115
2018;249;75 i +;68;39;107;SEC_249
2018;220;18-24;73;72;145;SEC_220
2018;309;16-17;11;12;23;SEC_309
2018;136;03-11;61;58;119;SEC_136
2018;249;35-49;121;119;240;SEC_249
2018;125;00-02;13;15;28;SEC_125
2018;613;03-11;39;50;89;SEC_613
2018;504;03-11;31;44;75;SEC_504
2018;211;50-64;124;100;224;SEC_211
2018;224;65-74;49;37;86;SEC_224
2018;127;50-64;100;82;182;SEC_127
2018;421;16-17;18;17;35;SEC_421
2018;432;75 i +;80;55;135;SEC_432
2018;409;03-11;85;87;172;SEC_409
2018;217;18-24;55;62;117;SEC_217
2018;321;16-17;13;18;31;SEC_321
2018;205;75 i +;69;51;120;SEC_205
2018;301;25-34;74;91;165;SEC_301
2018;209;25-34;86;86;172;SEC_209
2018;407;75 i +;79;48;127;SEC_407
2018;139;00-02;9;6;15;SEC_139
2018;508;16-17;16;11;27;SEC_508
2018;247;03-11;75;67;142;SEC_247
2018;631;00-02;8;12;20;SEC_631
2018;202;18-24;68;83;151;SEC_202
2018;128;03-11;42;53;95;SEC_128
2018;314;12-15;36;41;77;SEC_314
2018;514;50-64;131;125;256;SEC_514
2018;530;65-74;58;37;95;SEC_530
2018;301;16-17;9;8;17;SEC_301
2018;533;35-49;242;262;504;SEC_533
2018;414;50-64;169;142;311;SEC_414
2018;221;03-11;83;88;171;SEC_221
2018;532;75 i +;102;66;168;SEC_532
2018;246;65-74;35;31;66;SEC_246
2018;245;65-74;53;35;88;SEC_245
2018;247;65-74;53;39;92;SEC_247
2018;102;50-64;149;131;280;SEC_102
2018;134;75 i +;105;49;154;SEC_134
2018;601;65-74;127;92;219;SEC_601
2018;117;65-74;130;113;243;SEC_117
2018;217;35-49;191;210;401;SEC_217
2018;132;75 i +;111;83;194;SEC_132
2018;101;12-15;39;39;78;SEC_101
2018;503;16-17;3;7;10;SEC_503
2018;435;65-74;38;29;67;SEC_435
2018;431;25-34;128;140;268;SEC_431
2018;327;16-17;18;8;26;SEC_327
2018;105;75 i +;58;47;105;SEC_105
2018;612;18-24;29;40;69;SEC_612
2018;121;35-49;125;125;250;SEC_121
2018;228;12-15;44;57;101;SEC_228
2018;224;50-64;122;96;218;SEC_224
2018;414;03-11;95;90;185;SEC_414
2018;520;75 i +;63;41;104;SEC_520
2018;329;65-74;31;40;71;SEC_329
2018;321;25-34;131;138;269;SEC_321
2018;608;12-15;26;26;52;SEC_608
2018;127;65-74;27;23;50;SEC_127
2018;104;16-17;4;7;11;SEC_104
2018;139;50-64;80;96;176;SEC_139
2018;240;03-11;82;60;142;SEC_240
2018;503;25-34;33;44;77;SEC_503
2018;531;00-02;5;17;22;SEC_531
2018;531;35-49;123;134;257;SEC_531
2018;243;16-17;7;12;19;SEC_243
2018;136;12-15;22;26;48;SEC_136
2018;430;35-49;144;180;324;SEC_430
2018;115;25-34;57;96;153;SEC_115
2018;502;00-02;20;13;33;SEC_502
2018;505;50-64;105;102;207;SEC_505
2018;224;18-24;39;44;83;SEC_224
2018;425;16-17;7;10;17;SEC_425
2018;310;18-24;34;29;63;SEC_310
2018;324;03-11;64;63;127;SEC_324
2018;228;65-74;78;51;129;SEC_228
2018;502;75 i +;136;90;226;SEC_502
2018;128;50-64;82;84;166;SEC_128
2018;217;12-15;16;26;42;SEC_217
2018;121;00-02;9;17;26;SEC_121
2018;116;00-02;9;12;21;SEC_116
2018;423;03-11;46;45;91;SEC_423
2018;324;16-17;14;11;25;SEC_324
2018;314;16-17;14;15;29;SEC_314
2018;111;03-11;36;19;55;SEC_111
2018;418;75 i +;84;70;154;SEC_418
2018;418;18-24;56;55;111;SEC_418
2018;626;03-11;34;39;73;SEC_626
2018;125;35-49;214;213;427;SEC_125
2018;430;16-17;15;8;23;SEC_430
2018;133;35-49;98;114;212;SEC_133
2018;537;03-11;55;47;102;SEC_537
2018;535;50-64;105;86;191;SEC_535
2018;305;16-17;16;13;29;SEC_305
2018;521;12-15;11;20;31;SEC_521
2018;627;00-02;6;9;15;SEC_627
2018;321;12-15;43;39;82;SEC_321
2018;125;16-17;11;13;24;SEC_125
2018;623;12-15;21;38;59;SEC_623
2018;425;12-15;17;21;38;SEC_425
2018;137;16-17;17;17;34;SEC_137
2018;404;18-24;56;70;126;SEC_404
2018;223;16-17;12;10;22;SEC_223
2018;607;50-64;105;92;197;SEC_607
2018;238;12-15;12;16;28;SEC_238
2018;108;16-17;18;12;30;SEC_108
2018;137;00-02;16;21;37;SEC_137
2018;135;16-17;12;13;25;SEC_135
2018;612;50-64;73;73;146;SEC_612
2018;504;18-24;28;32;60;SEC_504
2018;421;00-02;16;18;34;SEC_421
2018;240;75 i +;106;67;173;SEC_240
2018;433;12-15;37;31;68;SEC_433
2018;608;65-74;72;50;122;SEC_608
2018;123;00-02;12;14;26;SEC_123
2018;426;03-11;51;50;101;SEC_426
2018;404;12-15;32;25;57;SEC_404
2018;613;25-34;48;52;100;SEC_613
2018;431;35-49;214;235;449;SEC_431
2018;110;75 i +;83;66;149;SEC_110
2018;535;65-74;95;60;155;SEC_535
2018;304;50-64;130;137;267;SEC_304
2018;202;35-49;236;269;505;SEC_202
2018;232;00-02;19;16;35;SEC_232
2018;327;35-49;141;144;285;SEC_327
2018;605;03-11;77;66;143;SEC_605
2018;326;16-17;5;6;11;SEC_326
2018;502;35-49;179;195;374;SEC_502
2018;619;65-74;88;77;165;SEC_619
2018;204;50-64;158;140;298;SEC_204
2018;302;18-24;36;46;82;SEC_302
2018;114;50-64;153;126;279;SEC_114
2018;305;65-74;98;84;182;SEC_305
2018;405;12-15;31;21;52;SEC_405
2018;608;50-64;146;130;276;SEC_608
2018;202;75 i +;81;65;146;SEC_202
2018;525;16-17;16;7;23;SEC_525
2018;525;12-15;21;12;33;SEC_525
2018;240;18-24;78;79;157;SEC_240
2018;441;50-64;244;199;443;SEC_441
2018;139;35-49;105;114;219;SEC_139
2018;416;18-24;60;68;128;SEC_416
2018;602;35-49;149;139;288;SEC_602
2018;507;25-34;56;69;125;SEC_507
2018;301;65-74;89;72;161;SEC_301
2018;323;65-74;129;133;262;SEC_323
2018;411;18-24;42;46;88;SEC_411
2018;205;03-11;40;29;69;SEC_205
2018;102;18-24;48;50;98;SEC_102
2018;243;12-15;29;36;65;SEC_243
2018;208;50-64;165;129;294;SEC_208
2018;124;12-15;19;15;34;SEC_124
2018;538;00-02;23;19;42;SEC_538
2018;249;50-64;100;97;197;SEC_249
2018;140;03-11;51;52;103;SEC_140
2018;119;35-49;116;136;252;SEC_119
2018;220;12-15;36;33;69;SEC_220
2018;232;18-24;53;53;106;SEC_232
2018;610;75 i +;93;92;185;SEC_610
2018;220;75 i +;100;47;147;SEC_220
2018;229;00-02;30;37;67;SEC_229
2018;514;75 i +;90;60;150;SEC_514
2018;208;35-49;165;154;319;SEC_208
2018;314;50-64;284;227;511;SEC_314
2018;630;03-11;30;44;74;SEC_630
2018;134;50-64;147;119;266;SEC_134
2018;127;16-17;8;8;16;SEC_127
2018;138;18-24;34;17;51;SEC_138
2018;419;16-17;21;22;43;SEC_419
2018;201;65-74;52;31;83;SEC_201
2018;310;25-34;74;63;137;SEC_310
2018;323;00-02;20;21;41;SEC_323
2018;535;03-11;32;25;57;SEC_535
2018;525;03-11;47;48;95;SEC_525
2018;626;50-64;74;74;148;SEC_626
2018;538;50-64;129;118;247;SEC_538
2018;440;35-49;111;110;221;SEC_440
2018;132;12-15;39;26;65;SEC_132
2018;315;35-49;244;253;497;SEC_315
2018;126;75 i +;81;71;152;SEC_126
2018;532;35-49;180;196;376;SEC_532
2018;111;35-49;91;93;184;SEC_111
2018;321;35-49;233;204;437;SEC_321
2018;433;25-34;154;150;304;SEC_433
2018;532;25-34;115;94;209;SEC_532
2018;207;65-74;82;62;144;SEC_207
2018;103;25-34;53;47;100;SEC_103
2018;427;65-74;49;33;82;SEC_427
2018;242;18-24;49;42;91;SEC_242
2018;117;50-64;236;209;445;SEC_117
2018;532;65-74;70;48;118;SEC_532
2018;304;75 i +;88;48;136;SEC_304
2018;309;75 i +;50;25;75;SEC_309
2018;249;18-24;43;47;90;SEC_249
2018;511;25-34;190;163;353;SEC_511
2018;214;25-34;192;194;386;SEC_214
2018;322;00-02;20;30;50;SEC_322
2018;441;75 i +;115;84;199;SEC_441
2018;435;12-15;19;27;46;SEC_435
2018;246;25-34;88;99;187;SEC_246
2018;623;25-34;58;64;122;SEC_623
2018;320;18-24;10;9;19;SEC_320
2018;534;35-49;137;127;264;SEC_534
2018;307;65-74;129;116;245;SEC_307
2018;529;25-34;109;100;209;SEC_529
2018;301;00-02;20;5;25;SEC_301
2018;508;18-24;65;58;123;SEC_508
2018;204;18-24;69;75;144;SEC_204
2018;632;03-11;37;46;83;SEC_632
2018;609;75 i +;60;56;116;SEC_609
2018;103;12-15;12;11;23;SEC_103
2018;606;75 i +;81;62;143;SEC_606
2018;317;18-24;44;58;102;SEC_317
2018;122;35-49;132;132;264;SEC_122
2018;606;25-34;61;58;119;SEC_606
2018;137;25-34;84;75;159;SEC_137
2018;211;16-17;11;19;30;SEC_211
2018;320;00-02;5;13;18;SEC_320
2018;407;16-17;9;15;24;SEC_407
2018;248;16-17;11;8;19;SEC_248
2018;137;65-74;97;67;164;SEC_137
2018;311;75 i +;91;60;151;SEC_311
2018;528;65-74;51;41;92;SEC_528
2018;311;18-24;57;61;118;SEC_311
2018;435;35-49;119;179;298;SEC_435
2018;117;75 i +;98;66;164;SEC_117
2018;242;35-49;144;152;296;SEC_242
2018;432;35-49;141;151;292;SEC_432
2018;622;75 i +;38;25;63;SEC_622
2018;607;65-74;48;23;71;SEC_607
2018;313;18-24;60;59;119;SEC_313
2018;233;12-15;8;17;25;SEC_233
2018;402;50-64;102;80;182;SEC_402
2018;136;16-17;11;12;23;SEC_136
2018;627;25-34;38;54;92;SEC_627
2018;246;12-15;37;20;57;SEC_246
2018;627;12-15;11;13;24;SEC_627
2018;513;75 i +;104;63;167;SEC_513
2018;418;16-17;11;17;28;SEC_418
2018;432;50-64;128;106;234;SEC_432
2018;247;12-15;34;30;64;SEC_247
2018;501;65-74;109;111;220;SEC_501
2018;419;00-02;31;37;68;SEC_419
2018;308;18-24;84;97;181;SEC_308
2018;528;35-49;163;153;316;SEC_528
2018;601;18-24;71;75;146;SEC_601
2018;441;16-17;14;18;32;SEC_441
2018;532;50-64;124;82;206;SEC_532
2018;607;35-49;101;128;229;SEC_607
2018;530;75 i +;93;68;161;SEC_530
2018;507;16-17;7;10;17;SEC_507
2018;310;65-74;47;62;109;SEC_310
2018;432;12-15;21;17;38;SEC_432
2018;302;35-49;174;186;360;SEC_302
2018;109;00-02;14;11;25;SEC_109
2018;420;35-49;220;270;490;SEC_420
2018;411;65-74;62;42;104;SEC_411
2018;122;50-64;64;62;126;SEC_122
2018;111;75 i +;72;49;121;SEC_111
2018;611;50-64;153;157;310;SEC_611
2018;327;12-15;22;30;52;SEC_327
2018;317;12-15;21;30;51;SEC_317
2018;104;25-34;43;42;85;SEC_104
2018;501;12-15;11;20;31;SEC_501
2018;234;18-24;40;57;97;SEC_234
2018;104;65-74;43;33;76;SEC_104
2018;406;50-64;139;126;265;SEC_406
2018;104;12-15;14;19;33;SEC_104
2018;609;65-74;73;46;119;SEC_609
2018;310;35-49;101;123;224;SEC_310
2018;321;03-11;55;80;135;SEC_321
2018;305;25-34;135;98;233;SEC_305
2018;314;65-74;145;129;274;SEC_314
2018;601;25-34;107;123;230;SEC_601
2018;117;03-11;60;73;133;SEC_117
2018;205;18-24;38;43;81;SEC_205
2018;523;65-74;63;43;106;SEC_523
2018;440;75 i +;84;77;161;SEC_440
2018;602;25-34;61;68;129;SEC_602
2018;319;75 i +;47;36;83;SEC_319
2018;231;65-74;34;26;60;SEC_231
2018;102;16-17;17;10;27;SEC_102
2018;201;25-34;150;133;283;SEC_201
2018;510;35-49;124;130;254;SEC_510
2018;617;65-74;66;45;111;SEC_617
2018;626;65-74;71;55;126;SEC_626
2018;232;25-34;82;84;166;SEC_232
2018;111;12-15;9;21;30;SEC_111
2018;232;12-15;11;19;30;SEC_232
2018;214;00-02;48;42;90;SEC_214
2018;233;00-02;12;15;27;SEC_233
2018;318;25-34;39;51;90;SEC_318
2018;626;16-17;4;10;14;SEC_626
2018;228;16-17;16;27;43;SEC_228
2018;622;18-24;20;39;59;SEC_622
2018;247;35-49;172;160;332;SEC_247
2018;617;25-34;53;47;100;SEC_617
2018;329;16-17;13;17;30;SEC_329
2018;305;75 i +;79;46;125;SEC_305
2018;401;25-34;89;83;172;SEC_401
2018;409;12-15;26;34;60;SEC_409
2018;224;16-17;9;9;18;SEC_224
2018;508;65-74;57;33;90;SEC_508
2018;504;00-02;13;18;31;SEC_504
2018;130;03-11;46;44;90;SEC_130
2018;113;35-49;221;196;417;SEC_113
2018;209;16-17;8;8;16;SEC_209
2018;139;18-24;37;42;79;SEC_139
2018;306;03-11;58;63;121;SEC_306
2018;108;25-34;117;97;214;SEC_108
2018;236;25-34;84;90;174;SEC_236
2018;433;18-24;98;68;166;SEC_433
2018;401;00-02;13;13;26;SEC_401
2018;403;65-74;74;53;127;SEC_403
2018;410;65-74;104;80;184;SEC_410
2018;129;16-17;6;18;24;SEC_129
2018;608;16-17;14;10;24;SEC_608
2018;440;25-34;59;66;125;SEC_440
2018;626;18-24;29;30;59;SEC_626
2018;204;12-15;22;25;47;SEC_204
2018;501;18-24;36;36;72;SEC_501
2018;520;18-24;31;40;71;SEC_520
2018;410;25-34;100;112;212;SEC_410
2018;123;12-15;18;20;38;SEC_123
2018;627;16-17;7;8;15;SEC_627
2018;325;12-15;37;30;67;SEC_325
2018;510;75 i +;77;43;120;SEC_510
2018;101;35-49;215;229;444;SEC_101
2018;103;16-17;8;8;16;SEC_103
2018;617;12-15;11;21;32;SEC_617
2018;314;35-49;277;288;565;SEC_314
2018;403;12-15;22;15;37;SEC_403
2018;422;00-02;20;18;38;SEC_422
2018;323;25-34;90;86;176;SEC_323
2018;309;25-34;94;68;162;SEC_309
2018;403;25-34;82;78;160;SEC_403
2018;304;25-34;166;159;325;SEC_304
2018;102;75 i +;134;96;230;SEC_102
2018;103;00-02;14;12;26;SEC_103
2018;240;50-64;167;147;314;SEC_240
2018;117;35-49;208;206;414;SEC_117
2018;437;50-64;152;142;294;SEC_437
2018;133;12-15;15;15;30;SEC_133
2018;217;75 i +;67;46;113;SEC_217
2018;220;65-74;69;42;111;SEC_220
2018;427;18-24;78;82;160;SEC_427
2018;308;25-34;97;99;196;SEC_308
2018;243;00-02;26;17;43;SEC_243
2018;205;25-34;73;81;154;SEC_205
2018;523;50-64;121;123;244;SEC_523
2018;209;75 i +;67;46;113;SEC_209
2018;619;00-02;8;13;21;SEC_619
2018;508;35-49;185;186;371;SEC_508
2018;617;03-11;31;59;90;SEC_617
2018;212;25-34;128;136;264;SEC_212
2018;530;16-17;12;11;23;SEC_530
2018;234;25-34;98;104;202;SEC_234
2018;140;12-15;14;25;39;SEC_140
2018;514;18-24;74;71;145;SEC_514
2018;221;65-74;76;67;143;SEC_221
2018;423;12-15;21;20;41;SEC_423
2018;119;16-17;5;10;15;SEC_119
2018;632;12-15;23;26;49;SEC_632
2018;436;00-02;25;33;58;SEC_436
2018;246;35-49;177;191;368;SEC_246
2018;612;35-49;111;140;251;SEC_612
2018;614;35-49;102;108;210;SEC_614
2018;525;18-24;47;34;81;SEC_525
2018;537;00-02;17;14;31;SEC_537
2018;530;00-02;37;40;77;SEC_530
2018;422;12-15;16;23;39;SEC_422
2018;414;75 i +;88;55;143;SEC_414
2018;613;12-15;15;24;39;SEC_613
2018;523;35-49;190;181;371;SEC_523
2018;619;16-17;9;6;15;SEC_619
2018;609;00-02;14;11;25;SEC_609
2018;116;50-64;144;124;268;SEC_116
2018;246;03-11;62;58;120;SEC_246
2018;418;50-64;123;128;251;SEC_418
2018;211;65-74;39;39;78;SEC_211
2018;113;65-74;116;103;219;SEC_113
2018;401;75 i +;88;53;141;SEC_401
2018;316;65-74;188;177;365;SEC_316
2018;131;25-34;78;66;144;SEC_131
2018;211;35-49;182;196;378;SEC_211
2018;513;16-17;8;21;29;SEC_513
2018;232;50-64;98;100;198;SEC_232
2018;243;25-34;141;134;275;SEC_243
2018;632;16-17;14;6;20;SEC_632
2018;614;18-24;22;31;53;SEC_614
2018;205;65-74;54;34;88;SEC_205
2018;214;12-15;47;55;102;SEC_214
2018;518;50-64;99;101;200;SEC_518
2018;510;12-15;15;17;32;SEC_510
2018;430;18-24;41;61;102;SEC_430
2018;619;25-34;53;67;120;SEC_619
2018;610;35-49;131;99;230;SEC_610
2018;128;25-34;66;75;141;SEC_128
2018;141;75 i +;12;5;17;SEC_141
2018;404;00-02;17;20;37;SEC_404
2018;419;18-24;86;96;182;SEC_419
2018;309;12-15;16;34;50;SEC_309
2018;312;12-15;23;29;52;SEC_312
2018;304;18-24;60;47;107;SEC_304
2018;239;12-15;19;13;32;SEC_239
2018;627;18-24;23;20;43;SEC_627
2018;401;18-24;52;61;113;SEC_401
2018;130;18-24;33;34;67;SEC_130
2018;631;65-74;113;73;186;SEC_631
2018;511;18-24;84;116;200;SEC_511
2018;307;25-34;59;72;131;SEC_307
2018;437;03-11;75;80;155;SEC_437
2018;414;65-74;56;53;109;SEC_414
2018;322;35-49;199;177;376;SEC_322
2018;126;25-34;68;48;116;SEC_126
2018;521;18-24;22;20;42;SEC_521
2018;414;16-17;12;12;24;SEC_414
2018;312;00-02;27;25;52;SEC_312
2018;120;50-64;212;188;400;SEC_120
2018;526;65-74;59;47;106;SEC_526
2018;124;25-34;68;66;134;SEC_124
2018;317;25-34;83;98;181;SEC_317
2018;231;03-11;62;64;126;SEC_231
2018;118;50-64;169;130;299;SEC_118
2018;402;65-74;31;26;57;SEC_402
2018;307;75 i +;111;64;175;SEC_307
2018;426;65-74;41;38;79;SEC_426
2018;321;50-64;270;238;508;SEC_321
2018;134;18-24;60;57;117;SEC_134
2018;618;35-49;121;103;224;SEC_618
2018;113;12-15;26;35;61;SEC_113
2018;420;00-02;22;40;62;SEC_420
2018;433;50-64;190;165;355;SEC_433
2018;618;00-02;10;4;14;SEC_618
2018;625;03-11;27;34;61;SEC_625
2018;433;75 i +;63;42;105;SEC_433
2018;209;00-02;10;19;29;SEC_209
2018;318;65-74;48;50;98;SEC_318
2018;228;35-49;311;316;627;SEC_228
2018;128;75 i +;63;41;104;SEC_128
2018;406;00-02;15;25;40;SEC_406
2018;327;25-34;84;76;160;SEC_327
2018;247;00-02;18;21;39;SEC_247
2018;435;50-64;87;112;199;SEC_435
2018;425;75 i +;73;44;117;SEC_425
2018;239;03-11;39;34;73;SEC_239
2018;505;12-15;15;18;33;SEC_505
2018;228;00-02;34;31;65;SEC_228
2018;503;03-11;16;24;40;SEC_503
2018;407;18-24;52;33;85;SEC_407
2018;503;18-24;21;26;47;SEC_503
2018;116;75 i +;102;87;189;SEC_116
2018;523;75 i +;98;69;167;SEC_523
2018;239;50-64;117;102;219;SEC_239
2018;433;65-74;66;65;131;SEC_433
2018;315;50-64;195;162;357;SEC_315
2018;246;75 i +;74;47;121;SEC_246
2018;631;35-49;131;122;253;SEC_631
2018;431;16-17;11;21;32;SEC_431
2018;103;65-74;41;32;73;SEC_103
2018;323;75 i +;63;47;110;SEC_323
2018;526;25-34;157;147;304;SEC_526
2018;131;75 i +;80;55;135;SEC_131
2018;441;03-11;89;89;178;SEC_441
2018;210;12-15;22;16;38;SEC_210
2018;131;00-02;19;18;37;SEC_131
2018;120;03-11;59;53;112;SEC_120
2018;114;00-02;19;11;30;SEC_114
2018;531;25-34;73;68;141;SEC_531
2018;422;03-11;63;63;126;SEC_422
2018;427;50-64;143;138;281;SEC_427
2018;432;00-02;18;16;34;SEC_432
2018;121;50-64;90;94;184;SEC_121
2018;612;12-15;20;20;40;SEC_612
2018;504;25-34;72;55;127;SEC_504
2018;422;50-64;110;114;224;SEC_422
2018;529;12-15;27;31;58;SEC_529
2018;101;00-02;33;30;63;SEC_101
2018;535;18-24;31;34;65;SEC_535
2018;409;18-24;84;78;162;SEC_409
2018;131;35-49;148;163;311;SEC_131
2018;226;16-17;21;13;34;SEC_226
2018;528;16-17;14;16;30;SEC_528
2018;622;50-64;86;80;166;SEC_622
2018;504;65-74;84;54;138;SEC_504
2018;249;03-11;35;45;80;SEC_249
2018;114;16-17;9;14;23;SEC_114
2018;204;35-49;209;212;421;SEC_204
2018;308;35-49;250;213;463;SEC_308
2018;617;35-49;114;119;233;SEC_617
2018;123;16-17;10;10;20;SEC_123
2018;216;16-17;16;15;31;SEC_216
2018;416;35-49;175;171;346;SEC_416
2018;419;25-34;156;176;332;SEC_419
2018;239;16-17;9;12;21;SEC_239
2018;213;00-02;18;11;29;SEC_213
2018;110;03-11;38;37;75;SEC_110
2018;534;00-02;20;20;40;SEC_534
2018;112;25-34;108;107;215;SEC_112
2018;618;16-17;12;14;26;SEC_618
2018;320;75 i +;1;3;4;SEC_320
2018;136;18-24;46;45;91;SEC_136
2018;121;65-74;21;21;42;SEC_121
2018;427;16-17;16;7;23;SEC_427
2018;127;25-34;51;50;101;SEC_127
2018;322;18-24;44;50;94;SEC_322
2018;303;75 i +;157;122;279;SEC_303
2018;129;65-74;65;44;109;SEC_129
2018;213;75 i +;54;44;98;SEC_213
2018;525;00-02;18;15;33;SEC_525
2018;108;65-74;66;59;125;SEC_108
2018;246;16-17;7;9;16;SEC_246
2018;120;65-74;108;98;206;SEC_120
2018;611;16-17;18;10;28;SEC_611
2018;111;16-17;4;11;15;SEC_111
2018;436;12-15;28;34;62;SEC_436
2018;409;25-34;148;169;317;SEC_409
2018;534;03-11;47;51;98;SEC_534
2018;518;75 i +;89;51;140;SEC_518
2018;614;75 i +;84;58;142;SEC_614
2018;520;65-74;49;38;87;SEC_520
2018;605;18-24;56;51;107;SEC_605
2018;423;18-24;46;43;89;SEC_423
2018;238;50-64;76;70;146;SEC_238
2018;401;65-74;56;51;107;SEC_401
2018;105;16-17;7;14;21;SEC_105
2018;223;75 i +;63;45;108;SEC_223
2018;518;12-15;18;18;36;SEC_518
2018;420;50-64;213;192;405;SEC_420
2018;314;18-24;75;70;145;SEC_314
2018;618;03-11;27;47;74;SEC_618
2018;325;18-24;58;53;111;SEC_325
2018;421;75 i +;88;72;160;SEC_421
2018;615;65-74;90;46;136;SEC_615
2018;626;35-49;108;102;210;SEC_626
2018;326;00-02;40;54;94;SEC_326
2018;416;75 i +;96;51;147;SEC_416
2018;138;12-15;14;9;23;SEC_138
2018;514;25-34;116;99;215;SEC_514
2018;319;65-74;90;74;164;SEC_319
2018;306;00-02;18;31;49;SEC_306
2018;435;75 i +;63;23;86;SEC_435
2018;329;75 i +;21;14;35;SEC_329
2018;226;75 i +;123;75;198;SEC_226
2018;611;25-34;111;112;223;SEC_611
2018;245;75 i +;68;41;109;SEC_245
2018;324;00-02;21;8;29;SEC_324
2018;625;65-74;117;109;226;SEC_625
2018;623;75 i +;97;65;162;SEC_623
2018;110;00-02;8;13;21;SEC_110
2018;212;03-11;62;64;126;SEC_212
2018;617;75 i +;69;40;109;SEC_617
2018;611;00-02;22;19;41;SEC_611
2018;110;18-24;24;31;55;SEC_110
2018;204;25-34;134;120;254;SEC_204
2018;109;03-11;48;43;91;SEC_109
2018;431;75 i +;82;38;120;SEC_431
2018;421;65-74;65;47;112;SEC_421
2018;303;35-49;199;214;413;SEC_303
2018;306;65-74;91;77;168;SEC_306
2018;407;50-64;89;80;169;SEC_407
2018;138;35-49;87;72;159;SEC_138
2018;140;75 i +;59;48;107;SEC_140
2018;202;12-15;25;35;60;SEC_202
2018;607;12-15;17;12;29;SEC_607
2018;122;75 i +;82;63;145;SEC_122
2018;226;35-49;238;238;476;SEC_226
2018;207;03-11;73;69;142;SEC_207
2018;141;50-64;64;64;128;SEC_141
2018;119;18-24;24;34;58;SEC_119
2018;410;75 i +;153;109;262;SEC_410
2018;312;18-24;77;58;135;SEC_312
2018;202;16-17;19;14;33;SEC_202
2018;532;18-24;59;58;117;SEC_532
2018;213;12-15;19;20;39;SEC_213
2018;119;12-15;19;18;37;SEC_119
2018;501;16-17;12;15;27;SEC_501
2018;313;75 i +;98;74;172;SEC_313
2018;518;35-49;144;151;295;SEC_518
2018;627;65-74;101;88;189;SEC_627
2018;115;75 i +;70;40;110;SEC_115
2018;431;18-24;73;66;139;SEC_431
2018;528;03-11;53;52;105;SEC_528
2018;321;65-74;196;158;354;SEC_321
2018;248;03-11;51;65;116;SEC_248
2018;416;65-74;55;48;103;SEC_416
2018;403;35-49;144;149;293;SEC_403
2018;116;18-24;60;37;97;SEC_116
2018;237;75 i +;76;48;124;SEC_237
2018;436;75 i +;72;53;125;SEC_436
2018;511;35-49;277;323;600;SEC_511
2018;617;16-17;9;6;15;SEC_617
2018;313;12-15;40;38;78;SEC_313
2018;209;50-64;110;89;199;SEC_209
2018;117;00-02;27;21;48;SEC_117
2018;422;16-17;11;14;25;SEC_422
2018;441;18-24;88;65;153;SEC_441
2018;125;65-74;106;84;190;SEC_125
2018;606;50-64;88;99;187;SEC_606
2018;511;75 i +;140;94;234;SEC_511
2018;204;00-02;25;18;43;SEC_204
2018;610;12-15;27;25;52;SEC_610
2018;613;75 i +;106;98;204;SEC_613
2018;229;16-17;22;16;38;SEC_229
2018;436;50-64;154;139;293;SEC_436
2018;627;75 i +;54;49;103;SEC_627
2018;430;25-34;87;99;186;SEC_430
