AnyPadro;Seccio;GrupEdat;Dones;Homes;Total;IdSeccio
2015;113;25-34;100;102;202;SEC_113
2015;217;12-15;16;28;44;SEC_217
2015;216;50-64;110;100;210;SEC_216
2015;528;16-17;13;8;21;SEC_528
2015;112;18-24;57;60;117;SEC_112
2015;403;16-17;8;10;18;SEC_403
2015;501;50-64;117;81;198;SEC_501
2015;508;18-24;58;69;127;SEC_508
2015;402;35-49;139;121;260;SEC_402
2015;537;65-74;87;60;147;SEC_537
2015;207;03-11;79;76;155;SEC_207
2015;122;25-34;64;40;104;SEC_122
2015;503;50-64;119;78;197;SEC_503
2015;304;25-34;311;275;586;SEC_304
2015;323;35-49;223;228;451;SEC_323
2015;510;03-11;43;43;86;SEC_510
2015;436;00-02;20;20;40;SEC_436
2015;131;65-74;113;111;224;SEC_131
2015;622;65-74;54;49;103;SEC_622
2015;234;12-15;18;14;32;SEC_234
2015;505;25-34;55;51;106;SEC_505
2015;406;50-64;121;118;239;SEC_406
2015;502;00-02;22;23;45;SEC_502
2015;201;75 i +;64;47;111;SEC_201
2015;420;50-64;177;171;348;SEC_420
2015;404;65-74;69;53;122;SEC_404
2015;401;18-24;52;45;97;SEC_401
2015;602;18-24;35;52;87;SEC_602
2015;303;00-02;25;23;48;SEC_303
2015;135;03-11;45;56;101;SEC_135
2015;106;50-64;236;169;405;SEC_106
2015;104;35-49;110;115;225;SEC_104
2015;523;35-49;176;178;354;SEC_523
2015;535;65-74;100;73;173;SEC_535
2015;623;18-24;36;46;82;SEC_623
2015;320;35-49;198;190;388;SEC_320
2015;624;16-17;4;6;10;SEC_624
2015;313;16-17;23;17;40;SEC_313
2015;441;16-17;19;17;36;SEC_441
2015;602;16-17;13;15;28;SEC_602
2015;532;00-02;21;24;45;SEC_532
2015;422;25-34;93;104;197;SEC_422
2015;526;12-15;24;30;54;SEC_526
2015;128;25-34;70;78;148;SEC_128
2015;409;35-49;219;241;460;SEC_409
2015;610;75 i +;74;69;143;SEC_610
2015;309;65-74;43;46;89;SEC_309
2015;124;50-64;88;71;159;SEC_124
2015;324;18-24;31;34;65;SEC_324
2015;320;03-11;11;7;18;SEC_320
2015;231;18-24;39;49;88;SEC_231
2015;220;35-49;226;206;432;SEC_220
2015;239;12-15;17;17;34;SEC_239
2015;114;00-02;11;14;25;SEC_114
2015;237;35-49;178;188;366;SEC_237
2015;521;16-17;4;9;13;SEC_521
2015;537;16-17;10;17;27;SEC_537
2015;106;00-02;20;30;50;SEC_106
2015;508;25-34;105;115;220;SEC_508
2015;617;03-11;31;51;82;SEC_617
2015;103;35-49;105;122;227;SEC_103
2015;248;16-17;6;10;16;SEC_248
2015;322;50-64;114;94;208;SEC_322
2015;136;16-17;10;13;23;SEC_136
2015;135;16-17;15;12;27;SEC_135
2015;245;65-74;50;27;77;SEC_245
2015;231;16-17;11;10;21;SEC_231
2015;137;50-64;150;133;283;SEC_137
2015;104;75 i +;85;41;126;SEC_104
2015;440;50-64;71;84;155;SEC_440
2015;440;03-11;38;51;89;SEC_440
2015;626;16-17;11;5;16;SEC_626
2015;211;65-74;46;40;86;SEC_211
2015;414;65-74;60;49;109;SEC_414
2015;501;25-34;45;43;88;SEC_501
2015;224;35-49;149;154;303;SEC_224
2015;247;50-64;127;110;237;SEC_247
2015;319;03-11;92;121;213;SEC_319
2015;618;50-64;110;96;206;SEC_618
2015;504;75 i +;95;79;174;SEC_504
2015;502;18-24;52;41;93;SEC_502
2015;402;00-02;7;21;28;SEC_402
2015;121;12-15;12;18;30;SEC_121
2015;616;35-49;296;280;576;SEC_616
2015;301;50-64;221;204;425;SEC_301
2015;311;25-34;113;116;229;SEC_311
2015;503;35-49;89;64;153;SEC_503
2015;435;35-49;117;168;285;SEC_435
2015;232;25-34;79;75;154;SEC_232
2015;246;03-11;63;48;111;SEC_246
2015;318;50-64;113;102;215;SEC_318
2015;326;50-64;38;52;90;SEC_326
2015;518;16-17;11;14;25;SEC_518
2015;609;16-17;10;8;18;SEC_609
2015;419;16-17;19;29;48;SEC_419
2015;506;16-17;13;17;30;SEC_506
2015;624;75 i +;59;48;107;SEC_624
2015;419;65-74;78;57;135;SEC_419
2015;302;00-02;13;17;30;SEC_302
2015;433;35-49;238;229;467;SEC_433
2015;621;00-02;12;17;29;SEC_621
2015;420;25-34;149;149;298;SEC_420
2015;129;25-34;53;66;119;SEC_129
2015;518;65-74;62;33;95;SEC_518
2015;212;18-24;47;45;92;SEC_212
2015;410;50-64;143;134;277;SEC_410
2015;326;25-34;159;119;278;SEC_326
2015;419;25-34;139;170;309;SEC_419
2015;247;65-74;63;40;103;SEC_247
2015;326;65-74;12;12;24;SEC_326
2015;521;00-02;9;9;18;SEC_521
2015;311;12-15;27;29;56;SEC_311
2015;243;03-11;66;86;152;SEC_243
2015;514;18-24;44;60;104;SEC_514
2015;217;16-17;11;15;26;SEC_217
2015;117;18-24;65;58;123;SEC_117
2015;212;25-34;99;102;201;SEC_212
2015;308;03-11;100;94;194;SEC_308
2015;229;75 i +;93;53;146;SEC_229
2015;605;16-17;14;9;23;SEC_605
2015;621;25-34;72;90;162;SEC_621
2015;136;75 i +;68;40;108;SEC_136
2015;116;25-34;68;68;136;SEC_116
2015;320;50-64;111;113;224;SEC_320
2015;313;03-11;82;74;156;SEC_313
2015;220;18-24;78;66;144;SEC_220
2015;124;25-34;57;50;107;SEC_124
2015;315;12-15;26;33;59;SEC_315
2015;524;75 i +;82;42;124;SEC_524
2015;524;18-24;41;45;86;SEC_524
2015;420;16-17;20;16;36;SEC_420
2015;612;00-02;19;9;28;SEC_612
2015;433;25-34;131;114;245;SEC_433
2015;621;12-15;18;29;47;SEC_621
2015;132;35-49;239;255;494;SEC_132
2015;416;00-02;17;19;36;SEC_416
2015;233;65-74;38;19;57;SEC_233
2015;321;18-24;63;77;140;SEC_321
2015;513;25-34;98;86;184;SEC_513
2015;608;50-64;142;116;258;SEC_608
2015;217;18-24;65;49;114;SEC_217
2015;324;65-74;52;34;86;SEC_324
2015;135;35-49;163;179;342;SEC_135
2015;221;03-11;93;87;180;SEC_221
2015;138;16-17;13;7;20;SEC_138
2015;426;03-11;49;44;93;SEC_426
2015;213;00-02;17;10;27;SEC_213
2015;306;50-64;144;144;288;SEC_306
2015;209;12-15;14;15;29;SEC_209
2015;425;03-11;42;49;91;SEC_425
2015;514;12-15;23;29;52;SEC_514
2015;130;16-17;7;3;10;SEC_130
2015;416;50-64;108;107;215;SEC_416
2015;623;25-34;56;65;121;SEC_623
2015;324;00-02;21;24;45;SEC_324
2015;508;75 i +;74;49;123;SEC_508
2015;521;18-24;23;23;46;SEC_521
2015;233;03-11;45;45;90;SEC_233
2015;305;03-11;62;71;133;SEC_305
2015;624;12-15;19;18;37;SEC_624
2015;135;25-34;85;94;179;SEC_135
2015;138;00-02;10;10;20;SEC_138
2015;116;12-15;22;25;47;SEC_116
2015;307;65-74;120;104;224;SEC_307
2015;435;00-02;19;22;41;SEC_435
2015;533;25-34;138;135;273;SEC_533
2015;528;12-15;23;23;46;SEC_528
2015;514;35-49;171;180;351;SEC_514
2015;621;16-17;7;16;23;SEC_621
2015;115;75 i +;69;39;108;SEC_115
2015;608;03-11;49;48;97;SEC_608
2015;242;65-74;62;47;109;SEC_242
2015;122;03-11;43;52;95;SEC_122
2015;306;35-49;200;192;392;SEC_306
2015;125;12-15;22;28;50;SEC_125
2015;419;00-02;36;32;68;SEC_419
2015;530;50-64;138;128;266;SEC_530
2015;125;75 i +;64;63;127;SEC_125
2015;437;12-15;29;28;57;SEC_437
2015;528;75 i +;69;56;125;SEC_528
2015;625;75 i +;62;43;105;SEC_625
2015;618;25-34;47;51;98;SEC_618
2015;201;25-34;169;151;320;SEC_201
2015;102;03-11;59;59;118;SEC_102
2015;129;12-15;11;28;39;SEC_129
2015;110;65-74;115;91;206;SEC_110
2015;418;25-34;79;95;174;SEC_418
2015;504;00-02;15;14;29;SEC_504
2015;623;00-02;13;17;30;SEC_623
2015;226;50-64;161;137;298;SEC_226
2015;308;25-34;103;99;202;SEC_308
2015;202;65-74;70;61;131;SEC_202
2015;214;35-49;316;297;613;SEC_214
2015;316;03-11;61;63;124;SEC_316
2015;431;03-11;88;85;173;SEC_431
2015;106;03-11;56;60;116;SEC_106
2015;301;00-02;40;45;85;SEC_301
2015;619;18-24;29;37;66;SEC_619
2015;238;18-24;39;37;76;SEC_238
2015;233;12-15;13;23;36;SEC_233
2015;314;65-74;112;99;211;SEC_314
2015;214;75 i +;122;72;194;SEC_214
2015;202;25-34;145;155;300;SEC_202
2015;120;50-64;199;200;399;SEC_120
2015;601;75 i +;132;110;242;SEC_601
2015;302;35-49;155;175;330;SEC_302
2015;229;35-49;244;215;459;SEC_229
2015;326;35-49;177;228;405;SEC_326
2015;410;12-15;23;37;60;SEC_410
2015;615;12-15;19;15;34;SEC_615
2015;306;75 i +;97;65;162;SEC_306
2015;211;00-02;14;29;43;SEC_211
2015;211;50-64;119;88;207;SEC_211
2015;605;50-64;140;105;245;SEC_605
2015;245;75 i +;67;47;114;SEC_245
2015;130;00-02;26;15;41;SEC_130
2015;322;12-15;28;31;59;SEC_322
2015;422;50-64;93;100;193;SEC_422
2015;624;50-64;76;54;130;SEC_624
2015;601;35-49;215;276;491;SEC_601
2015;606;12-15;20;21;41;SEC_606
2015;217;00-02;23;13;36;SEC_217
2015;109;00-02;12;13;25;SEC_109
2015;237;75 i +;84;47;131;SEC_237
2015;319;00-02;27;27;54;SEC_319
2015;210;16-17;9;5;14;SEC_210
2015;614;00-02;11;10;21;SEC_614
2015;315;25-34;130;130;260;SEC_315
2015;513;18-24;45;54;99;SEC_513
2015;201;35-49;227;227;454;SEC_201
2015;231;12-15;26;30;56;SEC_231
2015;508;50-64;130;115;245;SEC_508
2015;311;03-11;56;74;130;SEC_311
2015;117;16-17;17;15;32;SEC_117
2015;507;75 i +;45;21;66;SEC_507
2015;220;65-74;64;35;99;SEC_220
2015;623;16-17;12;8;20;SEC_623
2015;114;50-64;150;121;271;SEC_114
2015;430;18-24;46;49;95;SEC_430
2015;538;65-74;69;39;108;SEC_538
2015;117;03-11;69;83;152;SEC_117
2015;418;75 i +;83;63;146;SEC_418
2015;123;25-34;73;62;135;SEC_123
2015;110;35-49;123;112;235;SEC_110
2015;302;03-11;51;43;94;SEC_302
2015;421;03-11;51;52;103;SEC_421
2015;619;00-02;14;14;28;SEC_619
2015;109;35-49;127;123;250;SEC_109
2015;523;12-15;21;18;39;SEC_523
2015;407;75 i +;98;54;152;SEC_407
2015;631;25-34;55;40;95;SEC_631
2015;533;50-64;143;142;285;SEC_533
2015;506;00-02;22;13;35;SEC_506
2015;208;00-02;9;19;28;SEC_208
2015;110;50-64;115;99;214;SEC_110
2015;613;65-74;141;93;234;SEC_613
2015;530;65-74;64;42;106;SEC_530
2015;233;18-24;29;41;70;SEC_233
2015;115;12-15;18;22;40;SEC_115
2015;122;35-49;117;117;234;SEC_122
2015;327;65-74;59;51;110;SEC_327
2015;136;12-15;24;24;48;SEC_136
2015;208;18-24;50;51;101;SEC_208
2015;121;65-74;23;22;45;SEC_121
2015;535;03-11;31;31;62;SEC_535
2015;402;18-24;32;20;52;SEC_402
2015;401;16-17;8;21;29;SEC_401
2015;601;03-11;79;96;175;SEC_601
2015;120;35-49;195;191;386;SEC_120
2015;207;50-64;170;150;320;SEC_207
2015;418;50-64;114;117;231;SEC_418
2015;505;12-15;16;12;28;SEC_505
2015;127;50-64;87;79;166;SEC_127
2015;128;12-15;15;19;34;SEC_128
2015;308;65-74;117;109;226;SEC_308
2015;112;16-17;9;13;22;SEC_112
2015;316;75 i +;79;42;121;SEC_316
2015;508;00-02;21;21;42;SEC_508
2015;113;18-24;49;57;106;SEC_113
2015;128;18-24;26;23;49;SEC_128
2015;612;03-11;42;40;82;SEC_612
2015;110;18-24;23;32;55;SEC_110
2015;214;18-24;106;75;181;SEC_214
2015;630;25-34;45;43;88;SEC_630
2015;630;75 i +;41;27;68;SEC_630
2015;239;65-74;57;37;94;SEC_239
2015;325;65-74;128;107;235;SEC_325
2015;204;65-74;63;47;110;SEC_204
2015;402;16-17;10;5;15;SEC_402
2015;609;75 i +;45;34;79;SEC_609
2015;214;65-74;93;56;149;SEC_214
2015;420;00-02;33;39;72;SEC_420
2015;528;00-02;14;14;28;SEC_528
2015;240;18-24;76;77;153;SEC_240
2015;507;16-17;6;9;15;SEC_507
2015;422;00-02;22;15;37;SEC_422
2015;201;65-74;58;33;91;SEC_201
2015;137;16-17;15;14;29;SEC_137
2015;138;25-34;38;58;96;SEC_138
2015;228;25-34;168;167;335;SEC_228
2015;248;00-02;16;18;34;SEC_248
2015;105;75 i +;62;40;102;SEC_105
2015;422;03-11;60;60;120;SEC_422
2015;619;03-11;52;46;98;SEC_619
2015;626;18-24;28;29;57;SEC_626
2015;625;18-24;31;32;63;SEC_625
2015;317;12-15;17;25;42;SEC_317
2015;615;35-49;98;107;205;SEC_615
2015;130;25-34;55;64;119;SEC_130
2015;614;16-17;4;11;15;SEC_614
2015;321;25-34;140;145;285;SEC_321
2015;627;12-15;15;9;24;SEC_627
2015;232;50-64;92;90;182;SEC_232
2015;503;12-15;7;9;16;SEC_503
2015;229;00-02;26;32;58;SEC_229
2015;409;65-74;92;72;164;SEC_409
2015;121;35-49;122;122;244;SEC_121
2015;130;35-49;142;133;275;SEC_130
2015;234;16-17;8;10;18;SEC_234
2015;327;50-64;173;140;313;SEC_327
2015;533;03-11;80;96;176;SEC_533
2015;311;50-64;114;96;210;SEC_311
2015;538;50-64;111;93;204;SEC_538
2015;240;50-64;144;148;292;SEC_240
2015;616;00-02;25;25;50;SEC_616
2015;630;65-74;75;65;140;SEC_630
2015;128;65-74;62;41;103;SEC_128
2015;123;50-64;127;120;247;SEC_123
2015;609;35-49;108;105;213;SEC_609
2015;625;35-49;113;110;223;SEC_625
2015;632;03-11;41;55;96;SEC_632
2015;514;50-64;118;105;223;SEC_514
2015;506;12-15;32;34;66;SEC_506
2015;220;16-17;9;13;22;SEC_220
2015;111;50-64;99;71;170;SEC_111
2015;112;35-49;193;178;371;SEC_112
2015;533;16-17;19;13;32;SEC_533
2015;610;65-74;142;100;242;SEC_610
2015;624;25-34;54;52;106;SEC_624
2015;210;00-02;8;9;17;SEC_210
2015;441;65-74;122;101;223;SEC_441
2015;631;65-74;120;98;218;SEC_631
2015;525;18-24;35;41;76;SEC_525
2015;237;16-17;9;21;30;SEC_237
2015;506;50-64;203;147;350;SEC_506
2015;131;00-02;21;13;34;SEC_131
2015;220;75 i +;94;60;154;SEC_220
2015;204;12-15;29;17;46;SEC_204
2015;606;25-34;62;68;130;SEC_606
2015;528;65-74;59;46;105;SEC_528
2015;437;18-24;59;60;119;SEC_437
2015;426;12-15;12;21;33;SEC_426
2015;124;16-17;5;5;10;SEC_124
2015;407;12-15;19;23;42;SEC_407
2015;107;75 i +;115;61;176;SEC_107
2015;118;65-74;116;122;238;SEC_118
2015;107;03-11;65;77;142;SEC_107
2015;132;18-24;65;82;147;SEC_132
2015;130;65-74;44;27;71;SEC_130
2015;212;35-49;198;183;381;SEC_212
2015;130;50-64;80;81;161;SEC_130
2015;107;50-64;155;127;282;SEC_107
2015;116;65-74;120;90;210;SEC_116
2015;523;65-74;74;55;129;SEC_523
2015;508;35-49;180;214;394;SEC_508
2015;237;03-11;69;69;138;SEC_237
2015;440;75 i +;72;61;133;SEC_440
2015;511;03-11;89;112;201;SEC_511
2015;441;75 i +;112;67;179;SEC_441
2015;510;65-74;60;48;108;SEC_510
2015;242;16-17;12;9;21;SEC_242
2015;238;35-49;127;111;238;SEC_238
2015;307;25-34;65;91;156;SEC_307
2015;309;12-15;17;30;47;SEC_309
2015;632;25-34;52;49;101;SEC_632
2015;325;35-49;186;185;371;SEC_325
2015;101;00-02;37;34;71;SEC_101
2015;431;12-15;31;48;79;SEC_431
2015;627;25-34;49;60;109;SEC_627
2015;214;16-17;23;19;42;SEC_214
2015;310;00-02;19;15;34;SEC_310
2015;314;12-15;34;34;68;SEC_314
2015;118;25-34;90;75;165;SEC_118
2015;124;00-02;8;9;17;SEC_124
2015;421;65-74;75;50;125;SEC_421
2015;626;65-74;72;58;130;SEC_626
2015;626;00-02;7;7;14;SEC_626
2015;319;65-74;79;66;145;SEC_319
2015;411;18-24;34;26;60;SEC_411
2015;421;50-64;99;76;175;SEC_421
2015;618;00-02;10;12;22;SEC_618
2015;133;65-74;59;43;102;SEC_133
2015;525;03-11;46;49;95;SEC_525
2015;625;00-02;6;14;20;SEC_625
2015;435;50-64;84;87;171;SEC_435
2015;624;35-49;112;147;259;SEC_624
2015;319;35-49;262;272;534;SEC_319
2015;248;75 i +;68;50;118;SEC_248
2015;435;75 i +;75;37;112;SEC_435
2015;627;65-74;87;87;174;SEC_627
2015;618;12-15;25;31;56;SEC_618
2015;308;18-24;74;81;155;SEC_308
2015;441;12-15;32;39;71;SEC_441
2015;622;50-64;94;75;169;SEC_622
2015;243;18-24;52;72;124;SEC_243
2015;308;16-17;19;26;45;SEC_308
2015;404;35-49;165;186;351;SEC_404
2015;414;16-17;14;18;32;SEC_414
2015;511;12-15;32;31;63;SEC_511
2015;632;75 i +;60;40;100;SEC_632
2015;301;03-11;159;158;317;SEC_301
2015;234;03-11;36;36;72;SEC_234
2015;538;00-02;14;17;31;SEC_538
2015;510;50-64;99;88;187;SEC_510
2015;437;00-02;20;20;40;SEC_437
2015;523;50-64;112;122;234;SEC_523
2015;615;25-34;36;33;69;SEC_615
2015;534;16-17;5;6;11;SEC_534
2015;117;65-74;115;95;210;SEC_117
2015;129;18-24;44;33;77;SEC_129
2015;247;03-11;82;83;165;SEC_247
2015;236;25-34;66;94;160;SEC_236
2015;320;25-34;38;35;73;SEC_320
2015;441;00-02;25;25;50;SEC_441
2015;131;18-24;36;40;76;SEC_131
2015;217;75 i +;67;44;111;SEC_217
2015;202;75 i +;83;59;142;SEC_202
2015;524;35-49;166;180;346;SEC_524
2015;127;35-49;102;99;201;SEC_127
2015;223;35-49;148;156;304;SEC_223
2015;405;35-49;223;213;436;SEC_405
2015;529;03-11;58;60;118;SEC_529
2015;104;65-74;41;37;78;SEC_104
2015;133;50-64;84;71;155;SEC_133
2015;214;50-64;151;160;311;SEC_214
2015;313;50-64;214;171;385;SEC_313
2015;535;00-02;7;6;13;SEC_535
2015;326;18-24;20;16;36;SEC_326
2015;409;12-15;26;24;50;SEC_409
2015;126;16-17;8;7;15;SEC_126
2015;236;75 i +;103;47;150;SEC_236
2015;529;18-24;49;42;91;SEC_529
2015;507;35-49;99;112;211;SEC_507
2015;318;18-24;18;36;54;SEC_318
2015;303;12-15;16;16;32;SEC_303
2015;318;25-34;51;47;98;SEC_318
2015;318;12-15;8;18;26;SEC_318
2015;205;03-11;29;30;59;SEC_205
2015;317;18-24;36;51;87;SEC_317
2015;214;00-02;36;34;70;SEC_214
2015;114;35-49;173;198;371;SEC_114
2015;525;35-49;119;133;252;SEC_525
2015;435;03-11;52;62;114;SEC_435
2015;323;18-24;60;62;122;SEC_323
2015;130;18-24;29;36;65;SEC_130
2015;409;16-17;13;20;33;SEC_409
2015;204;16-17;16;12;28;SEC_204
2015;242;25-34;81;85;166;SEC_242
2015;107;25-34;90;111;201;SEC_107
2015;236;18-24;52;41;93;SEC_236
2015;531;25-34;72;67;139;SEC_531
2015;101;18-24;57;61;118;SEC_101
2015;115;65-74;82;74;156;SEC_115
2015;630;35-49;93;93;186;SEC_630
2015;402;65-74;39;26;65;SEC_402
2015;103;25-34;46;31;77;SEC_103
2015;406;03-11;48;60;108;SEC_406
2015;119;12-15;8;17;25;SEC_119
2015;436;65-74;60;52;112;SEC_436
2015;239;16-17;11;13;24;SEC_239
2015;420;65-74;86;65;151;SEC_420
2015;622;25-34;43;44;87;SEC_622
2015;325;16-17;15;14;29;SEC_325
2015;312;00-02;22;28;50;SEC_312
2015;102;75 i +;120;85;205;SEC_102
2015;523;03-11;49;48;97;SEC_523
2015;505;18-24;25;17;42;SEC_505
2015;119;35-49;125;145;270;SEC_119
2015;207;16-17;18;19;37;SEC_207
2015;134;03-11;60;54;114;SEC_134
2015;611;65-74;118;87;205;SEC_611
2015;501;35-49;103;123;226;SEC_501
2015;406;00-02;25;18;43;SEC_406
2015;437;16-17;16;21;37;SEC_437
2015;624;18-24;32;29;61;SEC_624
2015;316;18-24;78;84;162;SEC_316
2015;412;00-02;6;21;27;SEC_412
2015;202;12-15;32;27;59;SEC_202
2015;246;00-02;23;16;39;SEC_246
2015;246;50-64;94;100;194;SEC_246
2015;245;03-11;47;56;103;SEC_245
2015;207;00-02;33;21;54;SEC_207
2015;104;03-11;33;33;66;SEC_104
2015;425;35-49;131;146;277;SEC_425
2015;625;65-74;96;87;183;SEC_625
2015;632;00-02;12;14;26;SEC_632
2015;506;35-49;167;163;330;SEC_506
2015;631;75 i +;62;43;105;SEC_631
2015;632;18-24;26;39;65;SEC_632
2015;216;16-17;13;8;21;SEC_216
2015;305;75 i +;83;54;137;SEC_305
2015;606;16-17;8;15;23;SEC_606
2015;423;16-17;7;8;15;SEC_423
2015;209;03-11;33;34;67;SEC_209
2015;108;16-17;16;18;34;SEC_108
2015;124;65-74;44;29;73;SEC_124
2015;247;25-34;107;94;201;SEC_247
2015;133;18-24;14;24;38;SEC_133
2015;436;35-49;196;209;405;SEC_436
2015;316;25-34;164;186;350;SEC_316
2015;137;65-74;83;73;156;SEC_137
2015;209;16-17;10;7;17;SEC_209
2015;507;00-02;8;10;18;SEC_507
2015;115;18-24;24;48;72;SEC_115
2015;123;35-49;161;144;305;SEC_123
2015;537;25-34;102;86;188;SEC_537
2015;614;03-11;39;52;91;SEC_614
2015;518;35-49;145;147;292;SEC_518
2015;517;25-34;173;180;353;SEC_517
2015;525;16-17;8;7;15;SEC_525
2015;104;25-34;46;58;104;SEC_104
2015;319;18-24;36;52;88;SEC_319
2015;224;18-24;37;44;81;SEC_224
2015;125;00-02;19;33;52;SEC_125
2015;105;65-74;67;70;137;SEC_105
2015;226;25-34;117;133;250;SEC_226
2015;104;50-64;76;72;148;SEC_104
2015;502;50-64;134;128;262;SEC_502
2015;608;00-02;16;12;28;SEC_608
2015;131;03-11;42;54;96;SEC_131
2015;401;25-34;77;82;159;SEC_401
2015;507;03-11;42;36;78;SEC_507
2015;614;50-64;74;72;146;SEC_614
2015;526;75 i +;93;62;155;SEC_526
2015;311;00-02;16;27;43;SEC_311
2015;137;18-24;49;45;94;SEC_137
2015;104;18-24;35;24;59;SEC_104
2015;306;12-15;27;28;55;SEC_306
2015;108;35-49;187;173;360;SEC_108
2015;412;50-64;169;148;317;SEC_412
2015;613;35-49;134;154;288;SEC_613
2015;524;03-11;62;64;126;SEC_524
2015;525;65-74;43;32;75;SEC_525
2015;433;18-24;71;72;143;SEC_433
2015;201;18-24;39;35;74;SEC_201
2015;103;12-15;15;17;32;SEC_103
2015;416;12-15;30;31;61;SEC_416
2015;609;25-34;42;37;79;SEC_609
2015;135;00-02;16;14;30;SEC_135
2015;304;00-02;89;98;187;SEC_304
2015;221;25-34;135;157;292;SEC_221
2015;414;12-15;30;22;52;SEC_414
2015;412;35-49;156;168;324;SEC_412
2015;304;75 i +;117;65;182;SEC_304
2015;403;25-34;71;71;142;SEC_403
2015;440;00-02;11;13;24;SEC_440
2015;127;16-17;6;8;14;SEC_127
2015;520;16-17;6;8;14;SEC_520
2015;402;75 i +;63;46;109;SEC_402
2015;314;18-24;59;99;158;SEC_314
2015;239;35-49;148;159;307;SEC_239
2015;621;35-49;168;183;351;SEC_621
2015;537;03-11;52;40;92;SEC_537
2015;530;16-17;10;15;25;SEC_530
2015;524;00-02;12;22;34;SEC_524
2015;320;65-74;1;3;4;SEC_320
2015;139;00-02;7;15;22;SEC_139
2015;418;65-74;54;51;105;SEC_418
2015;134;12-15;21;29;50;SEC_134
2015;505;03-11;41;46;87;SEC_505
2015;405;00-02;15;28;43;SEC_405
2015;532;65-74;77;59;136;SEC_532
2015;245;16-17;14;7;21;SEC_245
2015;612;75 i +;78;62;140;SEC_612
2015;612;65-74;107;66;173;SEC_612
2015;209;35-49;127;117;244;SEC_209
2015;632;65-74;51;44;95;SEC_632
2015;403;03-11;49;45;94;SEC_403
2015;312;16-17;12;10;22;SEC_312
2015;534;65-74;57;47;104;SEC_534
2015;404;00-02;18;22;40;SEC_404
2015;432;75 i +;83;54;137;SEC_432
2015;205;18-24;30;50;80;SEC_205
2015;216;00-02;19;19;38;SEC_216
2015;513;03-11;79;76;155;SEC_513
2015;240;16-17;21;13;34;SEC_240
2015;412;75 i +;107;90;197;SEC_412
2015;435;16-17;8;11;19;SEC_435
2015;508;65-74;66;41;107;SEC_508
2015;432;25-34;80;81;161;SEC_432
2015;105;00-02;12;12;24;SEC_105
2015;139;50-64;97;82;179;SEC_139
2015;320;16-17;16;11;27;SEC_320
2015;242;35-49;138;137;275;SEC_242
2015;423;18-24;47;28;75;SEC_423
2015;632;50-64;80;66;146;SEC_632
2015;133;75 i +;64;35;99;SEC_133
2015;221;35-49;262;270;532;SEC_221
2015;523;18-24;38;58;96;SEC_523
2015;242;00-02;21;17;38;SEC_242
2015;314;16-17;23;17;40;SEC_314
2015;124;12-15;15;11;26;SEC_124
2015;317;65-74;28;32;60;SEC_317
2015;416;25-34;97;107;204;SEC_416
2015;517;75 i +;105;66;171;SEC_517
2015;104;16-17;9;5;14;SEC_104
2015;119;75 i +;97;60;157;SEC_119
2015;248;25-34;94;105;199;SEC_248
2015;236;03-11;33;56;89;SEC_236
2015;504;35-49;125;127;252;SEC_504
2015;310;03-11;43;46;89;SEC_310
2015;138;65-74;59;47;106;SEC_138
2015;618;75 i +;81;70;151;SEC_618
2015;409;18-24;75;73;148;SEC_409
2015;114;12-15;22;31;53;SEC_114
2015;205;50-64;100;100;200;SEC_205
2015;223;12-15;24;24;48;SEC_223
2015;533;00-02;32;34;66;SEC_533
2015;610;18-24;29;45;74;SEC_610
2015;310;25-34;72;64;136;SEC_310
2015;426;75 i +;52;27;79;SEC_426
2015;132;75 i +;112;72;184;SEC_132
2015;202;16-17;10;17;27;SEC_202
2015;405;75 i +;138;99;237;SEC_405
2015;231;65-74;41;28;69;SEC_231
2015;625;12-15;21;23;44;SEC_625
2015;430;25-34;84;94;178;SEC_430
2015;320;03-11;77;74;151;SEC_320
2015;433;75 i +;87;40;127;SEC_433
2015;303;16-17;10;11;21;SEC_303
2015;617;16-17;8;10;18;SEC_617
2015;427;35-49;237;227;464;SEC_427
2015;632;35-49;112;123;235;SEC_632
2015;414;25-34;145;141;286;SEC_414
2015;132;00-02;24;28;52;SEC_132
2015;214;25-34;188;181;369;SEC_214
2015;410;00-02;14;13;27;SEC_410
2015;228;75 i +;132;96;228;SEC_228
2015;537;00-02;20;16;36;SEC_537
2015;431;18-24;60;64;124;SEC_431
2015;419;03-11;77;120;197;SEC_419
2015;229;25-34;147;138;285;SEC_229
2015;437;03-11;61;76;137;SEC_437
2015;234;50-64;89;88;177;SEC_234
2015;103;18-24;24;21;45;SEC_103
2015;205;25-34;71;86;157;SEC_205
2015;108;65-74;62;58;120;SEC_108
2015;118;75 i +;59;50;109;SEC_118
2015;108;12-15;30;17;47;SEC_108
2015;530;25-34;136;117;253;SEC_530
2015;307;75 i +;83;71;154;SEC_307
2015;323;00-02;19;22;41;SEC_323
2015;214;12-15;36;44;80;SEC_214
2015;514;65-74;53;31;84;SEC_514
2015;208;12-15;17;27;44;SEC_208
2015;525;50-64;63;62;125;SEC_525
2015;246;18-24;60;38;98;SEC_246
2015;602;25-34;61;55;116;SEC_602
2015;411;00-02;8;9;17;SEC_411
2015;612;12-15;13;22;35;SEC_612
2015;213;12-15;7;25;32;SEC_213
2015;112;00-02;19;19;38;SEC_112
2015;404;16-17;16;14;30;SEC_404
2015;232;16-17;9;15;24;SEC_232
2015;316;12-15;21;31;52;SEC_316
2015;607;65-74;76;32;108;SEC_607
2015;205;65-74;50;34;84;SEC_205
2015;131;16-17;9;4;13;SEC_131
2015;401;03-11;38;57;95;SEC_401
2015;202;03-11;79;78;157;SEC_202
2015;229;50-64;147;139;286;SEC_229
2015;223;16-17;15;8;23;SEC_223
2015;441;50-64;244;212;456;SEC_441
2015;422;18-24;61;39;100;SEC_422
2015;243;50-64;139;145;284;SEC_243
2015;302;12-15;12;19;31;SEC_302
2015;416;35-49;178;185;363;SEC_416
2015;423;75 i +;75;58;133;SEC_423
2015;221;00-02;26;29;55;SEC_221
2015;308;50-64;204;187;391;SEC_308
2015;606;65-74;54;32;86;SEC_606
2015;510;16-17;6;8;14;SEC_510
2015;308;35-49;266;245;511;SEC_308
2015;236;16-17;6;7;13;SEC_236
2015;503;75 i +;45;20;65;SEC_503
2015;113;75 i +;61;42;103;SEC_113
2015;228;12-15;42;49;91;SEC_228
2015;321;50-64;279;251;530;SEC_321
2015;440;25-34;70;69;139;SEC_440
2015;303;50-64;112;118;230;SEC_303
2015;325;50-64;194;146;340;SEC_325
2015;319;12-15;29;34;63;SEC_319
2015;502;25-34;87;103;190;SEC_502
2015;617;12-15;20;15;35;SEC_617
2015;213;50-64;86;69;155;SEC_213
2015;534;35-49;119;116;235;SEC_534
2015;532;50-64;111;82;193;SEC_532
2015;128;35-49;163;151;314;SEC_128
2015;626;03-11;35;36;71;SEC_626
2015;625;03-11;29;42;71;SEC_625
2015;309;75 i +;46;25;71;SEC_309
2015;216;65-74;74;51;125;SEC_216
2015;234;75 i +;65;39;104;SEC_234
2015;111;18-24;22;21;43;SEC_111
2015;440;35-49;114;109;223;SEC_440
2015;612;25-34;45;37;82;SEC_612
2015;323;50-64;206;179;385;SEC_323
2015;504;50-64;76;70;146;SEC_504
2015;102;65-74;132;121;253;SEC_102
2015;248;50-64;107;108;215;SEC_248
2015;137;35-49;182;160;342;SEC_137
2015;216;25-34;94;87;181;SEC_216
2015;313;18-24;51;57;108;SEC_313
2015;627;00-02;5;12;17;SEC_627
2015;618;35-49;131;115;246;SEC_618
2015;616;16-17;16;36;52;SEC_616
2015;208;16-17;14;11;25;SEC_208
2015;423;03-11;42;38;80;SEC_423
2015;321;03-11;59;77;136;SEC_321
2015;523;00-02;22;18;40;SEC_523
2015;410;65-74;105;94;199;SEC_410
2015;419;18-24;68;82;150;SEC_419
2015;616;12-15;47;48;95;SEC_616
2015;619;16-17;8;13;21;SEC_619
2015;526;03-11;84;105;189;SEC_526
2015;139;75 i +;37;25;62;SEC_139
2015;320;00-02;5;5;10;SEC_320
2015;313;12-15;41;43;84;SEC_313
2015;314;35-49;269;278;547;SEC_314
2015;205;00-02;10;11;21;SEC_205
2015;504;65-74;91;69;160;SEC_504
2015;502;03-11;74;70;144;SEC_502
2015;322;18-24;42;49;91;SEC_322
2015;138;75 i +;46;35;81;SEC_138
2015;611;00-02;26;20;46;SEC_611
2015;616;75 i +;57;35;92;SEC_616
2015;217;25-34;114;119;233;SEC_217
2015;614;25-34;34;58;92;SEC_614
2015;401;35-49;116;110;226;SEC_401
2015;609;18-24;18;25;43;SEC_609
2015;249;03-11;41;47;88;SEC_249
2015;113;35-49;216;211;427;SEC_113
2015;207;12-15;22;33;55;SEC_207
2015;619;65-74;96;67;163;SEC_619
2015;246;12-15;13;20;33;SEC_246
2015;420;75 i +;136;92;228;SEC_420
2015;619;12-15;18;21;39;SEC_619
2015;610;50-64;89;73;162;SEC_610
2015;208;75 i +;234;127;361;SEC_208
2015;435;25-34;95;89;184;SEC_435
2015;114;65-74;127;88;215;SEC_114
2015;501;75 i +;40;35;75;SEC_501
2015;245;50-64;94;87;181;SEC_245
2015;425;50-64;84;94;178;SEC_425
2015;405;12-15;34;29;63;SEC_405
2015;426;18-24;37;50;87;SEC_426
2015;117;25-34;113;122;235;SEC_117
2015;531;35-49;114;126;240;SEC_531
2015;436;16-17;18;20;38;SEC_436
2015;127;00-02;13;4;17;SEC_127
2015;521;12-15;15;16;31;SEC_521
2015;626;75 i +;66;46;112;SEC_626
2015;247;00-02;24;23;47;SEC_247
2015;301;65-74;144;113;257;SEC_301
2015;127;65-74;32;23;55;SEC_127
2015;421;12-15;27;18;45;SEC_421
2015;115;35-49;159;148;307;SEC_115
2015;117;12-15;31;36;67;SEC_117
2015;237;65-74;69;46;115;SEC_237
2015;441;18-24;90;59;149;SEC_441
2015;431;75 i +;95;41;136;SEC_431
2015;302;50-64;149;102;251;SEC_302
2015;139;16-17;6;9;15;SEC_139
2015;325;03-11;67;60;127;SEC_325
2015;116;16-17;13;8;21;SEC_116
2015;311;75 i +;97;56;153;SEC_311
2015;423;00-02;15;17;32;SEC_423
2015;419;50-64;142;144;286;SEC_419
2015;427;16-17;18;20;38;SEC_427
2015;110;16-17;4;8;12;SEC_110
2015;411;16-17;9;3;12;SEC_411
2015;242;12-15;15;13;28;SEC_242
2015;238;12-15;10;15;25;SEC_238
2015;106;16-17;10;13;23;SEC_106
2015;511;00-02;32;36;68;SEC_511
2015;232;00-02;17;18;35;SEC_232
2015;506;65-74;167;146;313;SEC_506
2015;121;18-24;34;35;69;SEC_121
2015;605;18-24;47;41;88;SEC_605
2015;248;18-24;46;47;93;SEC_248
2015;506;75 i +;99;87;186;SEC_506
2015;440;18-24;35;33;68;SEC_440
2015;404;18-24;55;54;109;SEC_404
2015;126;65-74;94;81;175;SEC_126
2015;616;65-74;103;105;208;SEC_616
2015;623;12-15;24;31;55;SEC_623
2015;619;50-64;136;134;270;SEC_619
2015;111;75 i +;62;44;106;SEC_111
2015;529;25-34;88;81;169;SEC_529
2015;409;75 i +;112;89;201;SEC_409
2015;118;03-11;79;74;153;SEC_118
2015;249;16-17;10;16;26;SEC_249
2015;226;03-11;76;71;147;SEC_226
2015;101;12-15;41;36;77;SEC_101
2015;113;00-02;27;28;55;SEC_113
2015;120;16-17;22;22;44;SEC_120
2015;511;16-17;20;26;46;SEC_511
2015;322;25-34;92;74;166;SEC_322
2015;240;12-15;30;25;55;SEC_240
2015;123;16-17;7;20;27;SEC_123
2015;109;12-15;17;20;37;SEC_109
2015;320;18-24;33;38;71;SEC_320
2015;302;18-24;35;44;79;SEC_302
2015;320;12-15;2;5;7;SEC_320
2015;314;03-11;86;90;176;SEC_314
2015;115;25-34;65;71;136;SEC_115
2015;311;65-74;67;49;116;SEC_311
2015;530;75 i +;93;72;165;SEC_530
2015;223;50-64;108;102;210;SEC_223
2015;208;50-64;183;143;326;SEC_208
2015;606;18-24;29;35;64;SEC_606
2015;211;25-34;103;104;207;SEC_211
2015;116;50-64;141;119;260;SEC_116
2015;431;00-02;34;29;63;SEC_431
2015;611;03-11;72;108;180;SEC_611
2015;246;65-74;34;34;68;SEC_246
2015;401;00-02;13;14;27;SEC_401
2015;613;16-17;7;11;18;SEC_613
2015;440;65-74;81;62;143;SEC_440
2015;236;65-74;68;38;106;SEC_236
2015;248;65-74;42;37;79;SEC_248
2015;403;12-15;23;9;32;SEC_403
2015;105;03-11;55;55;110;SEC_105
2015;204;35-49;185;204;389;SEC_204
2015;610;25-34;50;45;95;SEC_610
2015;110;75 i +;79;43;122;SEC_110
2015;234;00-02;18;18;36;SEC_234
2015;238;25-34;72;85;157;SEC_238
2015;248;12-15;18;14;32;SEC_248
2015;430;12-15;22;21;43;SEC_430
2015;320;50-64;10;10;20;SEC_320
2015;507;50-64;78;67;145;SEC_507
2015;419;35-49;233;328;561;SEC_419
2015;526;00-02;33;35;68;SEC_526
2015;608;25-34;54;65;119;SEC_608
2015;239;50-64;99;85;184;SEC_239
2015;435;18-24;37;46;83;SEC_435
2015;304;50-64;181;165;346;SEC_304
2015;621;65-74;117;132;249;SEC_621
2015;320;35-49;29;36;65;SEC_320
2015;441;35-49;205;239;444;SEC_441
2015;623;50-64;128;115;243;SEC_623
2015;535;50-64;102;84;186;SEC_535
2015;611;50-64;121;133;254;SEC_611
2015;305;25-34;102;112;214;SEC_305
2015;233;16-17;7;9;16;SEC_233
2015;612;50-64;58;64;122;SEC_612
2015;608;18-24;33;45;78;SEC_608
2015;520;18-24;26;32;58;SEC_520
2015;615;03-11;32;25;57;SEC_615
2015;630;03-11;26;32;58;SEC_630
2015;232;75 i +;75;45;120;SEC_232
2015;504;18-24;27;22;49;SEC_504
2015;310;75 i +;43;21;64;SEC_310
2015;606;75 i +;85;69;154;SEC_606
2015;416;65-74;71;56;127;SEC_416
2015;534;75 i +;63;48;111;SEC_534
2015;426;50-64;75;85;160;SEC_426
2015;511;25-34;179;154;333;SEC_511
2015;101;50-64;178;171;349;SEC_101
2015;632;16-17;13;8;21;SEC_632
2015;520;35-49;96;95;191;SEC_520
2015;134;00-02;20;20;40;SEC_134
2015;528;25-34;82;80;162;SEC_528
2015;317;00-02;12;18;30;SEC_317
2015;111;12-15;13;18;31;SEC_111
2015;437;65-74;86;64;150;SEC_437
2015;503;65-74;48;65;113;SEC_503
2015;211;35-49;185;196;381;SEC_211
2015;618;65-74;104;78;182;SEC_618
2015;128;75 i +;57;46;103;SEC_128
2015;632;12-15;29;16;45;SEC_632
2015;403;35-49;120;137;257;SEC_403
2015;610;16-17;7;9;16;SEC_610
2015;521;50-64;90;72;162;SEC_521
2015;303;25-34;104;99;203;SEC_303
2015;112;50-64;172;163;335;SEC_112
2015;306;00-02;22;29;51;SEC_306
2015;421;35-49;153;159;312;SEC_421
2015;404;25-34;102;89;191;SEC_404
2015;109;03-11;43;49;92;SEC_109
2015;430;50-64;76;81;157;SEC_430
2015;312;18-24;64;55;119;SEC_312
2015;521;65-74;107;98;205;SEC_521
2015;111;65-74;67;51;118;SEC_111
2015;520;75 i +;58;39;97;SEC_520
2015;506;03-11;46;68;114;SEC_506
2015;114;03-11;51;64;115;SEC_114
2015;513;75 i +;101;60;161;SEC_513
2015;133;16-17;10;2;12;SEC_133
2015;605;25-34;82;91;173;SEC_605
2015;320;16-17;0;3;3;SEC_320
2015;410;35-49;166;169;335;SEC_410
2015;307;35-49;139;127;266;SEC_307
2015;615;18-24;23;26;49;SEC_615
2015;414;50-64;137;137;274;SEC_414
2015;126;75 i +;70;59;129;SEC_126
2015;401;75 i +;96;57;153;SEC_401
2015;601;25-34;113;122;235;SEC_601
2015;117;50-64;241;224;465;SEC_117
2015;528;18-24;51;44;95;SEC_528
2015;130;75 i +;103;65;168;SEC_130
2015;532;25-34;113;100;213;SEC_532
2015;249;12-15;16;14;30;SEC_249
2015;138;18-24;23;25;48;SEC_138
2015;401;65-74;44;39;83;SEC_401
2015;530;35-49;231;227;458;SEC_530
2015;504;16-17;6;5;11;SEC_504
2015;116;18-24;44;41;85;SEC_116
2015;229;18-24;83;91;174;SEC_229
2015;611;16-17;13;16;29;SEC_611
2015;405;03-11;81;67;148;SEC_405
2015;302;25-34;98;88;186;SEC_302
2015;132;16-17;12;18;30;SEC_132
2015;247;35-49;180;179;359;SEC_247
2015;501;16-17;11;6;17;SEC_501
2015;247;18-24;47;54;101;SEC_247
2015;229;12-15;43;29;72;SEC_229
2015;421;00-02;20;17;37;SEC_421
2015;432;12-15;24;13;37;SEC_432
2015;204;50-64;137;132;269;SEC_204
2015;433;16-17;14;12;26;SEC_433
2015;529;65-74;51;43;94;SEC_529
2015;326;12-15;13;11;24;SEC_326
2015;306;18-24;65;53;118;SEC_306
2015;613;50-64;71;68;139;SEC_613
2015;221;18-24;83;77;160;SEC_221
2015;140;03-11;37;54;91;SEC_140
2015;217;03-11;38;50;88;SEC_217
2015;116;35-49;151;166;317;SEC_116
2015;211;12-15;22;34;56;SEC_211
2015;326;03-11;62;52;114;SEC_326
2015;105;35-49;137;134;271;SEC_105
2015;208;35-49;179;152;331;SEC_208
2015;425;00-02;12;15;27;SEC_425
2015;407;25-34;66;80;146;SEC_407
2015;602;35-49;165;160;325;SEC_602
2015;402;25-34;70;58;128;SEC_402
2015;111;16-17;7;10;17;SEC_111
2015;117;35-49;205;210;415;SEC_117
2015;307;18-24;28;41;69;SEC_307
2015;514;16-17;21;15;36;SEC_514
2015;231;50-64;93;85;178;SEC_231
2015;201;50-64;89;84;173;SEC_201
2015;132;03-11;92;76;168;SEC_132
2015;325;25-34;82;84;166;SEC_325
2015;213;35-49;100;119;219;SEC_213
2015;104;00-02;11;13;24;SEC_104
2015;431;35-49;195;242;437;SEC_431
2015;529;16-17;10;15;25;SEC_529
2015;103;03-11;30;32;62;SEC_103
2015;211;18-24;46;54;100;SEC_211
2015;249;50-64;97;80;177;SEC_249
2015;220;12-15;27;25;52;SEC_220
2015;514;00-02;14;26;40;SEC_514
2015;239;00-02;17;15;32;SEC_239
2015;605;75 i +;114;108;222;SEC_605
2015;531;16-17;6;11;17;SEC_531
2015;304;03-11;166;173;339;SEC_304
2015;245;18-24;43;42;85;SEC_245
2015;510;75 i +;76;45;121;SEC_510
2015;427;50-64;145;126;271;SEC_427
2015;526;35-49;236;277;513;SEC_526
2015;421;18-24;29;55;84;SEC_421
2015;201;12-15;25;31;56;SEC_201
2015;246;35-49;149;170;319;SEC_246
2015;406;75 i +;76;64;140;SEC_406
2015;114;18-24;48;35;83;SEC_114
2015;608;75 i +;101;68;169;SEC_608
2015;402;50-64;67;74;141;SEC_402
2015;518;00-02;16;10;26;SEC_518
2015;312;50-64;160;157;317;SEC_312
2015;422;65-74;50;30;80;SEC_422
2015;238;03-11;40;50;90;SEC_238
2015;627;16-17;11;3;14;SEC_627
2015;113;65-74;80;94;174;SEC_113
2015;224;16-17;7;8;15;SEC_224
2015;537;18-24;63;44;107;SEC_537
2015;247;16-17;9;8;17;SEC_247
2015;609;12-15;10;12;22;SEC_609
2015;323;75 i +;61;27;88;SEC_323
2015;211;03-11;47;61;108;SEC_211
2015;532;35-49;179;200;379;SEC_532
2015;212;03-11;72;66;138;SEC_212
2015;106;25-34;113;114;227;SEC_106
2015;440;16-17;9;5;14;SEC_440
2015;228;18-24;86;89;175;SEC_228
2015;616;50-64;235;207;442;SEC_616
2015;231;25-34;104;85;189;SEC_231
2015;233;50-64;71;71;142;SEC_233
2015;627;03-11;25;34;59;SEC_627
2015;105;25-34;67;73;140;SEC_105
2015;135;18-24;53;44;97;SEC_135
2015;607;35-49;109;126;235;SEC_607
2015;411;75 i +;95;77;172;SEC_411
2015;414;75 i +;95;65;160;SEC_414
2015;242;03-11;43;53;96;SEC_242
2015;504;03-11;29;43;72;SEC_504
2015;226;75 i +;121;75;196;SEC_226
2015;608;16-17;10;5;15;SEC_608
2015;303;75 i +;145;117;262;SEC_303
2015;531;65-74;47;27;74;SEC_531
2015;626;12-15;12;23;35;SEC_626
2015;117;00-02;13;26;39;SEC_117
2015;422;12-15;19;22;41;SEC_422
2015;436;18-24;69;63;132;SEC_436
2015;202;18-24;62;66;128;SEC_202
2015;435;65-74;39;30;69;SEC_435
2015;126;12-15;27;18;45;SEC_126
2015;627;35-49;91;92;183;SEC_627
2015;407;35-49;126;143;269;SEC_407
2015;621;75 i +;55;41;96;SEC_621
2015;437;75 i +;109;79;188;SEC_437
2015;202;35-49;232;277;509;SEC_202
2015;416;03-11;60;75;135;SEC_416
2015;310;35-49;107;119;226;SEC_310
2015;140;16-17;6;9;15;SEC_140
2015;302;65-74;107;114;221;SEC_302
2015;605;00-02;24;12;36;SEC_605
2015;411;50-64;90;68;158;SEC_411
2015;432;18-24;38;41;79;SEC_432
2015;421;75 i +;90;65;155;SEC_421
2015;602;50-64;84;94;178;SEC_602
2015;617;65-74;65;41;106;SEC_617
2015;617;18-24;28;27;55;SEC_617
2015;416;18-24;65;66;131;SEC_416
2015;433;00-02;27;27;54;SEC_433
2015;322;35-49;183;175;358;SEC_322
2015;437;50-64;143;123;266;SEC_437
2015;612;16-17;4;10;14;SEC_612
2015;242;18-24;41;35;76;SEC_242
2015;325;75 i +;195;102;297;SEC_325
2015;520;00-02;6;10;16;SEC_520
2015;508;12-15;26;16;42;SEC_508
2015;523;16-17;8;10;18;SEC_523
2015;625;50-64;186;146;332;SEC_625
2015;520;03-11;38;31;69;SEC_520
2015;139;18-24;34;32;66;SEC_139
2015;323;12-15;38;35;73;SEC_323
2015;127;75 i +;41;32;73;SEC_127
2015;607;03-11;36;33;69;SEC_607
2015;213;75 i +;52;41;93;SEC_213
2015;233;75 i +;62;36;98;SEC_233
2015;419;12-15;38;38;76;SEC_419
2015;133;00-02;8;8;16;SEC_133
2015;623;65-74;128;98;226;SEC_623
2015;401;50-64;133;110;243;SEC_401
2015;132;12-15;39;29;68;SEC_132
2015;317;03-11;66;56;122;SEC_317
2015;101;75 i +;64;43;107;SEC_101
2015;120;25-34;89;94;183;SEC_120
2015;243;12-15;22;32;54;SEC_243
2015;517;50-64;191;148;339;SEC_517
2015;135;75 i +;81;49;130;SEC_135
2015;322;65-74;60;53;113;SEC_322
2015;513;12-15;23;34;57;SEC_513
2015;245;12-15;27;24;51;SEC_245
2015;530;12-15;21;27;48;SEC_530
2015;433;12-15;35;34;69;SEC_433
2015;517;35-49;245;304;549;SEC_517
2015;426;25-34;95;88;183;SEC_426
2015;405;25-34;114;110;224;SEC_405
2015;427;75 i +;91;52;143;SEC_427
2015;216;18-24;41;47;88;SEC_216
2015;409;25-34;130;135;265;SEC_409
2015;525;75 i +;74;38;112;SEC_525
2015;140;75 i +;62;46;108;SEC_140
2015;507;18-24;24;35;59;SEC_507
2015;425;16-17;10;8;18;SEC_425
2015;609;65-74;86;71;157;SEC_609
2015;513;35-49;206;218;424;SEC_513
2015;229;65-74;62;28;90;SEC_229
2015;520;50-64;80;57;137;SEC_520
2015;123;18-24;43;46;89;SEC_123
2015;538;35-49;163;177;340;SEC_538
2015;613;12-15;16;18;34;SEC_613
2015;128;16-17;7;6;13;SEC_128
2015;617;25-34;47;48;95;SEC_617
2015;514;03-11;50;64;114;SEC_514
2015;310;12-15;14;21;35;SEC_310
2015;110;25-34;59;60;119;SEC_110
2015;608;65-74;73;49;122;SEC_608
2015;114;16-17;17;13;30;SEC_114
2015;436;12-15;35;35;70;SEC_436
2015;308;12-15;41;50;91;SEC_308
2015;243;25-34;124;92;216;SEC_243
2015;510;00-02;22;10;32;SEC_510
2015;212;75 i +;79;48;127;SEC_212
2015;228;35-49;296;329;625;SEC_228
2015;249;25-34;77;89;166;SEC_249
2015;124;35-49;92;82;174;SEC_124
2015;616;18-24;83;96;179;SEC_616
2015;301;75 i +;149;98;247;SEC_301
2015;611;35-49;238;265;503;SEC_611
2015;321;00-02;20;32;52;SEC_321
2015;312;35-49;219;249;468;SEC_312
2015;432;16-17;8;17;25;SEC_432
2015;517;12-15;39;46;85;SEC_517
2015;615;65-74;105;67;172;SEC_615
2015;538;75 i +;100;59;159;SEC_538
2015;403;50-64;103;92;195;SEC_403
2015;124;03-11;44;34;78;SEC_124
2015;622;18-24;20;33;53;SEC_622
2015;102;50-64;143;125;268;SEC_102
2015;221;12-15;37;32;69;SEC_221
2015;501;00-02;8;11;19;SEC_501
2015;425;75 i +;73;47;120;SEC_425
2015;615;75 i +;52;51;103;SEC_615
2015;414;35-49;247;244;491;SEC_414
2015;537;50-64;120;104;224;SEC_537
2015;432;03-11;54;49;103;SEC_432
2015;420;18-24;83;68;151;SEC_420
2015;124;18-24;17;24;41;SEC_124
2015;202;00-02;17;39;56;SEC_202
2015;325;18-24;66;53;119;SEC_325
2015;518;75 i +;81;58;139;SEC_518
2015;119;65-74;111;106;217;SEC_119
2015;240;35-49;211;218;429;SEC_240
2015;226;35-49;240;213;453;SEC_226
2015;318;03-11;29;30;59;SEC_318
2015;520;12-15;13;23;36;SEC_520
2015;123;00-02;14;16;30;SEC_123
2015;117;75 i +;92;57;149;SEC_117
2015;530;03-11;70;78;148;SEC_530
2015;224;65-74;50;42;92;SEC_224
2015;129;16-17;8;14;22;SEC_129
2015;128;00-02;11;22;33;SEC_128
2015;111;35-49;93;90;183;SEC_111
2015;313;25-34;121;117;238;SEC_313
2015;139;25-34;49;59;108;SEC_139
2015;115;00-02;21;15;36;SEC_115
2015;216;03-11;53;69;122;SEC_216
2015;607;12-15;18;9;27;SEC_607
2015;128;50-64;83;87;170;SEC_128
2015;118;35-49;175;192;367;SEC_118
2015;132;25-34;139;154;293;SEC_132
2015;140;35-49;123;124;247;SEC_140
2015;602;03-11;57;67;124;SEC_602
2015;210;25-34;46;50;96;SEC_210
2015;423;12-15;20;20;40;SEC_423
2015;122;18-24;26;23;49;SEC_122
2015;622;16-17;7;10;17;SEC_622
2015;630;16-17;4;9;13;SEC_630
2015;137;75 i +;58;43;101;SEC_137
2015;520;25-34;56;58;114;SEC_520
2015;418;03-11;71;54;125;SEC_418
2015;401;12-15;18;15;33;SEC_401
2015;136;00-02;21;17;38;SEC_136
2015;430;75 i +;56;35;91;SEC_430
2015;123;65-74;69;55;124;SEC_123
2015;315;50-64;186;158;344;SEC_315
2015;409;50-64;159;143;302;SEC_409
2015;322;03-11;65;57;122;SEC_322
2015;208;65-74;101;88;189;SEC_208
2015;101;25-34;139;130;269;SEC_101
2015;213;25-34;94;76;170;SEC_213
2015;243;75 i +;108;70;178;SEC_243
2015;229;16-17;25;14;39;SEC_229
2015;133;03-11;38;31;69;SEC_133
2015;322;75 i +;73;44;117;SEC_322
2015;504;25-34;83;73;156;SEC_504
2015;109;16-17;16;7;23;SEC_109
2015;306;16-17;19;15;34;SEC_306
2015;518;50-64;84;84;168;SEC_518
2015;240;75 i +;125;74;199;SEC_240
2015;233;25-34;95;79;174;SEC_233
2015;234;65-74;40;24;64;SEC_234
2015;134;50-64;136;113;249;SEC_134
2015;238;50-64;65;59;124;SEC_238
2015;134;16-17;18;9;27;SEC_134
2015;403;65-74;83;57;140;SEC_403
2015;412;18-24;62;54;116;SEC_412
2015;405;65-74;87;54;141;SEC_405
2015;120;03-11;50;79;129;SEC_120
2015;303;35-49;192;209;401;SEC_303
2015;249;00-02;14;12;26;SEC_249
2015;537;35-49;139;116;255;SEC_537
2015;427;12-15;29;25;54;SEC_427
2015;110;00-02;13;13;26;SEC_110
2015;226;65-74;85;72;157;SEC_226
2015;112;03-11;62;72;134;SEC_112
2015;617;35-49;117;137;254;SEC_617
2015;326;75 i +;4;2;6;SEC_326
2015;236;35-49;129;131;260;SEC_236
2015;212;65-74;65;44;109;SEC_212
2015;410;25-34;99;99;198;SEC_410
2015;107;16-17;15;8;23;SEC_107
2015;307;12-15;12;17;29;SEC_307
2015;237;12-15;21;30;51;SEC_237
2015;403;18-24;29;34;63;SEC_403
2015;631;00-02;10;15;25;SEC_631
2015;422;35-49;144;163;307;SEC_422
2015;305;35-49;177;192;369;SEC_305
2015;307;03-11;43;34;77;SEC_307
2015;236;50-64;83;73;156;SEC_236
2015;323;16-17;26;17;43;SEC_323
2015;312;25-34;168;136;304;SEC_312
2015;318;75 i +;45;26;71;SEC_318
2015;327;16-17;10;10;20;SEC_327
2015;248;03-11;61;63;124;SEC_248
2015;210;12-15;8;14;22;SEC_210
2015;613;18-24;28;38;66;SEC_613
2015;304;65-74;85;65;150;SEC_304
2015;513;65-74;57;37;94;SEC_513
2015;405;16-17;13;20;33;SEC_405
2015;612;35-49;116;141;257;SEC_612
2015;125;16-17;10;18;28;SEC_125
2015;127;18-24;22;23;45;SEC_127
2015;506;25-34;92;104;196;SEC_506
2015;312;03-11;56;67;123;SEC_312
2015;320;65-74;92;83;175;SEC_320
2015;503;03-11;18;25;43;SEC_503
2015;535;75 i +;60;63;123;SEC_535
2015;123;03-11;51;56;107;SEC_123
2015;432;65-74;89;82;171;SEC_432
2015;229;03-11;72;89;161;SEC_229
2015;517;03-11;113;99;212;SEC_517
2015;412;12-15;28;21;49;SEC_412
2015;502;16-17;18;15;33;SEC_502
2015;611;12-15;38;23;61;SEC_611
2015;626;50-64;71;75;146;SEC_626
2015;310;65-74;49;49;98;SEC_310
2015;616;25-34;111;135;246;SEC_616
2015;109;18-24;30;41;71;SEC_109
2015;315;16-17;19;18;37;SEC_315
2015;602;12-15;25;34;59;SEC_602
2015;430;03-11;54;59;113;SEC_430
2015;310;50-64;95;84;179;SEC_310
2015;607;00-02;10;12;22;SEC_607
2015;108;75 i +;100;58;158;SEC_108
2015;618;18-24;38;41;79;SEC_618
2015;118;18-24;62;51;113;SEC_118
2015;140;00-02;15;14;29;SEC_140
2015;209;50-64;112;94;206;SEC_209
2015;631;12-15;12;15;27;SEC_631
2015;411;03-11;36;27;63;SEC_411
2015;126;18-24;30;33;63;SEC_126
2015;610;03-11;45;43;88;SEC_610
2015;309;03-11;63;69;132;SEC_309
2015;137;03-11;87;60;147;SEC_137
2015;103;00-02;13;7;20;SEC_103
2015;106;65-74;107;129;236;SEC_106
2015;611;25-34;88;100;188;SEC_611
2015;407;03-11;47;45;92;SEC_407
2015;129;03-11;42;42;84;SEC_129
2015;116;75 i +;94;76;170;SEC_116
2015;418;18-24;49;66;115;SEC_418
2015;136;35-49;165;167;332;SEC_136
2015;105;50-64;134;108;242;SEC_105
2015;406;25-34;94;86;180;SEC_406
2015;220;50-64;159;136;295;SEC_220
2015;309;25-34;98;90;188;SEC_309
2015;305;65-74;72;71;143;SEC_305
2015;109;50-64;134;119;253;SEC_109
2015;134;65-74;69;63;132;SEC_134
2015;615;00-02;11;13;24;SEC_615
2015;321;75 i +;126;85;211;SEC_321
2015;520;65-74;47;44;91;SEC_520
2015;614;65-74;88;68;156;SEC_614
2015;501;65-74;102;109;211;SEC_501
2015;607;25-34;59;62;121;SEC_607
2015;112;12-15;41;31;72;SEC_112
2015;501;12-15;19;25;44;SEC_501
2015;602;75 i +;78;75;153;SEC_602
2015;315;00-02;29;16;45;SEC_315
2015;119;25-34;75;66;141;SEC_119
2015;502;65-74;89;77;166;SEC_502
2015;313;75 i +;90;68;158;SEC_313
2015;106;75 i +;75;38;113;SEC_106
2015;601;50-64;177;155;332;SEC_601
2015;630;50-64;87;73;160;SEC_630
2015;207;18-24;64;73;137;SEC_207
2015;109;65-74;62;66;128;SEC_109
2015;426;00-02;16;13;29;SEC_426
2015;430;16-17;4;12;16;SEC_430
2015;431;65-74;60;47;107;SEC_431
2015;136;03-11;59;55;114;SEC_136
2015;136;18-24;36;37;73;SEC_136
2015;533;35-49;239;263;502;SEC_533
2015;123;75 i +;81;65;146;SEC_123
2015;535;12-15;10;25;35;SEC_535
2015;119;16-17;9;8;17;SEC_119
2015;107;18-24;30;57;87;SEC_107
2015;123;12-15;21;18;39;SEC_123
2015;130;12-15;18;19;37;SEC_130
2015;316;35-49;168;145;313;SEC_316
2015;126;25-34;57;48;105;SEC_126
2015;510;35-49;111;131;242;SEC_510
2015;122;65-74;56;35;91;SEC_122
2015;105;12-15;12;23;35;SEC_105
2015;608;35-49;139;176;315;SEC_608
2015;526;65-74;66;47;113;SEC_526
2015;216;75 i +;80;62;142;SEC_216
2015;518;18-24;33;48;81;SEC_518
2015;223;03-11;54;58;112;SEC_223
2015;246;25-34;89;86;175;SEC_246
2015;324;75 i +;43;30;73;SEC_324
2015;622;03-11;28;36;64;SEC_622
2015;615;16-17;6;3;9;SEC_615
2015;226;00-02;23;27;50;SEC_226
2015;238;00-02;15;16;31;SEC_238
2015;308;75 i +;101;84;185;SEC_308
2015;508;16-17;11;15;26;SEC_508
2015;122;75 i +;66;53;119;SEC_122
2015;243;00-02;15;17;32;SEC_243
2015;621;18-24;57;40;97;SEC_621
2015;121;50-64;62;79;141;SEC_121
2015;414;18-24;59;81;140;SEC_414
2015;217;50-64;125;124;249;SEC_217
2015;619;75 i +;109;92;201;SEC_619
2015;106;12-15;36;24;60;SEC_106
2015;503;18-24;24;25;49;SEC_503
2015;630;12-15;15;11;26;SEC_630
2015;228;65-74;104;61;165;SEC_228
2015;137;00-02;24;14;38;SEC_137
2015;526;16-17;21;20;41;SEC_526
2015;435;12-15;21;15;36;SEC_435
2015;508;03-11;63;77;140;SEC_508
2015;426;35-49;125;168;293;SEC_426
2015;631;18-24;32;26;58;SEC_631
2015;314;25-34;162;168;330;SEC_314
2015;120;00-02;15;11;26;SEC_120
2015;431;50-64;115;105;220;SEC_431
2015;323;65-74;102;112;214;SEC_323
2015;505;35-49;146;132;278;SEC_505
2015;231;03-11;61;75;136;SEC_231
2015;526;25-34;150;158;308;SEC_526
2015;418;00-02;14;19;33;SEC_418
2015;115;03-11;52;54;106;SEC_115
2015;126;35-49;110;115;225;SEC_126
2015;207;25-34;162;119;281;SEC_207
2015;533;12-15;39;21;60;SEC_533
2015;316;65-74;127;135;262;SEC_316
2015;209;18-24;30;42;72;SEC_209
2015;307;00-02;20;11;31;SEC_307
2015;309;00-02;16;24;40;SEC_309
2015;627;50-64;123;84;207;SEC_627
2015;411;35-49;80;101;181;SEC_411
2015;220;03-11;78;82;160;SEC_220
2015;217;65-74;62;51;113;SEC_217
2015;221;65-74;91;70;161;SEC_221
2015;410;75 i +;158;101;259;SEC_410
2015;624;03-11;37;43;80;SEC_624
2015;420;12-15;31;42;73;SEC_420
2015;301;18-24;82;84;166;SEC_301
2015;139;12-15;14;18;32;SEC_139
2015;538;18-24;49;46;95;SEC_538
2015;126;03-11;38;39;77;SEC_126
2015;201;00-02;38;43;81;SEC_201
2015;138;35-49;91;80;171;SEC_138
2015;319;25-34;113;101;214;SEC_319
2015;534;00-02;11;14;25;SEC_534
2015;619;35-49;123;131;254;SEC_619
2015;405;18-24;66;60;126;SEC_405
2015;102;00-02;12;14;26;SEC_102
2015;513;50-64;107;122;229;SEC_513
2015;532;16-17;7;12;19;SEC_532
2015;614;75 i +;69;51;120;SEC_614
2015;614;18-24;21;28;49;SEC_614
2015;321;35-49;236;203;439;SEC_321
2015;513;00-02;15;25;40;SEC_513
2015;133;12-15;13;15;28;SEC_133
2015;411;12-15;16;13;29;SEC_411
2015;139;65-74;55;55;110;SEC_139
2015;511;65-74;103;74;177;SEC_511
2015;248;35-49;171;166;337;SEC_248
2015;232;65-74;50;36;86;SEC_232
2015;249;65-74;49;43;92;SEC_249
2015;205;12-15;16;19;35;SEC_205
2015;118;00-02;11;22;33;SEC_118
2015;223;65-74;61;36;97;SEC_223
2015;246;16-17;6;10;16;SEC_246
2015;414;00-02;30;30;60;SEC_414
2015;625;16-17;10;12;22;SEC_625
2015;110;12-15;19;17;36;SEC_110
2015;531;03-11;40;40;80;SEC_531
2015;245;25-34;92;69;161;SEC_245
2015;622;12-15;10;18;28;SEC_622
2015;234;25-34;81;73;154;SEC_234
2015;631;16-17;4;7;11;SEC_631
2015;233;00-02;15;18;33;SEC_233
2015;320;12-15;35;33;68;SEC_320
2015;232;18-24;52;45;97;SEC_232
2015;517;65-74;71;48;119;SEC_517
2015;418;16-17;13;19;32;SEC_418
2015;534;03-11;33;38;71;SEC_534
2015;119;03-11;40;41;81;SEC_119
2015;423;35-49;118;120;238;SEC_423
2015;529;00-02;24;14;38;SEC_529
2015;226;18-24;59;68;127;SEC_226
2015;613;25-34;48;60;108;SEC_613
2015;416;75 i +;90;55;145;SEC_416
2015;535;16-17;7;8;15;SEC_535
2015;313;65-74;100;88;188;SEC_313
2015;124;75 i +;47;40;87;SEC_124
2015;416;16-17;9;9;18;SEC_416
2015;315;75 i +;56;43;99;SEC_315
2015;615;50-64;50;45;95;SEC_615
2015;631;35-49;132;132;264;SEC_631
2015;107;65-74;101;89;190;SEC_107
2015;121;75 i +;78;43;121;SEC_121
2015;528;03-11;47;55;102;SEC_528
2015;136;25-34;84;53;137;SEC_136
2015;437;25-34;106;126;232;SEC_437
2015;427;03-11;82;90;172;SEC_427
2015;327;18-24;47;37;84;SEC_327
2015;103;75 i +;54;33;87;SEC_103
2015;104;12-15;9;22;31;SEC_104
2015;138;12-15;14;9;23;SEC_138
2015;627;18-24;14;29;43;SEC_627
2015;231;00-02;22;24;46;SEC_231
2015;125;25-34;91;94;185;SEC_125
2015;135;50-64;165;145;310;SEC_135
2015;110;03-11;44;34;78;SEC_110
2015;427;00-02;24;28;52;SEC_427
2015;243;65-74;57;49;106;SEC_243
2015;418;12-15;23;25;48;SEC_418
2015;411;25-34;71;47;118;SEC_411
2015;315;65-74;75;79;154;SEC_315
2015;306;03-11;70;57;127;SEC_306
2015;404;12-15;26;25;51;SEC_404
2015;502;35-49;187;194;381;SEC_502
2015;427;18-24;72;81;153;SEC_427
2015;232;12-15;16;13;29;SEC_232
2015;609;50-64;48;48;96;SEC_609
2015;211;16-17;12;20;32;SEC_211
2015;532;75 i +;99;62;161;SEC_532
2015;306;25-34;109;110;219;SEC_306
2015;245;00-02;15;17;32;SEC_245
2015;518;12-15;21;19;40;SEC_518
2015;533;75 i +;131;85;216;SEC_533
2015;505;75 i +;87;81;168;SEC_505
2015;305;12-15;30;23;53;SEC_305
2015;526;18-24;75;66;141;SEC_526
2015;125;18-24;40;46;86;SEC_125
2015;133;25-34;58;57;115;SEC_133
2015;314;00-02;35;31;66;SEC_314
2015;505;65-74;148;113;261;SEC_505
2015;420;03-11;88;81;169;SEC_420
2015;631;03-11;44;49;93;SEC_631
2015;521;35-49;87;114;201;SEC_521
2015;108;03-11;55;61;116;SEC_108
2015;312;75 i +;87;61;148;SEC_312
2015;301;35-49;391;405;796;SEC_301
2015;237;25-34;116;114;230;SEC_237
2015;207;65-74;75;57;132;SEC_207
2015;247;12-15;26;24;50;SEC_247
2015;118;50-64;195;161;356;SEC_118
2015;121;16-17;4;10;14;SEC_121
2015;116;03-11;60;51;111;SEC_116
2015;327;75 i +;28;17;45;SEC_327
2015;410;03-11;61;52;113;SEC_410
2015;533;18-24;63;61;124;SEC_533
2015;534;12-15;14;14;28;SEC_534
2015;422;16-17;13;11;24;SEC_422
2015;317;35-49;134;185;319;SEC_317
2015;426;65-74;39;33;72;SEC_426
2015;517;00-02;26;33;59;SEC_517
2015;607;50-64;90;83;173;SEC_607
2015;138;03-11;26;24;50;SEC_138
2015;621;03-11;54;57;111;SEC_621
2015;106;35-49;182;196;378;SEC_106
2015;623;03-11;57;60;117;SEC_623
2015;204;75 i +;107;61;168;SEC_204
2015;441;25-34;166;167;333;SEC_441
2015;213;03-11;40;55;95;SEC_213
2015;313;35-49;216;213;429;SEC_313
2015;533;65-74;95;62;157;SEC_533
2015;102;18-24;43;48;91;SEC_102
2015;517;18-24;68;99;167;SEC_517
2015;309;16-17;4;11;15;SEC_309
2015;140;18-24;27;43;70;SEC_140
2015;112;65-74;91;75;166;SEC_112
2015;220;25-34;147;152;299;SEC_220
2015;224;75 i +;74;32;106;SEC_224
2015;210;75 i +;92;44;136;SEC_210
2015;202;50-64;126;111;237;SEC_202
2015;521;03-11;36;34;70;SEC_521
2015;423;65-74;48;43;91;SEC_423
2015;129;50-64;88;81;169;SEC_129
2015;605;35-49;203;198;401;SEC_605
2015;614;35-49;106;108;214;SEC_614
2015;510;18-24;40;35;75;SEC_510
2015;410;18-24;54;72;126;SEC_410
2015;425;25-34;93;86;179;SEC_425
2015;622;00-02;8;6;14;SEC_622
2015;534;50-64;79;77;156;SEC_534
2015;313;00-02;19;24;43;SEC_313
2015;538;16-17;7;13;20;SEC_538
2015;425;65-74;47;33;80;SEC_425
2015;131;12-15;9;29;38;SEC_131
2015;433;50-64;149;154;303;SEC_433
2015;127;03-11;35;33;68;SEC_127
2015;411;65-74;71;52;123;SEC_411
2015;521;25-34;51;44;95;SEC_521
2015;610;12-15;20;28;48;SEC_610
2015;102;35-49;164;178;342;SEC_102
2015;133;35-49;91;110;201;SEC_133
2015;108;00-02;19;32;51;SEC_108
2015;324;35-49;151;185;336;SEC_324
2015;125;65-74;99;88;187;SEC_125
2015;531;75 i +;49;41;90;SEC_531
2015;224;03-11;56;64;120;SEC_224
2015;324;16-17;9;11;20;SEC_324
2015;122;50-64;52;48;100;SEC_122
2015;311;18-24;39;49;88;SEC_311
2015;303;03-11;67;52;119;SEC_303
2015;406;65-74;86;66;152;SEC_406
2015;601;16-17;17;16;33;SEC_601
2015;105;18-24;28;39;67;SEC_105
2015;207;75 i +;121;50;171;SEC_207
2015;511;18-24;82;72;154;SEC_511
2015;430;35-49;139;173;312;SEC_430
2015;125;50-64;149;141;290;SEC_125
2015;406;12-15;26;25;51;SEC_406
2015;310;18-24;26;26;52;SEC_310
2015;121;25-34;51;47;98;SEC_121
2015;412;25-34;96;110;206;SEC_412
2015;623;75 i +;71;52;123;SEC_623
2015;529;12-15;25;27;52;SEC_529
2015;315;03-11;80;88;168;SEC_315
2015;502;12-15;24;26;50;SEC_502
2015;208;25-34;119;110;229;SEC_208
2015;129;65-74;74;48;122;SEC_129
2015;314;50-64;279;243;522;SEC_314
2015;309;18-24;29;34;63;SEC_309
2015;247;75 i +;85;48;133;SEC_247
2015;303;65-74;115;79;194;SEC_303
2015;525;00-02;14;25;39;SEC_525
2015;534;18-24;32;25;57;SEC_534
2015;245;35-49;136;163;299;SEC_245
2015;112;75 i +;73;40;113;SEC_112
2015;321;12-15;39;40;79;SEC_321
2015;301;12-15;52;47;99;SEC_301
2015;304;35-49;429;451;880;SEC_304
2015;421;25-34;76;79;155;SEC_421
2015;605;03-11;67;79;146;SEC_605
2015;537;12-15;23;9;32;SEC_537
2015;204;00-02;17;32;49;SEC_204
2015;317;16-17;11;7;18;SEC_317
2015;607;75 i +;96;84;180;SEC_607
2015;122;12-15;15;19;34;SEC_122
2015;524;16-17;12;15;27;SEC_524
2015;228;16-17;27;23;50;SEC_228
2015;209;75 i +;81;54;135;SEC_209
2015;103;65-74;34;34;68;SEC_103
2015;324;50-64;66;74;140;SEC_324
2015;625;25-34;61;81;142;SEC_625
2015;611;75 i +;101;84;185;SEC_611
2015;430;00-02;22;14;36;SEC_430
2015;220;00-02;24;19;43;SEC_220
2015;506;18-24;63;68;131;SEC_506
2015;407;18-24;40;25;65;SEC_407
2015;407;50-64;84;76;160;SEC_407
2015;323;03-11;75;100;175;SEC_323
2015;606;03-11;50;46;96;SEC_606
2015;306;65-74;76;65;141;SEC_306
2015;318;16-17;9;7;16;SEC_318
2015;107;00-02;24;16;40;SEC_107
2015;205;16-17;8;8;16;SEC_205
2015;237;50-64;111;107;218;SEC_237
2015;419;75 i +;114;81;195;SEC_419
2015;621;50-64;162;104;266;SEC_621
2015;423;50-64;83;69;152;SEC_423
2015;239;18-24;36;36;72;SEC_239
2015;430;65-74;30;31;61;SEC_430
2015;113;16-17;13;15;28;SEC_113
2015;501;18-24;27;35;62;SEC_501
2015;302;75 i +;66;49;115;SEC_302
2015;309;50-64;102;76;178;SEC_309
2015;223;25-34;99;91;190;SEC_223
2015;436;25-34;101;90;191;SEC_436
2015;316;16-17;14;13;27;SEC_316
2015;327;03-11;47;63;110;SEC_327
2015;602;65-74;92;62;154;SEC_602
2015;226;16-17;11;10;21;SEC_226
2015;209;65-74;39;29;68;SEC_209
2015;108;18-24;53;46;99;SEC_108
2015;431;16-17;16;15;31;SEC_431
2015;224;50-64;108;85;193;SEC_224
2015;327;00-02;11;20;31;SEC_327
2015;135;12-15;20;25;45;SEC_135
2015;213;65-74;51;36;87;SEC_213
2015;112;25-34;99;90;189;SEC_112
2015;114;25-34;62;60;122;SEC_114
2015;532;18-24;50;53;103;SEC_532
2015;111;25-34;51;32;83;SEC_111
2015;538;25-34;98;89;187;SEC_538
2015;534;25-34;68;63;131;SEC_534
2015;432;00-02;20;17;37;SEC_432
2015;538;12-15;20;35;55;SEC_538
2015;627;75 i +;47;35;82;SEC_627
2015;209;25-34;76;72;148;SEC_209
2015;321;65-74;157;135;292;SEC_321
2015;101;65-74;68;66;134;SEC_101
2015;239;75 i +;94;50;144;SEC_239
2015;325;12-15;26;39;65;SEC_325
2015;102;16-17;12;13;25;SEC_102
2015;118;12-15;31;17;48;SEC_118
2015;101;16-17;19;15;34;SEC_101
2015;210;35-49;103;88;191;SEC_210
2015;113;12-15;15;29;44;SEC_113
2015;605;65-74;153;102;255;SEC_605
2015;517;16-17;23;27;50;SEC_517
2015;303;18-24;37;38;75;SEC_303
2015;120;65-74;88;80;168;SEC_120
2015;210;50-64;79;79;158;SEC_210
2015;403;75 i +;95;82;177;SEC_403
2015;212;12-15;23;23;46;SEC_212
2015;311;35-49;169;215;384;SEC_311
2015;614;12-15;17;8;25;SEC_614
2015;232;35-49;136;140;276;SEC_232
2015;210;03-11;39;33;72;SEC_210
2015;524;25-34;94;103;197;SEC_524
2015;316;00-02;15;29;44;SEC_316
2015;221;50-64;164;167;331;SEC_221
2015;224;00-02;20;21;41;SEC_224
2015;529;50-64;88;90;178;SEC_529
2015;404;75 i +;85;54;139;SEC_404
2015;524;65-74;47;30;77;SEC_524
2015;437;35-49;176;212;388;SEC_437
2015;226;12-15;40;27;67;SEC_226
2015;240;25-34;142;139;281;SEC_240
2015;631;50-64;77;66;143;SEC_631
2015;518;25-34;62;57;119;SEC_518
2015;412;03-11;45;52;97;SEC_412
2015;322;16-17;15;12;27;SEC_322
2015;622;35-49;96;109;205;SEC_622
2015;323;25-34;100;114;214;SEC_323
2015;103;50-64;61;61;122;SEC_103
2015;412;16-17;6;12;18;SEC_412
2015;407;65-74;46;28;74;SEC_407
2015;505;50-64;92;78;170;SEC_505
2015;204;03-11;47;60;107;SEC_204
2015;109;25-34;79;75;154;SEC_109
2015;221;16-17;16;29;45;SEC_221
2015;532;12-15;29;17;46;SEC_532
2015;131;25-34;73;71;144;SEC_131
2015;601;12-15;28;33;61;SEC_601
2015;238;65-74;43;36;79;SEC_238
2015;608;12-15;27;19;46;SEC_608
2015;617;00-02;9;20;29;SEC_617
2015;412;65-74;118;80;198;SEC_412
2015;125;35-49;216;223;439;SEC_125
2015;418;35-49;151;175;326;SEC_418
2015;626;35-49;100;100;200;SEC_626
2015;310;16-17;4;9;13;SEC_310
2015;319;16-17;14;23;37;SEC_319
2015;503;00-02;7;10;17;SEC_503
2015;601;18-24;60;60;120;SEC_601
2015;302;16-17;5;11;16;SEC_302
2015;102;12-15;39;36;75;SEC_102
2015;105;16-17;7;7;14;SEC_105
2015;524;12-15;24;19;43;SEC_524
2015;129;00-02;12;23;35;SEC_129
2015;305;16-17;17;10;27;SEC_305
2015;140;50-64;83;68;151;SEC_140
2015;521;75 i +;67;60;127;SEC_521
2015;314;75 i +;91;63;154;SEC_314
2015;305;50-64;198;179;377;SEC_305
2015;224;25-34;114;106;220;SEC_224
2015;404;50-64;110;105;215;SEC_404
2015;111;00-02;13;5;18;SEC_111
2015;414;03-11;86;86;172;SEC_414
2015;239;25-34;77;89;166;SEC_239
2015;107;12-15;28;24;52;SEC_107
2015;210;65-74;62;49;111;SEC_210
2015;223;75 i +;61;44;105;SEC_223
2015;324;25-34;96;76;172;SEC_324
2015;507;12-15;9;21;30;SEC_507
2015;402;03-11;46;44;90;SEC_402
2015;324;03-11;57;56;113;SEC_324
2015;432;35-49;127;144;271;SEC_432
2015;137;25-34;98;81;179;SEC_137
2015;228;03-11;100;104;204;SEC_228
2015;234;35-49;141;139;280;SEC_234
2015;507;25-34;49;57;106;SEC_507
2015;115;50-64;117;123;240;SEC_115
2015;236;12-15;16;21;37;SEC_236
2015;404;03-11;77;65;142;SEC_404
2015;140;65-74;49;46;95;SEC_140
2015;606;00-02;12;22;34;SEC_606
2015;525;12-15;11;16;27;SEC_525
2015;610;35-49;127;128;255;SEC_610
2015;119;50-64;141;98;239;SEC_119
2015;127;25-34;62;51;113;SEC_127
2015;113;03-11;70;88;158;SEC_113
2015;511;35-49;277;285;562;SEC_511
2015;433;03-11;84;102;186;SEC_433
2015;101;03-11;155;181;336;SEC_101
2015;320;18-24;5;2;7;SEC_320
2015;208;03-11;35;48;83;SEC_208
2015;134;18-24;43;48;91;SEC_134
2015;501;03-11;21;35;56;SEC_501
2015;505;00-02;8;9;17;SEC_505
2015;118;16-17;20;13;33;SEC_118
2015;132;65-74;117;134;251;SEC_132
2015;115;16-17;13;9;22;SEC_115
2015;130;03-11;54;36;90;SEC_130
2015;216;35-49;155;146;301;SEC_216
2015;243;16-17;17;21;38;SEC_243
2015;120;12-15;28;38;66;SEC_120
2015;613;00-02;7;12;19;SEC_613
2015;426;16-17;19;4;23;SEC_426
2015;129;75 i +;98;79;177;SEC_129
2015;101;35-49;369;366;735;SEC_101
2015;511;50-64;187;154;341;SEC_511
2015;217;35-49;156;225;381;SEC_217
2015;211;75 i +;81;38;119;SEC_211
2015;312;12-15;19;24;43;SEC_312
2015;305;18-24;72;62;134;SEC_305
2015;427;65-74;54;37;91;SEC_427
2015;529;35-49;177;165;342;SEC_529
2015;502;75 i +;141;81;222;SEC_502
2015;122;16-17;5;9;14;SEC_122
2015;204;18-24;76;68;144;SEC_204
2015;626;25-34;52;39;91;SEC_626
2015;121;00-02;7;13;20;SEC_121
2015;436;03-11;76;74;150;SEC_436
2015;242;50-64;92;89;181;SEC_242
2015;131;50-64;134;119;253;SEC_131
2015;249;35-49;124;125;249;SEC_249
2015;325;00-02;19;17;36;SEC_325
2015;326;00-02;48;53;101;SEC_326
2015;619;25-34;50;66;116;SEC_619
2015;308;00-02;23;16;39;SEC_308
2015;622;75 i +;35;15;50;SEC_622
2015;108;25-34;102;86;188;SEC_108
2015;609;00-02;9;8;17;SEC_609
2015;138;50-64;92;77;169;SEC_138
2015;307;16-17;10;11;21;SEC_307
2015;236;00-02;15;14;29;SEC_236
2015;311;16-17;17;16;33;SEC_311
2015;128;03-11;40;59;99;SEC_128
2015;240;03-11;82;63;145;SEC_240
2015;231;75 i +;84;41;125;SEC_231
2015;431;25-34;114;140;254;SEC_431
2015;135;65-74;79;80;159;SEC_135
2015;301;25-34;157;171;328;SEC_301
2015;504;12-15;9;12;21;SEC_504
2015;127;12-15;15;18;33;SEC_127
2015;140;25-34;62;42;104;SEC_140
2015;405;50-64;140;143;283;SEC_405
2015;214;03-11;98;106;204;SEC_214
2015;309;35-49;159;159;318;SEC_309
2015;212;00-02;16;19;35;SEC_212
2015;505;16-17;4;6;10;SEC_505
2015;609;03-11;41;42;83;SEC_609
2015;318;00-02;9;12;21;SEC_318
2015;510;12-15;19;13;32;SEC_510
2015;423;25-34;71;83;154;SEC_423
2015;433;65-74;58;50;108;SEC_433
2015;224;12-15;18;21;39;SEC_224
2015;119;18-24;35;35;70;SEC_119
2015;232;03-11;36;51;87;SEC_232
2015;213;16-17;3;17;20;SEC_213
2015;210;18-24;27;26;53;SEC_210
2015;510;25-34;64;71;135;SEC_510
2015;436;50-64;136;127;263;SEC_436
2015;535;35-49;89;88;177;SEC_535
2015;317;75 i +;49;23;72;SEC_317
2015;528;50-64;108;83;191;SEC_528
2015;312;65-74;137;91;228;SEC_312
2015;139;35-49;96;116;212;SEC_139
2015;327;25-34;91;84;175;SEC_327
2015;406;35-49;157;163;320;SEC_406
2015;239;03-11;24;37;61;SEC_239
2015;407;16-17;9;7;16;SEC_407
2015;531;50-64;85;84;169;SEC_531
2015;322;00-02;22;20;42;SEC_322
2015;623;35-49;160;174;334;SEC_623
2015;238;75 i +;56;37;93;SEC_238
2015;602;00-02;16;20;36;SEC_602
2015;120;75 i +;70;42;112;SEC_120
2015;103;16-17;5;4;9;SEC_103
2015;304;18-24;90;65;155;SEC_304
2015;126;50-64;77;54;131;SEC_126
2015;407;00-02;10;18;28;SEC_407
2015;523;75 i +;91;67;158;SEC_523
2015;301;16-17;21;17;38;SEC_301
2015;317;25-34;79;88;167;SEC_317
2015;204;25-34;118;113;231;SEC_204
2015;237;00-02;21;26;47;SEC_237
2015;221;75 i +;116;84;200;SEC_221
2015;304;16-17;41;19;60;SEC_304
2015;409;00-02;36;21;57;SEC_409
2015;605;12-15;30;30;60;SEC_605
2015;238;16-17;14;14;28;SEC_238
2015;535;18-24;32;29;61;SEC_535
2015;136;50-64;106;98;204;SEC_136
2015;518;03-11;47;52;99;SEC_518
2015;129;35-49;130;144;274;SEC_129
2015;240;00-02;24;19;43;SEC_240
2015;530;00-02;25;38;63;SEC_530
2015;228;50-64;156;171;327;SEC_228
2015;601;65-74;155;113;268;SEC_601
2015;205;35-49;99;97;196;SEC_205
2015;630;00-02;9;13;22;SEC_630
2015;109;75 i +;72;37;109;SEC_109
2015;436;75 i +;65;46;111;SEC_436
2015;538;03-11;54;57;111;SEC_538
2015;613;75 i +;82;58;140;SEC_613
2015;503;25-34;34;48;82;SEC_503
2015;532;03-11;69;69;138;SEC_532
2015;223;00-02;26;16;42;SEC_223
2015;119;00-02;13;10;23;SEC_119
2015;420;35-49;223;268;491;SEC_420
2015;113;50-64;211;158;369;SEC_113
2015;318;35-49;88;81;169;SEC_318
2015;111;03-11;28;28;56;SEC_111
2015;511;75 i +;144;101;245;SEC_511
2015;618;03-11;50;46;96;SEC_618
2015;524;50-64;104;80;184;SEC_524
2015;316;50-64;359;299;658;SEC_316
2015;319;75 i +;41;29;70;SEC_319
2015;422;75 i +;76;45;121;SEC_422
2015;122;00-02;16;17;33;SEC_122
2015;624;00-02;16;11;27;SEC_624
2015;320;75 i +;1;1;2;SEC_320
2015;531;00-02;10;13;23;SEC_531
2015;513;16-17;16;17;33;SEC_513
2015;514;75 i +;98;60;158;SEC_514
2015;207;35-49;259;232;491;SEC_207
2015;320;75 i +;50;31;81;SEC_320
2015;528;35-49;163;152;315;SEC_528
2015;205;75 i +;79;51;130;SEC_205
2015;525;25-34;80;63;143;SEC_525
2015;120;18-24;69;62;131;SEC_120
2015;523;25-34;87;102;189;SEC_523
2015;507;65-74;57;45;102;SEC_507
2015;406;18-24;62;54;116;SEC_406
2015;326;16-17;6;5;11;SEC_326
2015;246;75 i +;73;48;121;SEC_246
2015;321;16-17;27;25;52;SEC_321
2015;108;50-64;145;126;271;SEC_108
2015;530;18-24;60;70;130;SEC_530
2015;131;35-49;153;174;327;SEC_131
2015;403;00-02;17;10;27;SEC_403
2015;617;75 i +;63;40;103;SEC_617
2015;616;03-11;108;105;213;SEC_616
2015;315;35-49;256;253;509;SEC_315
2015;249;75 i +;73;42;115;SEC_249
2015;611;18-24;50;58;108;SEC_611
2015;139;03-11;33;34;67;SEC_139
2015;121;03-11;35;50;85;SEC_121
2015;304;12-15;82;47;129;SEC_304
2015;107;35-49;202;213;415;SEC_107
2015;140;12-15;13;21;34;SEC_140
2015;612;18-24;25;36;61;SEC_612
2015;441;03-11;84;75;159;SEC_441
2015;526;50-64;138;132;270;SEC_526
2015;242;75 i +;76;55;131;SEC_242
2015;320;25-34;62;70;132;SEC_320
2015;317;50-64;84;69;153;SEC_317
2015;134;75 i +;81;41;122;SEC_134
2015;137;12-15;25;26;51;SEC_137
2015;209;00-02;12;15;27;SEC_209
2015;212;16-17;16;13;29;SEC_212
2015;318;65-74;43;39;82;SEC_318
2015;402;12-15;11;23;34;SEC_402
2015;233;35-49;131;149;280;SEC_233
2015;216;12-15;23;17;40;SEC_216
2015;514;25-34;86;99;185;SEC_514
2015;503;16-17;10;8;18;SEC_503
2015;305;00-02;22;15;37;SEC_305
2015;320;00-02;20;17;37;SEC_320
2015;201;03-11;69;85;154;SEC_201
2015;624;65-74;109;103;212;SEC_624
2015;606;50-64;89;82;171;SEC_606
2015;529;75 i +;95;60;155;SEC_529
2015;606;35-49;129;129;258;SEC_606
2015;421;16-17;8;10;18;SEC_421
2015;425;12-15;14;26;40;SEC_425
2015;607;16-17;5;8;13;SEC_607
2015;134;25-34;93;95;188;SEC_134
2015;406;16-17;13;9;22;SEC_406
2015;618;16-17;12;19;31;SEC_618
2015;125;03-11;83;73;156;SEC_125
2015;535;25-34;47;43;90;SEC_535
2015;427;25-34;140;129;269;SEC_427
2015;243;35-49;215;202;417;SEC_243
2015;327;12-15;25;24;49;SEC_327
2015;212;50-64;114;106;220;SEC_212
2015;134;35-49;174;165;339;SEC_134
2015;136;65-74;60;63;123;SEC_136
2015;131;75 i +;70;63;133;SEC_131
2015;240;65-74;58;36;94;SEC_240
2015;531;18-24;45;41;86;SEC_531
2015;213;18-24;32;36;68;SEC_213
2015;531;12-15;19;8;27;SEC_531
2015;231;35-49;172;178;350;SEC_231
2015;223;18-24;62;51;113;SEC_223
2015;106;18-24;44;50;94;SEC_106
2015;234;18-24;38;38;76;SEC_234
2015;102;25-34;71;58;129;SEC_102
2015;319;50-64;140;134;274;SEC_319
2015;327;35-49;131;137;268;SEC_327
2015;116;00-02;22;12;34;SEC_116
2015;126;00-02;10;12;22;SEC_126
2015;630;18-24;22;25;47;SEC_630
2015;610;00-02;10;12;22;SEC_610
2015;237;18-24;41;53;94;SEC_237
2015;228;00-02;32;27;59;SEC_228
2015;425;18-24;36;43;79;SEC_425
2015;601;00-02;19;31;50;SEC_601
2015;613;03-11;41;50;91;SEC_613
2015;440;12-15;11;17;28;SEC_440
2015;201;16-17;6;11;17;SEC_201
2015;324;12-15;23;25;48;SEC_324
2015;114;75 i +;106;72;178;SEC_114
2015;617;50-64;81;72;153;SEC_617
2015;607;18-24;30;34;64;SEC_607
2015;132;50-64;239;216;455;SEC_132
2015;410;16-17;19;19;38;SEC_410
2015;409;03-11;72;79;151;SEC_409
2015;307;50-64;179;124;303;SEC_307
2015;537;75 i +;83;56;139;SEC_537
2015;249;18-24;41;40;81;SEC_249
2015;315;18-24;51;62;113;SEC_315
2015;432;50-64;125;105;230;SEC_432
