AnyPadro;Seccio;GrupEdat;Dones;Homes;Total;IdSeccio
1999;438;18-24;39;38;77;SEC_438
1999;130;65-74;82;73;155;SEC_130
1999;240;03-11;15;24;39;SEC_240
1999;109;75 i +;46;23;69;SEC_109
1999;207;50-64;59;48;107;SEC_207
1999;430;03-11;25;39;64;SEC_430
1999;208;25-34;120;145;265;SEC_208
1999;121;50-64;61;42;103;SEC_121
1999;515;75 i +;26;13;39;SEC_515
1999;612;03-11;35;36;71;SEC_612
1999;126;16-17;10;7;17;SEC_126
1999;527;18-24;40;48;88;SEC_527
1999;525;18-24;43;55;98;SEC_525
1999;435;03-11;32;29;61;SEC_435
1999;103;75 i +;47;23;70;SEC_103
1999;314;03-11;84;114;198;SEC_314
1999;439;16-17;3;9;12;SEC_439
1999;203;18-24;25;27;52;SEC_203
1999;417;16-17;5;11;16;SEC_417
1999;427;35-49;69;66;135;SEC_427
1999;214;75 i +;40;14;54;SEC_214
1999;240;18-24;22;27;49;SEC_240
1999;304;50-64;107;102;209;SEC_304
1999;320;25-34;68;84;152;SEC_320
1999;123;16-17;11;12;23;SEC_123
1999;436;65-74;30;22;52;SEC_436
1999;101;12-15;36;34;70;SEC_101
1999;111;00-02;4;17;21;SEC_111
1999;210;65-74;91;66;157;SEC_210
1999;434;00-02;7;5;12;SEC_434
1999;228;75 i +;36;21;57;SEC_228
1999;628;75 i +;34;12;46;SEC_628
1999;224;35-49;60;60;120;SEC_224
1999;402;65-74;49;68;117;SEC_402
1999;311;00-02;16;13;29;SEC_311
1999;311;75 i +;82;39;121;SEC_311
1999;535;00-02;4;5;9;SEC_535
1999;609;00-02;10;4;14;SEC_609
1999;437;35-49;83;72;155;SEC_437
1999;611;25-34;187;202;389;SEC_611
1999;218;03-11;23;21;44;SEC_218
1999;402;75 i +;43;24;67;SEC_402
1999;202;35-49;52;53;105;SEC_202
1999;222;35-49;71;68;139;SEC_222
1999;210;18-24;40;38;78;SEC_210
1999;105;25-34;73;90;163;SEC_105
1999;537;35-49;111;110;221;SEC_537
1999;209;18-24;25;29;54;SEC_209
1999;513;03-11;16;20;36;SEC_513
1999;322;00-02;20;11;31;SEC_322
1999;233;50-64;73;68;141;SEC_233
1999;111;03-11;37;29;66;SEC_111
1999;508;25-34;41;60;101;SEC_508
1999;242;35-49;88;90;178;SEC_242
1999;324;16-17;10;9;19;SEC_324
1999;435;12-15;16;27;43;SEC_435
1999;517;18-24;41;61;102;SEC_517
1999;130;75 i +;61;37;98;SEC_130
1999;505;16-17;15;15;30;SEC_505
1999;101;03-11;58;62;120;SEC_101
1999;232;16-17;9;11;20;SEC_232
1999;232;03-11;31;26;57;SEC_232
1999;246;65-74;75;58;133;SEC_246
1999;208;75 i +;123;67;190;SEC_208
1999;622;18-24;72;60;132;SEC_622
1999;107;03-11;50;52;102;SEC_107
1999;135;50-64;135;157;292;SEC_135
1999;311;50-64;141;117;258;SEC_311
1999;118;65-74;41;37;78;SEC_118
1999;311;03-11;34;41;75;SEC_311
1999;306;65-74;105;79;184;SEC_306
1999;209;75 i +;88;46;134;SEC_209
1999;224;03-11;17;19;36;SEC_224
1999;323;00-02;51;37;88;SEC_323
1999;414;35-49;79;82;161;SEC_414
1999;236;35-49;86;85;171;SEC_236
1999;610;18-24;85;83;168;SEC_610
1999;604;16-17;8;4;12;SEC_604
1999;107;16-17;22;21;43;SEC_107
1999;226;00-02;7;6;13;SEC_226
1999;505;25-34;136;149;285;SEC_505
1999;626;16-17;5;5;10;SEC_626
1999;603;16-17;6;5;11;SEC_603
1999;324;50-64;71;75;146;SEC_324
1999;406;75 i +;53;31;84;SEC_406
1999;437;00-02;16;3;19;SEC_437
1999;414;65-74;66;66;132;SEC_414
1999;119;16-17;17;12;29;SEC_119
1999;406;65-74;68;78;146;SEC_406
1999;222;65-74;47;41;88;SEC_222
1999;239;18-24;47;52;99;SEC_239
1999;318;35-49;131;130;261;SEC_318
1999;622;12-15;21;23;44;SEC_622
1999;414;75 i +;42;25;67;SEC_414
1999;103;50-64;63;63;126;SEC_103
1999;129;03-11;41;31;72;SEC_129
1999;405;50-64;118;86;204;SEC_405
1999;433;50-64;77;74;151;SEC_433
1999;431;50-64;116;112;228;SEC_431
1999;416;35-49;51;65;116;SEC_416
1999;247;65-74;79;65;144;SEC_247
1999;614;25-34;102;108;210;SEC_614
1999;605;50-64;113;94;207;SEC_605
1999;323;50-64;199;250;449;SEC_323
1999;522;12-15;18;13;31;SEC_522
1999;505;35-49;93;80;173;SEC_505
1999;525;25-34;83;83;166;SEC_525
1999;112;03-11;56;61;117;SEC_112
1999;310;03-11;28;35;63;SEC_310
1999;608;00-02;6;8;14;SEC_608
1999;229;50-64;61;59;120;SEC_229
1999;505;00-02;9;5;14;SEC_505
1999;631;65-74;45;46;91;SEC_631
1999;438;35-49;71;64;135;SEC_438
1999;304;00-02;6;12;18;SEC_304
1999;113;00-02;12;14;26;SEC_113
1999;535;35-49;121;110;231;SEC_535
1999;314;25-34;175;181;356;SEC_314
1999;620;12-15;15;12;27;SEC_620
1999;423;12-15;9;18;27;SEC_423
1999;140;35-49;76;70;146;SEC_140
1999;138;03-11;25;35;60;SEC_138
1999;239;16-17;10;7;17;SEC_239
1999;407;00-02;10;11;21;SEC_407
1999;140;03-11;10;14;24;SEC_140
1999;128;03-11;23;36;59;SEC_128
1999;316;12-15;94;100;194;SEC_316
1999;419;35-49;57;72;129;SEC_419
1999;421;12-15;4;15;19;SEC_421
1999;318;75 i +;8;8;16;SEC_318
1999;310;00-02;9;13;22;SEC_310
1999;137;18-24;86;85;171;SEC_137
1999;116;12-15;34;21;55;SEC_116
1999;435;75 i +;102;46;148;SEC_435
1999;416;00-02;6;6;12;SEC_416
1999;243;00-02;9;14;23;SEC_243
1999;625;12-15;39;46;85;SEC_625
1999;234;12-15;11;12;23;SEC_234
1999;419;25-34;80;91;171;SEC_419
1999;238;25-34;57;53;110;SEC_238
1999;605;00-02;3;5;8;SEC_605
1999;617;25-34;106;132;238;SEC_617
1999;523;50-64;138;130;268;SEC_523
1999;211;18-24;39;51;90;SEC_211
1999;601;16-17;15;23;38;SEC_601
1999;512;65-74;44;29;73;SEC_512
1999;604;18-24;39;51;90;SEC_604
1999;529;00-02;13;13;26;SEC_529
1999;438;25-34;86;95;181;SEC_438
1999;513;16-17;5;2;7;SEC_513
1999;123;35-49;126;131;257;SEC_123
1999;504;35-49;98;84;182;SEC_504
1999;608;35-49;85;88;173;SEC_608
1999;630;35-49;111;89;200;SEC_630
1999;629;75 i +;25;7;32;SEC_629
1999;133;16-17;11;12;23;SEC_133
1999;504;75 i +;54;36;90;SEC_504
1999;427;50-64;76;53;129;SEC_427
1999;211;16-17;9;9;18;SEC_211
1999;534;00-02;9;12;21;SEC_534
1999;407;12-15;8;17;25;SEC_407
1999;319;18-24;43;49;92;SEC_319
1999;214;65-74;44;43;87;SEC_214
1999;123;65-74;80;73;153;SEC_123
1999;242;75 i +;50;47;97;SEC_242
1999;524;65-74;81;58;139;SEC_524
1999;234;35-49;79;75;154;SEC_234
1999;432;16-17;11;19;30;SEC_432
1999;248;75 i +;61;38;99;SEC_248
1999;208;65-74;135;119;254;SEC_208
1999;606;00-02;6;9;15;SEC_606
1999;611;65-74;80;76;156;SEC_611
1999;140;12-15;13;11;24;SEC_140
1999;433;03-11;44;33;77;SEC_433
1999;628;03-11;39;32;71;SEC_628
1999;325;65-74;122;98;220;SEC_325
1999;409;50-64;76;69;145;SEC_409
1999;138;18-24;47;53;100;SEC_138
1999;402;50-64;94;77;171;SEC_402
1999;514;35-49;61;65;126;SEC_514
1999;417;50-64;68;54;122;SEC_417
1999;325;03-11;59;55;114;SEC_325
1999;106;35-49;266;236;502;SEC_106
1999;410;16-17;24;23;47;SEC_410
1999;437;12-15;14;18;32;SEC_437
1999;304;65-74;92;72;164;SEC_304
1999;423;16-17;12;7;19;SEC_423
1999;129;00-02;8;17;25;SEC_129
1999;204;00-02;4;4;8;SEC_204
1999;438;65-74;40;37;77;SEC_438
1999;407;50-64;98;83;181;SEC_407
1999;441;25-34;120;134;254;SEC_441
1999;405;75 i +;29;21;50;SEC_405
1999;432;00-02;5;12;17;SEC_432
1999;519;75 i +;15;14;29;SEC_519
1999;103;18-24;42;41;83;SEC_103
1999;410;65-74;117;110;227;SEC_410
1999;426;12-15;11;14;25;SEC_426
1999;231;18-24;45;54;99;SEC_231
1999;628;35-49;113;79;192;SEC_628
1999;234;25-34;73;78;151;SEC_234
1999;124;75 i +;32;22;54;SEC_124
1999;114;16-17;22;17;39;SEC_114
1999;520;12-15;16;19;35;SEC_520
1999;236;50-64;110;92;202;SEC_236
1999;503;12-15;28;19;47;SEC_503
1999;429;50-64;49;60;109;SEC_429
1999;318;18-24;47;51;98;SEC_318
1999;418;35-49;91;102;193;SEC_418
1999;527;00-02;12;19;31;SEC_527
1999;242;03-11;30;30;60;SEC_242
1999;611;16-17;13;13;26;SEC_611
1999;623;12-15;33;30;63;SEC_623
1999;248;50-64;86;83;169;SEC_248
1999;507;18-24;49;58;107;SEC_507
1999;442;65-74;29;25;54;SEC_442
1999;203;12-15;6;9;15;SEC_203
1999;509;12-15;13;11;24;SEC_509
1999;241;50-64;54;55;109;SEC_241
1999;429;12-15;8;12;20;SEC_429
1999;404;00-02;20;18;38;SEC_404
1999;218;35-49;72;75;147;SEC_218
1999;516;16-17;10;0;10;SEC_516
1999;606;75 i +;35;17;52;SEC_606
1999;439;12-15;7;18;25;SEC_439
1999;249;65-74;73;71;144;SEC_249
1999;504;12-15;15;16;31;SEC_504
1999;305;16-17;16;23;39;SEC_305
1999;408;18-24;35;49;84;SEC_408
1999;509;65-74;35;34;69;SEC_509
1999;220;03-11;17;20;37;SEC_220
1999;518;50-64;125;100;225;SEC_518
1999;424;75 i +;18;11;29;SEC_424
1999;321;18-24;168;146;314;SEC_321
1999;236;75 i +;58;38;96;SEC_236
1999;122;16-17;8;7;15;SEC_122
1999;533;25-34;82;84;166;SEC_533
1999;109;18-24;56;51;107;SEC_109
1999;621;18-24;149;172;321;SEC_621
1999;612;16-17;14;10;24;SEC_612
1999;215;16-17;8;8;16;SEC_215
1999;506;00-02;18;18;36;SEC_506
1999;611;00-02;11;15;26;SEC_611
1999;313;50-64;153;153;306;SEC_313
1999;117;16-17;31;41;72;SEC_117
1999;115;00-02;19;17;36;SEC_115
1999;105;65-74;49;38;87;SEC_105
1999;519;25-34;55;46;101;SEC_519
1999;515;50-64;52;54;106;SEC_515
1999;109;00-02;14;9;23;SEC_109
1999;519;18-24;14;28;42;SEC_519
1999;423;00-02;7;11;18;SEC_423
1999;429;35-49;70;66;136;SEC_429
1999;234;75 i +;80;32;112;SEC_234
1999;409;16-17;9;9;18;SEC_409
1999;534;65-74;56;50;106;SEC_534
1999;425;00-02;9;8;17;SEC_425
1999;320;16-17;6;6;12;SEC_320
1999;622;16-17;12;17;29;SEC_622
1999;438;50-64;101;99;200;SEC_438
1999;132;03-11;74;82;156;SEC_132
1999;312;12-15;23;22;45;SEC_312
1999;208;16-17;9;18;27;SEC_208
1999;111;16-17;9;6;15;SEC_111
1999;323;12-15;73;65;138;SEC_323
1999;121;75 i +;47;27;74;SEC_121
1999;237;12-15;14;13;27;SEC_237
1999;249;03-11;20;27;47;SEC_249
1999;233;00-02;5;11;16;SEC_233
1999;313;16-17;33;22;55;SEC_313
1999;110;18-24;89;96;185;SEC_110
1999;226;16-17;13;14;27;SEC_226
1999;118;00-02;16;25;41;SEC_118
1999;203;35-49;56;60;116;SEC_203
1999;406;50-64;142;123;265;SEC_406
1999;309;18-24;39;47;86;SEC_309
1999;517;65-74;70;58;128;SEC_517
1999;418;16-17;11;7;18;SEC_418
1999;209;00-02;10;7;17;SEC_209
1999;325;25-34;161;161;322;SEC_325
1999;630;03-11;26;30;56;SEC_630
1999;225;03-11;9;12;21;SEC_225
1999;107;65-74;90;71;161;SEC_107
1999;601;50-64;179;165;344;SEC_601
1999;241;16-17;3;4;7;SEC_241
1999;623;65-74;49;39;88;SEC_623
1999;603;75 i +;10;12;22;SEC_603
1999;123;75 i +;60;41;101;SEC_123
1999;113;12-15;46;39;85;SEC_113
1999;215;18-24;29;38;67;SEC_215
1999;608;18-24;55;74;129;SEC_608
1999;505;50-64;235;222;457;SEC_505
1999;531;03-11;24;27;51;SEC_531
1999;106;50-64;148;175;323;SEC_106
1999;426;25-34;69;72;141;SEC_426
1999;224;25-34;46;51;97;SEC_224
1999;624;35-49;105;73;178;SEC_624
1999;135;35-49;174;161;335;SEC_135
1999;513;25-34;61;62;123;SEC_513
1999;609;12-15;14;12;26;SEC_609
1999;401;16-17;15;17;32;SEC_401
1999;303;65-74;95;108;203;SEC_303
1999;321;75 i +;84;42;126;SEC_321
1999;509;50-64;79;86;165;SEC_509
1999;108;00-02;19;14;33;SEC_108
1999;119;50-64;161;169;330;SEC_119
1999;230;35-49;46;67;113;SEC_230
1999;441;00-02;10;14;24;SEC_441
1999;403;16-17;20;14;34;SEC_403
1999;139;35-49;94;92;186;SEC_139
1999;506;16-17;22;27;49;SEC_506
1999;133;35-49;95;81;176;SEC_133
1999;135;12-15;33;31;64;SEC_135
1999;323;65-74;65;39;104;SEC_323
1999;517;12-15;11;15;26;SEC_517
1999;130;12-15;7;7;14;SEC_130
1999;140;75 i +;46;26;72;SEC_140
1999;509;35-49;68;62;130;SEC_509
1999;325;00-02;18;15;33;SEC_325
1999;124;00-02;7;10;17;SEC_124
1999;430;00-02;8;6;14;SEC_430
1999;618;16-17;8;5;13;SEC_618
1999;248;16-17;9;12;21;SEC_248
1999;433;00-02;6;18;24;SEC_433
1999;242;00-02;10;6;16;SEC_242
1999;621;75 i +;29;15;44;SEC_621
1999;222;18-24;39;51;90;SEC_222
1999;320;18-24;29;41;70;SEC_320
1999;121;65-74;97;77;174;SEC_121
1999;442;12-15;9;9;18;SEC_442
1999;433;16-17;10;12;22;SEC_433
1999;513;50-64;91;79;170;SEC_513
1999;135;16-17;20;19;39;SEC_135
1999;620;25-34;59;61;120;SEC_620
1999;107;00-02;15;14;29;SEC_107
1999;304;35-49;99;107;206;SEC_304
1999;504;25-34;106;116;222;SEC_504
1999;501;18-24;113;137;250;SEC_501
1999;136;18-24;64;78;142;SEC_136
1999;620;18-24;65;45;110;SEC_620
1999;422;75 i +;63;41;104;SEC_422
1999;111;75 i +;42;25;67;SEC_111
1999;308;03-11;41;43;84;SEC_308
1999;507;65-74;39;37;76;SEC_507
1999;221;65-74;67;70;137;SEC_221
1999;127;12-15;22;21;43;SEC_127
1999;513;65-74;46;46;92;SEC_513
1999;537;16-17;15;15;30;SEC_537
1999;247;12-15;16;19;35;SEC_247
1999;620;35-49;63;57;120;SEC_620
1999;201;75 i +;39;15;54;SEC_201
1999;114;75 i +;60;22;82;SEC_114
1999;226;03-11;24;29;53;SEC_226
1999;134;75 i +;70;30;100;SEC_134
1999;209;50-64;90;72;162;SEC_209
1999;322;12-15;22;15;37;SEC_322
1999;432;35-49;137;121;258;SEC_432
1999;317;03-11;27;31;58;SEC_317
1999;439;35-49;68;67;135;SEC_439
1999;426;65-74;61;47;108;SEC_426
1999;515;35-49;61;45;106;SEC_515
1999;104;25-34;67;86;153;SEC_104
1999;140;65-74;62;58;120;SEC_140
1999;617;50-64;126;95;221;SEC_617
1999;105;75 i +;45;24;69;SEC_105
1999;533;35-49;67;71;138;SEC_533
1999;303;00-02;16;21;37;SEC_303
1999;105;18-24;89;71;160;SEC_105
1999;428;16-17;4;4;8;SEC_428
1999;225;18-24;15;30;45;SEC_225
1999;319;50-64;65;75;140;SEC_319
1999;126;50-64;150;166;316;SEC_126
1999;631;50-64;166;175;341;SEC_631
1999;214;35-49;46;51;97;SEC_214
1999;412;65-74;91;91;182;SEC_412
1999;416;18-24;29;34;63;SEC_416
1999;529;12-15;13;12;25;SEC_529
1999;515;18-24;30;22;52;SEC_515
1999;425;50-64;91;86;177;SEC_425
1999;538;00-02;12;7;19;SEC_538
1999;220;50-64;76;59;135;SEC_220
1999;428;65-74;46;34;80;SEC_428
1999;422;00-02;11;10;21;SEC_422
1999;526;12-15;8;10;18;SEC_526
1999;207;18-24;29;28;57;SEC_207
1999;413;18-24;24;24;48;SEC_413
1999;113;65-74;50;33;83;SEC_113
1999;523;35-49;104;115;219;SEC_523
1999;206;12-15;12;16;28;SEC_206
1999;221;03-11;43;50;93;SEC_221
1999;202;16-17;3;7;10;SEC_202
1999;613;18-24;78;81;159;SEC_613
1999;111;35-49;99;89;188;SEC_111
1999;509;75 i +;40;14;54;SEC_509
1999;629;03-11;20;18;38;SEC_629
1999;201;35-49;51;51;102;SEC_201
1999;321;00-02;37;24;61;SEC_321
1999;322;35-49;107;112;219;SEC_322
1999;242;18-24;38;36;74;SEC_242
1999;529;35-49;82;85;167;SEC_529
1999;507;35-49;82;79;161;SEC_507
1999;424;35-49;46;46;92;SEC_424
1999;102;00-02;17;19;36;SEC_102
1999;521;35-49;115;77;192;SEC_521
1999;230;25-34;81;75;156;SEC_230
1999;239;75 i +;58;46;104;SEC_239
1999;202;03-11;13;21;34;SEC_202
1999;116;35-49;162;139;301;SEC_116
1999;247;50-64;101;95;196;SEC_247
1999;217;25-34;42;60;102;SEC_217
1999;504;65-74;70;67;137;SEC_504
1999;213;12-15;17;18;35;SEC_213
1999;139;75 i +;23;10;33;SEC_139
1999;113;16-17;25;28;53;SEC_113
1999;302;35-49;161;125;286;SEC_302
1999;221;35-49;100;101;201;SEC_221
1999;625;35-49;206;174;380;SEC_625
1999;614;03-11;27;42;69;SEC_614
1999;313;75 i +;60;27;87;SEC_313
1999;422;50-64;78;82;160;SEC_422
1999;501;03-11;32;40;72;SEC_501
1999;249;50-64;107;84;191;SEC_249
1999;124;65-74;49;36;85;SEC_124
1999;427;16-17;11;9;20;SEC_427
1999;120;25-34;123;116;239;SEC_120
1999;421;03-11;30;30;60;SEC_421
1999;139;16-17;10;14;24;SEC_139
1999;437;18-24;42;37;79;SEC_437
1999;227;65-74;54;42;96;SEC_227
1999;244;12-15;7;4;11;SEC_244
1999;433;12-15;18;14;32;SEC_433
1999;618;65-74;29;17;46;SEC_618
1999;518;00-02;11;7;18;SEC_518
1999;235;12-15;15;10;25;SEC_235
1999;532;35-49;105;95;200;SEC_532
1999;202;00-02;1;6;7;SEC_202
1999;529;75 i +;64;38;102;SEC_529
1999;510;18-24;55;49;104;SEC_510
1999;420;16-17;9;11;20;SEC_420
1999;514;18-24;33;34;67;SEC_514
1999;322;16-17;20;8;28;SEC_322
1999;537;12-15;18;26;44;SEC_537
1999;418;12-15;19;26;45;SEC_418
1999;305;35-49;207;186;393;SEC_305
1999;320;75 i +;19;9;28;SEC_320
1999;612;65-74;56;57;113;SEC_612
1999;420;50-64;122;108;230;SEC_420
1999;611;03-11;65;59;124;SEC_611
1999;325;12-15;24;26;50;SEC_325
1999;136;65-74;54;55;109;SEC_136
1999;409;65-74;37;40;77;SEC_409
1999;618;35-49;61;50;111;SEC_618
1999;131;75 i +;39;22;61;SEC_131
1999;138;35-49;111;101;212;SEC_138
1999;225;25-34;29;31;60;SEC_225
1999;133;12-15;15;20;35;SEC_133
1999;116;03-11;52;52;104;SEC_116
1999;105;00-02;5;16;21;SEC_105
1999;407;25-34;76;99;175;SEC_407
1999;503;75 i +;23;10;33;SEC_503
1999;507;00-02;8;9;17;SEC_507
1999;306;03-11;58;48;106;SEC_306
1999;206;18-24;35;39;74;SEC_206
1999;437;03-11;25;32;57;SEC_437
1999;305;03-11;67;44;111;SEC_305
1999;622;25-34;84;98;182;SEC_622
1999;120;12-15;42;43;85;SEC_120
1999;607;25-34;101;113;214;SEC_607
1999;222;25-34;62;67;129;SEC_222
1999;229;18-24;31;25;56;SEC_229
1999;440;03-11;22;33;55;SEC_440
1999;505;03-11;37;26;63;SEC_505
1999;223;65-74;76;71;147;SEC_223
1999;216;00-02;11;3;14;SEC_216
1999;246;50-64;86;69;155;SEC_246
1999;530;12-15;16;19;35;SEC_530
1999;120;16-17;18;20;38;SEC_120
1999;402;12-15;10;15;25;SEC_402
1999;621;03-11;62;60;122;SEC_621
1999;318;00-02;9;10;19;SEC_318
1999;415;50-64;54;55;109;SEC_415
1999;221;25-34;103;85;188;SEC_221
1999;133;00-02;5;10;15;SEC_133
1999;219;16-17;3;18;21;SEC_219
1999;219;00-02;14;8;22;SEC_219
1999;133;75 i +;47;29;76;SEC_133
1999;314;50-64;152;166;318;SEC_314
1999;609;35-49;65;45;110;SEC_609
1999;427;00-02;6;9;15;SEC_427
1999;528;50-64;129;115;244;SEC_528
1999;216;65-74;82;63;145;SEC_216
1999;120;75 i +;43;21;64;SEC_120
1999;614;00-02;9;12;21;SEC_614
1999;424;03-11;9;11;20;SEC_424
1999;111;65-74;40;43;83;SEC_111
1999;623;00-02;15;17;32;SEC_623
1999;228;35-49;39;48;87;SEC_228
1999;422;35-49;86;96;182;SEC_422
1999;103;00-02;11;8;19;SEC_103
1999;108;03-11;43;49;92;SEC_108
1999;128;35-49;94;94;188;SEC_128
1999;123;18-24;66;66;132;SEC_123
1999;516;00-02;12;8;20;SEC_516
1999;511;03-11;14;23;37;SEC_511
1999;217;12-15;11;11;22;SEC_217
1999;431;25-34;101;101;202;SEC_431
1999;536;50-64;109;94;203;SEC_536
1999;115;50-64;118;126;244;SEC_115
1999;231;16-17;7;11;18;SEC_231
1999;527;50-64;82;83;165;SEC_527
1999;121;25-34;85;82;167;SEC_121
1999;228;12-15;7;6;13;SEC_228
1999;238;18-24;24;35;59;SEC_238
1999;232;25-34;77;73;150;SEC_232
1999;410;00-02;16;17;33;SEC_410
1999;519;00-02;11;15;26;SEC_519
1999;245;25-34;77;89;166;SEC_245
1999;435;50-64;81;63;144;SEC_435
1999;121;00-02;10;13;23;SEC_121
1999;411;50-64;116;109;225;SEC_411
1999;237;50-64;133;117;250;SEC_237
1999;232;65-74;81;60;141;SEC_232
1999;515;00-02;4;5;9;SEC_515
1999;216;03-11;28;38;66;SEC_216
1999;532;00-02;16;15;31;SEC_532
1999;516;18-24;21;32;53;SEC_516
1999;110;35-49;147;128;275;SEC_110
1999;214;00-02;4;3;7;SEC_214
1999;602;16-17;9;6;15;SEC_602
1999;211;35-49;104;107;211;SEC_211
1999;436;03-11;25;31;56;SEC_436
1999;208;50-64;199;164;363;SEC_208
1999;104;12-15;6;8;14;SEC_104
1999;438;03-11;23;26;49;SEC_438
1999;428;50-64;41;34;75;SEC_428
1999;513;35-49;50;61;111;SEC_513
1999;429;03-11;10;29;39;SEC_429
1999;219;12-15;22;16;38;SEC_219
1999;413;50-64;51;51;102;SEC_413
1999;215;50-64;85;61;146;SEC_215
1999;419;16-17;9;6;15;SEC_419
1999;609;18-24;71;62;133;SEC_609
1999;424;18-24;31;48;79;SEC_424
1999;533;16-17;6;7;13;SEC_533
1999;508;50-64;55;45;100;SEC_508
1999;520;65-74;50;59;109;SEC_520
1999;133;18-24;54;51;105;SEC_133
1999;124;35-49;107;88;195;SEC_124
1999;121;12-15;10;7;17;SEC_121
1999;205;25-34;64;66;130;SEC_205
1999;122;25-34;80;81;161;SEC_122
1999;630;25-34;62;72;134;SEC_630
1999;245;18-24;40;50;90;SEC_245
1999;503;03-11;35;44;79;SEC_503
1999;221;18-24;53;58;111;SEC_221
1999;617;03-11;37;47;84;SEC_617
1999;614;18-24;57;66;123;SEC_614
1999;404;18-24;60;57;117;SEC_404
1999;135;03-11;60;46;106;SEC_135
1999;319;75 i +;25;14;39;SEC_319
1999;616;12-15;74;79;153;SEC_616
1999;136;35-49;127;119;246;SEC_136
1999;110;03-11;35;45;80;SEC_110
1999;218;75 i +;43;17;60;SEC_218
1999;240;65-74;62;43;105;SEC_240
1999;140;25-34;73;96;169;SEC_140
1999;417;35-49;59;57;116;SEC_417
1999;519;65-74;43;41;84;SEC_519
1999;405;35-49;53;64;117;SEC_405
1999;216;35-49;123;116;239;SEC_216
1999;532;03-11;41;28;69;SEC_532
1999;217;00-02;3;10;13;SEC_217
1999;506;03-11;79;89;168;SEC_506
1999;223;16-17;5;9;14;SEC_223
1999;422;18-24;36;46;82;SEC_422
1999;501;65-74;18;24;42;SEC_501
1999;301;35-49;164;181;345;SEC_301
1999;223;35-49;87;92;179;SEC_223
1999;246;12-15;14;13;27;SEC_246
1999;530;50-64;122;98;220;SEC_530
1999;126;35-49;76;64;140;SEC_126
1999;205;12-15;17;17;34;SEC_205
1999;632;03-11;43;46;89;SEC_632
1999;432;12-15;22;22;44;SEC_432
1999;626;25-34;88;134;222;SEC_626
1999;420;18-24;52;66;118;SEC_420
1999;534;16-17;6;9;15;SEC_534
1999;243;75 i +;87;47;134;SEC_243
1999;418;50-64;124;108;232;SEC_418
1999;431;12-15;20;25;45;SEC_431
1999;630;12-15;20;15;35;SEC_630
1999;130;03-11;32;32;64;SEC_130
1999;616;03-11;129;140;269;SEC_616
1999;507;16-17;3;5;8;SEC_507
1999;430;18-24;42;36;78;SEC_430
1999;117;03-11;65;60;125;SEC_117
1999;241;18-24;38;22;60;SEC_241
1999;521;18-24;98;103;201;SEC_521
1999;503;65-74;27;19;46;SEC_503
1999;316;35-49;424;348;772;SEC_316
1999;607;65-74;69;58;127;SEC_607
1999;137;50-64;134;133;267;SEC_137
1999;244;18-24;25;16;41;SEC_244
1999;114;00-02;23;18;41;SEC_114
1999;116;16-17;28;15;43;SEC_116
1999;432;18-24;78;94;172;SEC_432
1999;225;00-02;1;3;4;SEC_225
1999;630;75 i +;25;13;38;SEC_630
1999;244;35-49;58;71;129;SEC_244
1999;601;00-02;10;12;22;SEC_601
1999;303;18-24;91;85;176;SEC_303
1999;501;25-34;98;107;205;SEC_501
1999;404;25-34;108;124;232;SEC_404
1999;621;25-34;141;145;286;SEC_621
1999;439;65-74;59;59;118;SEC_439
1999;313;25-34;142;138;280;SEC_313
1999;201;12-15;10;18;28;SEC_201
1999;620;00-02;2;6;8;SEC_620
1999;107;35-49;161;156;317;SEC_107
1999;321;65-74;79;78;157;SEC_321
1999;243;50-64;132;107;239;SEC_243
1999;238;35-49;63;80;143;SEC_238
1999;522;16-17;9;5;14;SEC_522
1999;217;16-17;8;6;14;SEC_217
1999;104;50-64;70;65;135;SEC_104
1999;139;65-74;34;22;56;SEC_139
1999;612;12-15;16;21;37;SEC_612
1999;521;16-17;15;11;26;SEC_521
1999;101;25-34;103;108;211;SEC_101
1999;301;65-74;107;96;203;SEC_301
1999;310;18-24;53;61;114;SEC_310
1999;533;03-11;33;26;59;SEC_533
1999;220;18-24;37;24;61;SEC_220
1999;535;03-11;32;35;67;SEC_535
1999;102;65-74;95;67;162;SEC_102
1999;241;12-15;15;9;24;SEC_241
1999;217;35-49;60;70;130;SEC_217
1999;227;35-49;59;51;110;SEC_227
1999;501;35-49;138;103;241;SEC_501
1999;423;03-11;30;22;52;SEC_423
1999;435;25-34;63;72;135;SEC_435
1999;316;18-24;162;181;343;SEC_316
1999;140;00-02;9;7;16;SEC_140
1999;115;03-11;41;57;98;SEC_115
1999;231;00-02;9;4;13;SEC_231
1999;618;00-02;3;6;9;SEC_618
1999;136;00-02;14;16;30;SEC_136
1999;403;65-74;71;57;128;SEC_403
1999;431;65-74;85;75;160;SEC_431
1999;202;75 i +;34;16;50;SEC_202
1999;120;65-74;56;46;102;SEC_120
1999;301;00-02;26;17;43;SEC_301
1999;225;75 i +;43;38;81;SEC_225
1999;514;75 i +;34;16;50;SEC_514
1999;227;12-15;7;7;14;SEC_227
1999;249;18-24;41;50;91;SEC_249
1999;532;16-17;7;13;20;SEC_532
1999;319;25-34;52;54;106;SEC_319
1999;324;65-74;62;40;102;SEC_324
1999;426;18-24;41;58;99;SEC_426
1999;417;65-74;39;37;76;SEC_417
1999;214;12-15;8;9;17;SEC_214
1999;632;65-74;42;40;82;SEC_632
1999;617;75 i +;22;21;43;SEC_617
1999;134;03-11;34;45;79;SEC_134
1999;608;65-74;55;46;101;SEC_608
1999;212;16-17;11;8;19;SEC_212
1999;130;16-17;5;7;12;SEC_130
1999;132;50-64;190;220;410;SEC_132
1999;630;18-24;81;94;175;SEC_630
1999;241;35-49;63;65;128;SEC_241
1999;416;03-11;20;24;44;SEC_416
1999;628;65-74;45;43;88;SEC_628
1999;609;65-74;32;38;70;SEC_609
1999;248;35-49;107;113;220;SEC_248
1999;114;50-64;212;189;401;SEC_114
1999;632;16-17;14;19;33;SEC_632
1999;622;35-49;106;98;204;SEC_622
1999;623;03-11;49;47;96;SEC_623
1999;220;75 i +;39;23;62;SEC_220
1999;233;25-34;59;56;115;SEC_233
1999;239;25-34;90;98;188;SEC_239
1999;122;12-15;10;10;20;SEC_122
1999;411;03-11;35;21;56;SEC_411
1999;615;12-15;12;10;22;SEC_615
1999;109;16-17;14;21;35;SEC_109
1999;314;35-49;319;321;640;SEC_314
1999;302;75 i +;48;17;65;SEC_302
1999;435;65-74;95;60;155;SEC_435
1999;244;00-02;4;4;8;SEC_244
1999;610;35-49;88;79;167;SEC_610
1999;526;18-24;28;38;66;SEC_526
1999;105;12-15;20;26;46;SEC_105
1999;524;00-02;19;21;40;SEC_524
1999;531;12-15;10;17;27;SEC_531
1999;525;75 i +;33;27;60;SEC_525
1999;616;16-17;43;21;64;SEC_616
1999;606;12-15;16;18;34;SEC_606
1999;247;00-02;12;9;21;SEC_247
1999;613;03-11;34;38;72;SEC_613
1999;131;00-02;15;10;25;SEC_131
1999;607;50-64;149;136;285;SEC_607
1999;120;18-24;83;93;176;SEC_120
1999;104;16-17;5;3;8;SEC_104
1999;118;75 i +;35;20;55;SEC_118
1999;209;35-49;79;92;171;SEC_209
1999;230;16-17;1;3;4;SEC_230
1999;121;18-24;25;28;53;SEC_121
1999;536;03-11;27;24;51;SEC_536
1999;403;35-49;108;95;203;SEC_403
1999;504;03-11;18;27;45;SEC_504
1999;537;50-64;146;131;277;SEC_537
1999;530;03-11;47;43;90;SEC_530
1999;210;50-64;93;80;173;SEC_210
1999;136;16-17;15;16;31;SEC_136
1999;518;18-24;57;47;104;SEC_518
1999;428;03-11;16;14;30;SEC_428
1999;303;03-11;32;41;73;SEC_303
1999;233;18-24;33;32;65;SEC_233
1999;433;65-74;50;42;92;SEC_433
1999;312;00-02;16;14;30;SEC_312
1999;236;18-24;41;37;78;SEC_236
1999;222;00-02;4;5;9;SEC_222
1999;431;35-49;109;116;225;SEC_431
1999;536;65-74;78;63;141;SEC_536
1999;228;00-02;3;5;8;SEC_228
1999;206;75 i +;72;35;107;SEC_206
1999;236;25-34;70;73;143;SEC_236
1999;116;18-24;114;118;232;SEC_116
1999;310;16-17;10;9;19;SEC_310
1999;415;25-34;65;61;126;SEC_415
1999;510;16-17;6;10;16;SEC_510
1999;425;65-74;76;66;142;SEC_425
1999;211;50-64;93;77;170;SEC_211
1999;519;35-49;37;47;84;SEC_519
1999;110;50-64;159;153;312;SEC_110
1999;303;50-64;223;190;413;SEC_303
1999;129;25-34;113;119;232;SEC_129
1999;318;50-64;63;70;133;SEC_318
1999;531;25-34;80;82;162;SEC_531
1999;138;65-74;32;34;66;SEC_138
1999;501;12-15;21;21;42;SEC_501
1999;101;50-64;97;88;185;SEC_101
1999;420;12-15;15;23;38;SEC_420
1999;601;25-34;84;134;218;SEC_601
1999;514;12-15;18;9;27;SEC_514
1999;305;00-02;14;17;31;SEC_305
1999;619;50-64;172;161;333;SEC_619
1999;112;50-64;146;143;289;SEC_112
1999;436;50-64;68;60;128;SEC_436
1999;427;25-34;63;74;137;SEC_427
1999;435;18-24;43;48;91;SEC_435
1999;625;65-74;31;37;68;SEC_625
1999;411;75 i +;48;29;77;SEC_411
1999;404;12-15;22;19;41;SEC_404
1999;247;35-49;106;113;219;SEC_247
1999;617;16-17;13;15;28;SEC_617
1999;434;25-34;33;34;67;SEC_434
1999;319;35-49;108;89;197;SEC_319
1999;418;75 i +;61;41;102;SEC_418
1999;629;16-17;8;10;18;SEC_629
1999;129;12-15;23;21;44;SEC_129
1999;102;03-11;47;61;108;SEC_102
1999;203;25-34;59;56;115;SEC_203
1999;134;18-24;51;77;128;SEC_134
1999;119;65-74;69;58;127;SEC_119
1999;321;50-64;216;233;449;SEC_321
1999;424;12-15;14;9;23;SEC_424
1999;115;25-34;95;119;214;SEC_115
1999;234;65-74;91;52;143;SEC_234
1999;107;25-34;156;198;354;SEC_107
1999;513;12-15;8;12;20;SEC_513
1999;523;16-17;21;19;40;SEC_523
1999;120;50-64;121;135;256;SEC_120
1999;113;35-49;206;169;375;SEC_113
1999;615;75 i +;23;14;37;SEC_615
1999;315;16-17;20;19;39;SEC_315
1999;313;35-49;233;216;449;SEC_313
1999;301;03-11;72;83;155;SEC_301
1999;433;25-34;96;92;188;SEC_433
1999;309;75 i +;22;10;32;SEC_309
1999;538;35-49;98;83;181;SEC_538
1999;535;75 i +;37;25;62;SEC_535
1999;122;75 i +;39;27;66;SEC_122
1999;240;35-49;53;58;111;SEC_240
1999;409;03-11;14;21;35;SEC_409
1999;403;50-64;156;140;296;SEC_403
1999;514;65-74;48;39;87;SEC_514
1999;410;03-11;38;55;93;SEC_410
1999;317;00-02;13;13;26;SEC_317
1999;315;12-15;30;29;59;SEC_315
1999;427;18-24;50;44;94;SEC_427
1999;127;16-17;11;5;16;SEC_127
1999;307;35-49;206;171;377;SEC_307
1999;440;16-17;7;6;13;SEC_440
1999;521;50-64;154;195;349;SEC_521
1999;210;75 i +;60;38;98;SEC_210
1999;102;18-24;96;115;211;SEC_102
1999;134;00-02;15;19;34;SEC_134
1999;225;35-49;43;39;82;SEC_225
1999;536;35-49;65;68;133;SEC_536
1999;419;50-64;74;74;148;SEC_419
1999;602;65-74;21;30;51;SEC_602
1999;611;50-64;234;205;439;SEC_611
1999;404;75 i +;54;33;87;SEC_404
1999;419;75 i +;42;19;61;SEC_419
1999;509;16-17;8;6;14;SEC_509
1999;325;18-24;102;113;215;SEC_325
1999;624;25-34;106;127;233;SEC_624
1999;236;03-11;32;23;55;SEC_236
1999;121;35-49;63;77;140;SEC_121
1999;524;35-49;90;101;191;SEC_524
1999;519;16-17;7;5;12;SEC_519
1999;134;65-74;47;36;83;SEC_134
1999;129;75 i +;41;21;62;SEC_129
1999;212;18-24;68;69;137;SEC_212
1999;116;50-64;179;186;365;SEC_116
1999;606;25-34;104;98;202;SEC_606
1999;416;50-64;81;63;144;SEC_416
1999;602;35-49;41;35;76;SEC_602
1999;522;65-74;38;38;76;SEC_522
1999;602;00-02;4;8;12;SEC_602
1999;312;03-11;49;34;83;SEC_312
1999;106;25-34;149;145;294;SEC_106
1999;611;18-24;86;84;170;SEC_611
1999;436;35-49;64;87;151;SEC_436
1999;125;16-17;8;17;25;SEC_125
1999;503;16-17;15;19;34;SEC_503
1999;626;12-15;20;22;42;SEC_626
1999;528;65-74;61;55;116;SEC_528
1999;401;35-49;116;113;229;SEC_401
1999;631;03-11;41;23;64;SEC_631
1999;510;65-74;65;53;118;SEC_510
1999;530;25-34;115;124;239;SEC_530
1999;533;50-64;85;75;160;SEC_533
1999;609;03-11;20;35;55;SEC_609
1999;602;75 i +;25;14;39;SEC_602
1999;304;12-15;11;18;29;SEC_304
1999;302;00-02;12;13;25;SEC_302
1999;238;12-15;13;13;26;SEC_238
1999;437;25-34;59;88;147;SEC_437
1999;207;00-02;7;4;11;SEC_207
1999;231;12-15;15;7;22;SEC_231
1999;238;50-64;69;62;131;SEC_238
1999;105;50-64;77;99;176;SEC_105
1999;214;03-11;18;16;34;SEC_214
1999;229;00-02;12;9;21;SEC_229
1999;408;75 i +;35;16;51;SEC_408
1999;249;16-17;6;10;16;SEC_249
1999;632;50-64;105;96;201;SEC_632
1999;321;03-11;86;103;189;SEC_321
1999;618;50-64;71;78;149;SEC_618
1999;617;18-24;55;86;141;SEC_617
1999;105;16-17;11;19;30;SEC_105
1999;302;65-74;55;48;103;SEC_302
1999;606;16-17;16;12;28;SEC_606
1999;514;16-17;2;11;13;SEC_514
1999;104;03-11;24;18;42;SEC_104
1999;610;25-34;126;140;266;SEC_610
1999;424;65-74;31;39;70;SEC_424
1999;308;65-74;70;58;128;SEC_308
1999;441;18-24;122;124;246;SEC_441
1999;607;18-24;46;52;98;SEC_607
1999;123;12-15;25;20;45;SEC_123
1999;406;12-15;22;26;48;SEC_406
1999;423;65-74;66;46;112;SEC_423
1999;522;35-49;72;64;136;SEC_522
1999;418;03-11;29;31;60;SEC_418
1999;247;16-17;6;7;13;SEC_247
1999;242;50-64;106;109;215;SEC_242
1999;525;03-11;29;31;60;SEC_525
1999;404;50-64;126;112;238;SEC_404
1999;237;75 i +;65;37;102;SEC_237
1999;224;50-64;41;39;80;SEC_224
1999;613;50-64;210;198;408;SEC_613
1999;524;16-17;9;11;20;SEC_524
1999;535;12-15;30;30;60;SEC_535
1999;403;25-34;69;97;166;SEC_403
1999;623;35-49;157;137;294;SEC_623
1999;125;75 i +;30;23;53;SEC_125
1999;533;00-02;9;3;12;SEC_533
1999;223;03-11;44;41;85;SEC_223
1999;615;50-64;170;149;319;SEC_615
1999;518;03-11;35;29;64;SEC_518
1999;214;50-64;65;55;120;SEC_214
1999;243;18-24;48;50;98;SEC_243
1999;511;18-24;30;30;60;SEC_511
1999;615;03-11;7;17;24;SEC_615
1999;607;35-49;83;94;177;SEC_607
1999;103;35-49;88;71;159;SEC_103
1999;110;25-34;95;100;195;SEC_110
1999;502;50-64;154;161;315;SEC_502
1999;222;50-64;75;73;148;SEC_222
1999;204;75 i +;29;16;45;SEC_204
1999;601;75 i +;60;25;85;SEC_601
1999;603;35-49;50;51;101;SEC_603
1999;440;35-49;68;84;152;SEC_440
1999;217;65-74;45;36;81;SEC_217
1999;229;65-74;52;48;100;SEC_229
1999;132;00-02;23;23;46;SEC_132
1999;432;03-11;27;42;69;SEC_432
1999;615;65-74;33;36;69;SEC_615
1999;310;12-15;31;21;52;SEC_310
1999;516;65-74;43;28;71;SEC_516
1999;418;65-74;68;45;113;SEC_418
1999;623;75 i +;46;31;77;SEC_623
1999;417;75 i +;24;13;37;SEC_417
1999;427;65-74;70;58;128;SEC_427
1999;112;35-49;175;160;335;SEC_112
1999;102;25-34;155;167;322;SEC_102
1999;135;25-34;111;118;229;SEC_135
1999;428;12-15;11;5;16;SEC_428
1999;626;50-64;133;101;234;SEC_626
1999;201;00-02;4;7;11;SEC_201
1999;126;75 i +;43;19;62;SEC_126
1999;138;25-34;58;67;125;SEC_138
1999;502;18-24;104;101;205;SEC_502
1999;245;75 i +;70;33;103;SEC_245
1999;534;18-24;52;58;110;SEC_534
1999;538;16-17;11;12;23;SEC_538
1999;122;18-24;43;36;79;SEC_122
1999;202;12-15;11;13;24;SEC_202
1999;525;00-02;13;8;21;SEC_525
1999;205;65-74;61;49;110;SEC_205
1999;111;18-24;47;72;119;SEC_111
1999;131;50-64;147;165;312;SEC_131
1999;219;25-34;87;90;177;SEC_219
1999;408;16-17;7;16;23;SEC_408
1999;230;03-11;18;29;47;SEC_230
1999;604;00-02;9;6;15;SEC_604
1999;536;18-24;38;46;84;SEC_536
1999;109;12-15;24;18;42;SEC_109
1999;405;12-15;12;10;22;SEC_405
1999;232;18-24;49;43;92;SEC_232
1999;109;03-11;39;42;81;SEC_109
1999;422;16-17;18;6;24;SEC_422
1999;604;35-49;56;71;127;SEC_604
1999;116;65-74;62;55;117;SEC_116
1999;237;18-24;60;56;116;SEC_237
1999;632;12-15;18;26;44;SEC_632
1999;243;12-15;21;16;37;SEC_243
1999;623;25-34;149;169;318;SEC_623
1999;442;03-11;21;18;39;SEC_442
1999;512;25-34;65;80;145;SEC_512
1999;617;00-02;10;10;20;SEC_617
1999;136;12-15;23;18;41;SEC_136
1999;110;00-02;4;6;10;SEC_110
1999;441;75 i +;66;51;117;SEC_441
1999;243;03-11;46;54;100;SEC_243
1999;523;12-15;18;20;38;SEC_523
1999;521;03-11;23;31;54;SEC_521
1999;531;18-24;35;48;83;SEC_531
1999;625;25-34;89;106;195;SEC_625
1999;625;18-24;110;126;236;SEC_625
1999;122;00-02;14;11;25;SEC_122
1999;440;18-24;81;73;154;SEC_440
1999;312;65-74;60;49;109;SEC_312
1999;117;65-74;70;46;116;SEC_117
1999;405;18-24;50;41;91;SEC_405
1999;126;00-02;11;8;19;SEC_126
1999;249;12-15;12;14;26;SEC_249
1999;201;16-17;6;2;8;SEC_201
1999;428;00-02;7;2;9;SEC_428
1999;244;03-11;18;17;35;SEC_244
1999;618;18-24;39;42;81;SEC_618
1999;220;00-02;7;7;14;SEC_220
1999;138;00-02;8;8;16;SEC_138
1999;118;18-24;154;166;320;SEC_118
1999;244;16-17;2;4;6;SEC_244
1999;123;50-64;108;103;211;SEC_123
1999;229;03-11;21;18;39;SEC_229
1999;228;50-64;71;62;133;SEC_228
1999;108;50-64;107;106;213;SEC_108
1999;108;35-49;133;121;254;SEC_108
1999;439;00-02;7;11;18;SEC_439
1999;602;12-15;6;10;16;SEC_602
1999;213;35-49;93;93;186;SEC_213
1999;421;75 i +;48;31;79;SEC_421
1999;248;25-34;95;92;187;SEC_248
1999;201;65-74;48;48;96;SEC_201
1999;127;03-11;40;34;74;SEC_127
1999;611;75 i +;48;31;79;SEC_611
1999;621;12-15;24;37;61;SEC_621
1999;503;00-02;11;12;23;SEC_503
1999;227;25-34;65;54;119;SEC_227
1999;113;18-24;100;86;186;SEC_113
1999;224;65-74;46;35;81;SEC_224
1999;127;35-49;95;97;192;SEC_127
1999;105;03-11;45;65;110;SEC_105
1999;508;75 i +;27;22;49;SEC_508
1999;218;25-34;49;58;107;SEC_218
1999;631;18-24;79;99;178;SEC_631
1999;238;75 i +;60;29;89;SEC_238
1999;527;65-74;69;44;113;SEC_527
1999;419;03-11;33;36;69;SEC_419
1999;315;25-34;131;121;252;SEC_315
1999;616;35-49;264;275;539;SEC_616
1999;127;50-64;52;52;104;SEC_127
1999;416;25-34;58;64;122;SEC_416
1999;619;16-17;23;17;40;SEC_619
1999;619;65-74;66;64;130;SEC_619
1999;312;18-24;69;70;139;SEC_312
1999;428;75 i +;29;20;49;SEC_428
1999;421;25-34;128;116;244;SEC_421
1999;409;25-34;56;61;117;SEC_409
1999;606;65-74;71;63;134;SEC_606
1999;128;16-17;14;13;27;SEC_128
1999;415;03-11;22;22;44;SEC_415
1999;631;00-02;6;15;21;SEC_631
1999;412;12-15;36;38;74;SEC_412
1999;618;75 i +;17;14;31;SEC_618
1999;131;65-74;57;50;107;SEC_131
1999;409;00-02;10;5;15;SEC_409
1999;404;65-74;86;66;152;SEC_404
1999;627;65-74;27;27;54;SEC_627
1999;526;50-64;63;65;128;SEC_526
1999;537;18-24;73;74;147;SEC_537
1999;625;16-17;30;28;58;SEC_625
1999;325;16-17;24;15;39;SEC_325
1999;119;12-15;33;29;62;SEC_119
1999;503;18-24;66;75;141;SEC_503
1999;245;50-64;80;72;152;SEC_245
1999;504;16-17;11;3;14;SEC_504
1999;402;35-49;60;67;127;SEC_402
1999;632;75 i +;28;14;42;SEC_632
1999;216;16-17;11;14;25;SEC_216
1999;202;65-74;45;45;90;SEC_202
1999;625;03-11;47;50;97;SEC_625
1999;139;03-11;26;37;63;SEC_139
1999;239;03-11;20;30;50;SEC_239
1999;248;03-11;36;39;75;SEC_248
1999;515;65-74;30;23;53;SEC_515
1999;229;35-49;55;52;107;SEC_229
1999;239;12-15;10;22;32;SEC_239
1999;442;75 i +;31;16;47;SEC_442
1999;516;12-15;8;2;10;SEC_516
1999;408;25-34;75;84;159;SEC_408
1999;615;18-24;64;65;129;SEC_615
1999;135;00-02;17;19;36;SEC_135
1999;316;03-11;100;110;210;SEC_316
1999;429;65-74;50;32;82;SEC_429
1999;311;12-15;12;13;25;SEC_311
1999;244;25-34;58;52;110;SEC_244
1999;429;00-02;0;4;4;SEC_429
1999;603;03-11;23;26;49;SEC_603
1999;535;25-34;65;100;165;SEC_535
1999;413;75 i +;37;15;52;SEC_413
1999;244;65-74;48;32;80;SEC_244
1999;401;12-15;20;33;53;SEC_401
1999;431;16-17;16;17;33;SEC_431
1999;302;25-34;125;129;254;SEC_302
1999;209;03-11;17;36;53;SEC_209
1999;632;00-02;14;16;30;SEC_632
1999;516;50-64;63;56;119;SEC_516
1999;515;16-17;3;2;5;SEC_515
1999;516;35-49;46;59;105;SEC_516
1999;509;00-02;7;11;18;SEC_509
1999;423;18-24;46;44;90;SEC_423
1999;521;65-74;42;41;83;SEC_521
1999;136;03-11;43;38;81;SEC_136
1999;502;75 i +;68;37;105;SEC_502
1999;102;16-17;15;7;22;SEC_102
1999;528;18-24;49;67;116;SEC_528
1999;117;25-34;163;159;322;SEC_117
1999;434;12-15;14;8;22;SEC_434
1999;118;03-11;79;63;142;SEC_118
1999;119;18-24;111;119;230;SEC_119
1999;139;00-02;9;14;23;SEC_139
1999;511;75 i +;33;13;46;SEC_511
1999;315;03-11;52;60;112;SEC_315
1999;227;03-11;15;13;28;SEC_227
1999;511;35-49;44;47;91;SEC_511
1999;427;75 i +;43;33;76;SEC_427
1999;619;03-11;38;45;83;SEC_619
1999;529;18-24;51;42;93;SEC_529
1999;113;75 i +;42;24;66;SEC_113
1999;523;00-02;9;9;18;SEC_523
1999;205;50-64;83;74;157;SEC_205
1999;612;25-34;100;123;223;SEC_612
1999;535;16-17;17;21;38;SEC_535
1999;522;50-64;64;56;120;SEC_522
1999;131;25-34;120;132;252;SEC_131
1999;308;35-49;151;148;299;SEC_308
1999;610;75 i +;35;23;58;SEC_610
1999;317;25-34;66;81;147;SEC_317
1999;218;65-74;46;31;77;SEC_218
1999;106;75 i +;49;25;74;SEC_106
1999;203;03-11;12;20;32;SEC_203
1999;206;00-02;6;7;13;SEC_206
1999;538;12-15;16;14;30;SEC_538
1999;208;12-15;22;28;50;SEC_208
1999;420;75 i +;67;37;104;SEC_420
1999;316;50-64;173;202;375;SEC_316
1999;511;16-17;3;4;7;SEC_511
1999;228;18-24;32;29;61;SEC_228
1999;624;65-74;38;40;78;SEC_624
1999;115;16-17;16;17;33;SEC_115
1999;522;18-24;39;44;83;SEC_522
1999;102;12-15;30;30;60;SEC_102
1999;420;00-02;8;6;14;SEC_420
1999;307;65-74;81;60;141;SEC_307
1999;531;75 i +;46;24;70;SEC_531
1999;610;50-64;217;204;421;SEC_610
1999;428;18-24;20;21;41;SEC_428
1999;240;12-15;7;13;20;SEC_240
1999;430;75 i +;52;27;79;SEC_430
1999;605;75 i +;24;14;38;SEC_605
1999;615;35-49;48;43;91;SEC_615
1999;125;35-49;139;120;259;SEC_125
1999;525;16-17;11;8;19;SEC_525
1999;415;65-74;45;35;80;SEC_415
1999;235;03-11;29;30;59;SEC_235
1999;222;03-11;36;28;64;SEC_222
1999;232;50-64;92;89;181;SEC_232
1999;207;65-74;65;33;98;SEC_207
1999;139;12-15;13;19;32;SEC_139
1999;117;18-24;116;139;255;SEC_117
1999;602;18-24;31;24;55;SEC_602
1999;532;50-64;155;148;303;SEC_532
1999;129;35-49;92;104;196;SEC_129
1999;621;50-64;169;217;386;SEC_621
1999;139;50-64;81;85;166;SEC_139
1999;624;03-11;39;33;72;SEC_624
1999;431;03-11;31;44;75;SEC_431
1999;301;12-15;36;53;89;SEC_301
1999;528;12-15;18;12;30;SEC_528
1999;529;65-74;88;72;160;SEC_529
1999;418;25-34;84;104;188;SEC_418
1999;306;18-24;84;80;164;SEC_306
1999;240;75 i +;44;19;63;SEC_240
1999;512;35-49;71;72;143;SEC_512
1999;118;50-64;148;169;317;SEC_118
1999;106;12-15;44;44;88;SEC_106
1999;510;03-11;24;35;59;SEC_510
1999;226;25-34;82;68;150;SEC_226
1999;241;75 i +;47;30;77;SEC_241
1999;213;03-11;29;32;61;SEC_213
1999;438;00-02;7;8;15;SEC_438
1999;402;16-17;6;6;12;SEC_402
1999;626;03-11;34;32;66;SEC_626
1999;425;12-15;13;15;28;SEC_425
1999;401;03-11;48;41;89;SEC_401
1999;233;75 i +;72;32;104;SEC_233
1999;131;35-49;160;159;319;SEC_131
1999;520;18-24;47;63;110;SEC_520
1999;224;00-02;5;9;14;SEC_224
1999;508;18-24;34;20;54;SEC_508
1999;127;65-74;47;39;86;SEC_127
1999;212;50-64;143;116;259;SEC_212
1999;133;03-11;17;27;44;SEC_133
1999;212;35-49;111;113;224;SEC_212
1999;622;65-74;45;26;71;SEC_622
1999;528;03-11;40;31;71;SEC_528
1999;417;03-11;21;19;40;SEC_417
1999;101;16-17;15;16;31;SEC_101
1999;425;16-17;8;4;12;SEC_425
1999;320;35-49;47;45;92;SEC_320
1999;318;65-74;23;17;40;SEC_318
1999;437;65-74;50;42;92;SEC_437
1999;601;12-15;25;18;43;SEC_601
1999;613;25-34;150;163;313;SEC_613
1999;307;18-24;121;108;229;SEC_307
1999;420;25-34;107;107;214;SEC_420
1999;307;25-34;104;89;193;SEC_307
1999;309;50-64;64;61;125;SEC_309
1999;304;03-11;37;43;80;SEC_304
1999;110;75 i +;53;27;80;SEC_110
1999;303;35-49;101;106;207;SEC_303
1999;403;18-24;52;62;114;SEC_403
1999;441;65-74;110;82;192;SEC_441
1999;629;50-64;68;55;123;SEC_629
1999;230;00-02;10;12;22;SEC_230
1999;317;65-74;56;39;95;SEC_317
1999;117;12-15;61;56;117;SEC_117
1999;617;35-49;98;100;198;SEC_617
1999;207;16-17;7;8;15;SEC_207
1999;229;12-15;7;12;19;SEC_229
1999;131;03-11;58;52;110;SEC_131
1999;531;35-49;78;76;154;SEC_531
1999;128;18-24;65;70;135;SEC_128
1999;415;75 i +;43;28;71;SEC_415
1999;607;00-02;6;12;18;SEC_607
1999;613;65-74;66;54;120;SEC_613
1999;213;25-34;68;78;146;SEC_213
1999;321;16-17;34;34;68;SEC_321
1999;127;75 i +;32;13;45;SEC_127
1999;518;75 i +;55;21;76;SEC_518
1999;238;16-17;7;5;12;SEC_238
1999;322;03-11;36;46;82;SEC_322
1999;108;25-34;113;103;216;SEC_108
1999;624;16-17;17;16;33;SEC_624
1999;134;50-64;110;108;218;SEC_134
1999;121;16-17;4;3;7;SEC_121
1999;409;35-49;63;61;124;SEC_409
1999;112;25-34;121;109;230;SEC_112
1999;302;18-24;121;127;248;SEC_302
1999;304;18-24;46;60;106;SEC_304
1999;118;35-49;245;202;447;SEC_118
1999;627;75 i +;21;12;33;SEC_627
1999;536;12-15;9;11;20;SEC_536
1999;208;03-11;39;38;77;SEC_208
1999;533;12-15;11;11;22;SEC_533
1999;511;50-64;66;66;132;SEC_511
1999;315;65-74;53;38;91;SEC_315
1999;606;50-64;110;90;200;SEC_606
1999;122;35-49;60;82;142;SEC_122
1999;506;65-74;76;69;145;SEC_506
1999;614;12-15;9;20;29;SEC_614
1999;218;00-02;8;7;15;SEC_218
1999;530;65-74;116;81;197;SEC_530
1999;421;35-49;74;72;146;SEC_421
1999;414;18-24;37;44;81;SEC_414
1999;534;03-11;23;19;42;SEC_534
1999;632;25-34;84;113;197;SEC_632
1999;616;65-74;46;41;87;SEC_616
1999;209;16-17;3;8;11;SEC_209
1999;131;12-15;20;30;50;SEC_131
1999;107;75 i +;59;33;92;SEC_107
1999;521;25-34;93;98;191;SEC_521
1999;622;75 i +;36;11;47;SEC_622
1999;412;75 i +;55;33;88;SEC_412
1999;124;03-11;29;33;62;SEC_124
1999;137;00-02;12;15;27;SEC_137
1999;442;50-64;68;61;129;SEC_442
1999;408;12-15;20;13;33;SEC_408
1999;209;65-74;72;59;131;SEC_209
1999;212;25-34;121;105;226;SEC_212
1999;137;16-17;21;14;35;SEC_137
1999;130;35-49;68;85;153;SEC_130
1999;526;03-11;24;25;49;SEC_526
1999;204;35-49;37;53;90;SEC_204
1999;205;03-11;29;29;58;SEC_205
1999;421;00-02;7;15;22;SEC_421
1999;232;75 i +;65;31;96;SEC_232
1999;236;00-02;7;7;14;SEC_236
1999;620;50-64;95;90;185;SEC_620
1999;506;12-15;34;42;76;SEC_506
1999;117;00-02;31;23;54;SEC_117
1999;107;12-15;24;38;62;SEC_107
1999;235;00-02;12;15;27;SEC_235
1999;427;12-15;8;14;22;SEC_427
1999;442;18-24;31;35;66;SEC_442
1999;609;16-17;8;10;18;SEC_609
1999;422;03-11;29;39;68;SEC_422
1999;133;25-34;61;85;146;SEC_133
1999;217;75 i +;44;17;61;SEC_217
1999;534;50-64;104;101;205;SEC_534
1999;401;25-34;86;87;173;SEC_401
1999;307;12-15;31;34;65;SEC_307
1999;420;65-74;89;66;155;SEC_420
1999;215;35-49;70;66;136;SEC_215
1999;212;75 i +;66;34;100;SEC_212
1999;212;65-74;74;71;145;SEC_212
1999;320;00-02;5;7;12;SEC_320
1999;628;25-34;92;97;189;SEC_628
1999;607;75 i +;39;17;56;SEC_607
1999;516;75 i +;27;10;37;SEC_516
1999;517;35-49;104;108;212;SEC_517
1999;318;25-34;61;65;126;SEC_318
1999;523;75 i +;86;36;122;SEC_523
1999;211;00-02;7;18;25;SEC_211
1999;322;75 i +;41;22;63;SEC_322
1999;204;65-74;54;39;93;SEC_204
1999;608;75 i +;29;11;40;SEC_608
1999;507;50-64;91;98;189;SEC_507
1999;101;00-02;17;16;33;SEC_101
1999;423;75 i +;53;25;78;SEC_423
1999;234;18-24;31;41;72;SEC_234
1999;517;75 i +;47;31;78;SEC_517
1999;302;16-17;14;19;33;SEC_302
1999;510;00-02;11;13;24;SEC_510
1999;608;12-15;20;24;44;SEC_608
1999;128;12-15;18;17;35;SEC_128
1999;426;50-64;75;73;148;SEC_426
1999;233;65-74;50;39;89;SEC_233
1999;433;35-49;94;84;178;SEC_433
1999;621;00-02;16;15;31;SEC_621
1999;324;75 i +;49;21;70;SEC_324
1999;404;16-17;14;12;26;SEC_404
1999;403;03-11;20;31;51;SEC_403
1999;442;35-49;53;55;108;SEC_442
1999;109;50-64;89;92;181;SEC_109
1999;315;18-24;92;84;176;SEC_315
1999;323;75 i +;47;15;62;SEC_323
1999;526;00-02;6;8;14;SEC_526
1999;133;65-74;54;44;98;SEC_133
1999;319;03-11;19;25;44;SEC_319
1999;611;12-15;30;20;50;SEC_611
1999;434;03-11;23;24;47;SEC_434
1999;305;25-34;95;103;198;SEC_305
1999;309;16-17;8;9;17;SEC_309
1999;437;75 i +;22;16;38;SEC_437
1999;402;25-34;49;72;121;SEC_402
1999;524;25-34;118;106;224;SEC_524
1999;235;18-24;55;55;110;SEC_235
1999;522;00-02;7;7;14;SEC_522
1999;632;35-49;101;96;197;SEC_632
1999;239;50-64;119;79;198;SEC_239
1999;509;25-34;67;78;145;SEC_509
1999;527;75 i +;52;28;80;SEC_527
1999;613;35-49;70;80;150;SEC_613
1999;132;35-49;258;229;487;SEC_132
1999;411;00-02;7;6;13;SEC_411
1999;207;03-11;18;17;35;SEC_207
1999;601;18-24;102;113;215;SEC_601
1999;301;50-64;202;206;408;SEC_301
1999;227;50-64;67;60;127;SEC_227
1999;612;75 i +;39;17;56;SEC_612
1999;631;35-49;97;68;165;SEC_631
1999;624;12-15;17;23;40;SEC_624
1999;246;25-34;92;92;184;SEC_246
1999;128;65-74;48;45;93;SEC_128
1999;210;03-11;23;22;45;SEC_210
1999;430;16-17;7;7;14;SEC_430
1999;235;35-49;84;91;175;SEC_235
1999;104;75 i +;60;34;94;SEC_104
1999;621;65-74;40;33;73;SEC_621
1999;303;75 i +;76;41;117;SEC_303
1999;321;35-49;320;301;621;SEC_321
1999;315;75 i +;48;25;73;SEC_315
1999;112;18-24;90;88;178;SEC_112
1999;239;35-49;92;84;176;SEC_239
1999;324;00-02;17;12;29;SEC_324
1999;527;25-34;84;81;165;SEC_527
1999;221;16-17;11;12;23;SEC_221
1999;504;18-24;66;95;161;SEC_504
1999;604;50-64;92;69;161;SEC_604
1999;248;18-24;36;59;95;SEC_248
1999;408;65-74;53;54;107;SEC_408
1999;240;50-64;65;60;125;SEC_240
1999;507;12-15;23;20;43;SEC_507
1999;535;65-74;40;38;78;SEC_535
1999;430;50-64;82;90;172;SEC_430
1999;438;16-17;9;5;14;SEC_438
1999;405;16-17;5;7;12;SEC_405
1999;627;16-17;20;19;39;SEC_627
1999;411;25-34;62;76;138;SEC_411
1999;406;00-02;11;12;23;SEC_406
1999;312;75 i +;46;29;75;SEC_312
1999;605;12-15;9;5;14;SEC_605
1999;223;75 i +;62;26;88;SEC_223
1999;511;00-02;9;3;12;SEC_511
1999;511;65-74;57;47;104;SEC_511
1999;528;16-17;9;9;18;SEC_528
1999;235;65-74;106;87;193;SEC_235
1999;410;50-64;201;189;390;SEC_410
1999;404;03-11;49;41;90;SEC_404
1999;140;18-24;62;56;118;SEC_140
1999;519;03-11;8;24;32;SEC_519
1999;130;50-64;113;80;193;SEC_130
1999;213;18-24;53;60;113;SEC_213
1999;401;00-02;9;15;24;SEC_401
1999;247;18-24;59;53;112;SEC_247
1999;512;16-17;4;5;9;SEC_512
1999;221;50-64;109;99;208;SEC_221
1999;211;65-74;86;73;159;SEC_211
1999;227;16-17;6;10;16;SEC_227
1999;109;25-34;92;80;172;SEC_109
1999;414;50-64;87;80;167;SEC_414
1999;624;18-24;85;118;203;SEC_624
1999;112;16-17;25;11;36;SEC_112
1999;502;25-34;112;124;236;SEC_502
1999;126;18-24;87;68;155;SEC_126
1999;238;03-11;17;19;36;SEC_238
1999;204;18-24;19;18;37;SEC_204
1999;137;12-15;26;30;56;SEC_137
1999;125;00-02;8;8;16;SEC_125
1999;247;25-34;94;103;197;SEC_247
1999;510;75 i +;42;25;67;SEC_510
1999;315;35-49;176;176;352;SEC_315
1999;128;50-64;107;104;211;SEC_128
1999;415;16-17;8;9;17;SEC_415
1999;526;75 i +;34;18;52;SEC_526
1999;605;25-34;68;81;149;SEC_605
1999;224;12-15;8;14;22;SEC_224
1999;513;00-02;6;10;16;SEC_513
1999;412;25-34;100;129;229;SEC_412
1999;238;00-02;5;6;11;SEC_238
1999;508;12-15;13;11;24;SEC_508
1999;430;12-15;11;15;26;SEC_430
1999;248;00-02;12;9;21;SEC_248
1999;129;50-64;128;126;254;SEC_129
1999;306;12-15;26;36;62;SEC_306
1999;324;03-11;37;34;71;SEC_324
1999;204;50-64;52;42;94;SEC_204
1999;412;35-49;175;172;347;SEC_412
1999;426;03-11;24;26;50;SEC_426
1999;434;16-17;3;9;12;SEC_434
1999;520;16-17;7;11;18;SEC_520
1999;406;35-49;128;130;258;SEC_406
1999;306;16-17;30;15;45;SEC_306
1999;111;12-15;18;17;35;SEC_111
1999;622;00-02;10;14;24;SEC_622
1999;113;50-64;106;124;230;SEC_113
1999;518;35-49;75;90;165;SEC_518
1999;226;35-49;99;93;192;SEC_226
1999;434;35-49;55;51;106;SEC_434
1999;218;12-15;7;18;25;SEC_218
1999;304;16-17;11;9;20;SEC_304
1999;210;16-17;5;7;12;SEC_210
1999;511;12-15;4;8;12;SEC_511
1999;508;35-49;47;56;103;SEC_508
1999;313;12-15;39;44;83;SEC_313
1999;620;75 i +;11;4;15;SEC_620
1999;301;16-17;17;32;49;SEC_301
1999;230;18-24;34;30;64;SEC_230
1999;139;18-24;59;55;114;SEC_139
1999;223;25-34;89;86;175;SEC_223
1999;122;50-64;129;107;236;SEC_122
1999;528;00-02;12;9;21;SEC_528
1999;126;12-15;13;12;25;SEC_126
1999;225;16-17;4;3;7;SEC_225
1999;243;16-17;15;8;23;SEC_243
1999;424;00-02;7;5;12;SEC_424
1999;426;00-02;12;4;16;SEC_426
1999;132;16-17;28;35;63;SEC_132
1999;523;25-34;115;111;226;SEC_523
1999;106;00-02;20;21;41;SEC_106
1999;303;12-15;18;27;45;SEC_303
1999;605;35-49;50;38;88;SEC_605
1999;506;75 i +;57;34;91;SEC_506
1999;530;18-24;55;74;129;SEC_530
1999;405;65-74;85;69;154;SEC_405
1999;442;25-34;46;47;93;SEC_442
1999;224;75 i +;40;13;53;SEC_224
1999;203;50-64;60;67;127;SEC_203
1999;215;12-15;14;12;26;SEC_215
1999;612;18-24;64;85;149;SEC_612
1999;322;65-74;66;53;119;SEC_322
1999;203;16-17;6;9;15;SEC_203
1999;620;03-11;17;30;47;SEC_620
1999;106;03-11;63;61;124;SEC_106
1999;512;03-11;28;26;54;SEC_512
1999;440;65-74;51;48;99;SEC_440
1999;203;00-02;5;7;12;SEC_203
1999;202;50-64;79;69;148;SEC_202
1999;216;18-24;76;65;141;SEC_216
1999;627;00-02;17;6;23;SEC_627
1999;314;18-24;129;138;267;SEC_314
1999;613;12-15;15;15;30;SEC_613
1999;231;50-64;95;81;176;SEC_231
1999;137;75 i +;42;18;60;SEC_137
1999;205;00-02;13;12;25;SEC_205
1999;102;50-64;204;210;414;SEC_102
1999;305;75 i +;80;41;121;SEC_305
1999;424;16-17;4;7;11;SEC_424
1999;423;25-34;75;91;166;SEC_423
1999;204;16-17;3;3;6;SEC_204
1999;221;12-15;13;27;40;SEC_221
1999;323;16-17;50;51;101;SEC_323
1999;627;50-64;108;123;231;SEC_627
1999;411;35-49;87;80;167;SEC_411
1999;310;65-74;37;35;72;SEC_310
1999;220;25-34;77;73;150;SEC_220
1999;236;65-74;92;73;165;SEC_236
1999;518;65-74;63;72;135;SEC_518
1999;115;12-15;18;31;49;SEC_115
1999;109;65-74;57;46;103;SEC_109
1999;534;12-15;10;13;23;SEC_534
1999;110;12-15;29;21;50;SEC_110
1999;322;18-24;66;68;134;SEC_322
1999;312;35-49;139;145;284;SEC_312
1999;324;25-34;71;78;149;SEC_324
1999;526;16-17;7;8;15;SEC_526
1999;220;12-15;8;12;20;SEC_220
1999;119;03-11;22;45;67;SEC_119
1999;431;00-02;22;12;34;SEC_431
1999;629;12-15;12;12;24;SEC_629
1999;536;25-34;90;94;184;SEC_536
1999;219;65-74;82;61;143;SEC_219
1999;512;00-02;9;8;17;SEC_512
1999;234;16-17;5;7;12;SEC_234
1999;206;65-74;58;61;119;SEC_206
1999;106;18-24;151;183;334;SEC_106
1999;617;12-15;27;18;45;SEC_617
1999;510;35-49;79;81;160;SEC_510
1999;407;16-17;9;14;23;SEC_407
1999;107;18-24;118;120;238;SEC_107
1999;520;25-34;73;72;145;SEC_520
1999;631;25-34;117;125;242;SEC_631
1999;514;00-02;8;8;16;SEC_514
1999;613;00-02;10;13;23;SEC_613
1999;221;75 i +;34;28;62;SEC_221
1999;403;75 i +;50;23;73;SEC_403
1999;537;75 i +;51;28;79;SEC_537
1999;420;03-11;37;32;69;SEC_420
1999;313;18-24;139;115;254;SEC_313
1999;136;50-64;103;103;206;SEC_136
1999;517;16-17;11;17;28;SEC_517
1999;514;50-64;73;60;133;SEC_514
1999;137;25-34;120;100;220;SEC_137
1999;412;50-64;183;169;352;SEC_412
1999;112;12-15;30;27;57;SEC_112
1999;316;65-74;38;30;68;SEC_316
1999;439;03-11;35;30;65;SEC_439
1999;209;25-34;78;86;164;SEC_209
1999;505;75 i +;40;27;67;SEC_505
1999;108;12-15;27;13;40;SEC_108
1999;516;03-11;12;21;33;SEC_516
1999;120;35-49;231;221;452;SEC_120
1999;606;03-11;41;45;86;SEC_606
1999;412;18-24;91;108;199;SEC_412
1999;245;35-49;88;87;175;SEC_245
1999;435;35-49;76;99;175;SEC_435
1999;521;75 i +;39;22;61;SEC_521
1999;206;03-11;24;26;50;SEC_206
1999;519;50-64;56;49;105;SEC_519
1999;304;75 i +;77;39;116;SEC_304
1999;422;25-34;76;79;155;SEC_422
1999;605;03-11;10;19;29;SEC_605
1999;217;18-24;22;21;43;SEC_217
1999;119;00-02;15;9;24;SEC_119
1999;224;16-17;4;10;14;SEC_224
1999;312;16-17;9;16;25;SEC_312
1999;227;75 i +;45;24;69;SEC_227
1999;305;12-15;47;41;88;SEC_305
1999;501;50-64;140;172;312;SEC_501
1999;119;35-49;155;135;290;SEC_119
1999;521;12-15;23;19;42;SEC_521
1999;122;03-11;33;18;51;SEC_122
1999;114;12-15;28;30;58;SEC_114
1999;309;03-11;26;37;63;SEC_309
1999;207;12-15;7;8;15;SEC_207
1999;320;03-11;15;21;36;SEC_320
1999;205;35-49;94;93;187;SEC_205
1999;317;16-17;8;9;17;SEC_317
1999;402;00-02;4;5;9;SEC_402
1999;532;75 i +;69;39;108;SEC_532
1999;502;00-02;13;13;26;SEC_502
1999;104;35-49;72;62;134;SEC_104
1999;435;16-17;4;12;16;SEC_435
1999;607;03-11;32;29;61;SEC_607
1999;125;65-74;51;47;98;SEC_125
1999;220;16-17;10;10;20;SEC_220
1999;419;12-15;12;9;21;SEC_419
1999;440;00-02;6;7;13;SEC_440
1999;419;00-02;18;15;33;SEC_419
1999;406;25-34;92;104;196;SEC_406
1999;321;12-15;45;55;100;SEC_321
1999;303;25-34;182;206;388;SEC_303
1999;202;25-34;65;75;140;SEC_202
1999;519;12-15;9;8;17;SEC_519
1999;324;18-24;29;45;74;SEC_324
1999;603;18-24;32;54;86;SEC_603
1999;101;35-49;147;162;309;SEC_101
1999;420;35-49;97;109;206;SEC_420
1999;137;65-74;43;40;83;SEC_137
1999;425;25-34;91;80;171;SEC_425
1999;515;12-15;15;12;27;SEC_515
1999;114;25-34;146;157;303;SEC_114
1999;101;18-24;65;61;126;SEC_101
1999;622;50-64;66;78;144;SEC_622
1999;201;03-11;22;19;41;SEC_201
1999;214;25-34;56;70;126;SEC_214
1999;619;25-34;111;134;245;SEC_619
1999;210;12-15;7;11;18;SEC_210
1999;630;65-74;30;27;57;SEC_630
1999;524;12-15;18;22;40;SEC_524
1999;630;50-64;101;113;214;SEC_630
1999;316;75 i +;32;22;54;SEC_316
1999;627;18-24;100;101;201;SEC_627
1999;625;00-02;12;10;22;SEC_625
1999;507;75 i +;36;22;58;SEC_507
1999;309;65-74;35;30;65;SEC_309
1999;241;00-02;7;9;16;SEC_241
1999;436;16-17;3;4;7;SEC_436
1999;529;16-17;7;10;17;SEC_529
1999;113;03-11;53;66;119;SEC_113
1999;302;50-64;150;183;333;SEC_302
1999;244;75 i +;39;36;75;SEC_244
1999;323;18-24;231;219;450;SEC_323
1999;629;25-34;46;64;110;SEC_629
1999;442;16-17;6;7;13;SEC_442
1999;115;75 i +;45;24;69;SEC_115
1999;108;16-17;9;15;24;SEC_108
1999;610;00-02;5;8;13;SEC_610
1999;432;25-34;89;86;175;SEC_432
1999;607;12-15;12;21;33;SEC_607
1999;301;18-24;113;119;232;SEC_301
1999;610;03-11;28;37;65;SEC_610
1999;436;25-34;74;81;155;SEC_436
1999;215;00-02;9;11;20;SEC_215
1999;631;12-15;19;15;34;SEC_631
1999;308;50-64;166;168;334;SEC_308
1999;101;75 i +;27;10;37;SEC_101
1999;137;35-49;160;147;307;SEC_137
1999;605;65-74;42;40;82;SEC_605
1999;514;03-11;23;19;42;SEC_514
1999;535;18-24;68;93;161;SEC_535
1999;203;65-74;55;42;97;SEC_203
1999;537;65-74;78;59;137;SEC_537
1999;126;03-11;24;20;44;SEC_126
1999;210;35-49;79;78;157;SEC_210
1999;507;25-34;79;96;175;SEC_507
1999;216;25-34;87;105;192;SEC_216
1999;110;65-74;54;44;98;SEC_110
1999;208;35-49;176;163;339;SEC_208
1999;306;75 i +;66;42;108;SEC_306
1999;120;00-02;24;29;53;SEC_120
1999;433;75 i +;44;20;64;SEC_433
1999;134;12-15;32;33;65;SEC_134
1999;212;00-02;13;18;31;SEC_212
1999;628;50-64;133;148;281;SEC_628
1999;223;50-64;111;104;215;SEC_223
1999;407;18-24;39;43;82;SEC_407
1999;117;75 i +;49;24;73;SEC_117
1999;121;03-11;33;33;66;SEC_121
1999;243;25-34;146;127;273;SEC_243
1999;620;16-17;9;5;14;SEC_620
1999;536;00-02;7;11;18;SEC_536
1999;246;00-02;6;16;22;SEC_246
1999;249;00-02;6;11;17;SEC_249
1999;234;00-02;12;6;18;SEC_234
1999;242;65-74;95;75;170;SEC_242
1999;208;00-02;12;13;25;SEC_208
1999;623;16-17;15;25;40;SEC_623
1999;308;00-02;18;20;38;SEC_308
1999;413;16-17;6;5;11;SEC_413
1999;438;12-15;18;10;28;SEC_438
1999;234;03-11;23;30;53;SEC_234
1999;606;35-49;87;101;188;SEC_606
1999;120;03-11;79;76;155;SEC_120
1999;442;00-02;4;3;7;SEC_442
1999;230;75 i +;41;18;59;SEC_230
1999;124;18-24;49;46;95;SEC_124
1999;413;00-02;2;2;4;SEC_413
1999;249;35-49;85;83;168;SEC_249
1999;126;25-34;105;129;234;SEC_126
1999;245;03-11;25;29;54;SEC_245
1999;538;50-64;130;106;236;SEC_538
1999;309;35-49;92;71;163;SEC_309
1999;112;00-02;14;16;30;SEC_112
1999;628;12-15;21;20;41;SEC_628
1999;614;50-64;140;126;266;SEC_614
1999;216;12-15;21;22;43;SEC_216
1999;140;50-64;118;111;229;SEC_140
1999;103;65-74;39;34;73;SEC_103
1999;436;18-24;42;45;87;SEC_436
1999;533;18-24;41;47;88;SEC_533
1999;614;35-49;82;71;153;SEC_614
1999;207;35-49;75;66;141;SEC_207
1999;625;50-64;118;136;254;SEC_625
1999;236;12-15;13;11;24;SEC_236
1999;413;12-15;6;9;15;SEC_413
1999;441;03-11;85;74;159;SEC_441
1999;408;00-02;5;15;20;SEC_408
1999;537;25-34;107;93;200;SEC_537
1999;616;75 i +;31;19;50;SEC_616
1999;405;00-02;10;13;23;SEC_405
1999;507;03-11;23;27;50;SEC_507
1999;106;65-74;54;41;95;SEC_106
1999;229;16-17;2;4;6;SEC_229
1999;415;00-02;3;10;13;SEC_415
1999;508;16-17;9;6;15;SEC_508
1999;239;65-74;101;75;176;SEC_239
1999;308;12-15;30;37;67;SEC_308
1999;431;75 i +;65;38;103;SEC_431
1999;409;18-24;45;43;88;SEC_409
1999;246;16-17;9;9;18;SEC_246
1999;614;16-17;8;15;23;SEC_614
1999;532;18-24;68;74;142;SEC_532
1999;206;16-17;8;8;16;SEC_206
1999;612;50-64;176;148;324;SEC_612
1999;104;18-24;35;38;73;SEC_104
1999;417;18-24;32;31;63;SEC_417
1999;407;35-49;86;90;176;SEC_407
1999;219;03-11;31;32;63;SEC_219
1999;528;75 i +;42;25;67;SEC_528
1999;306;50-64;130;123;253;SEC_306
1999;520;00-02;9;8;17;SEC_520
1999;314;75 i +;65;30;95;SEC_314
1999;538;03-11;24;39;63;SEC_538
1999;130;00-02;8;14;22;SEC_130
1999;325;50-64;206;182;388;SEC_325
1999;435;00-02;10;14;24;SEC_435
1999;538;18-24;56;57;113;SEC_538
1999;430;65-74;57;48;105;SEC_430
1999;426;75 i +;51;33;84;SEC_426
1999;413;25-34;41;53;94;SEC_413
1999;132;75 i +;53;24;77;SEC_132
1999;132;65-74;72;82;154;SEC_132
1999;135;75 i +;49;21;70;SEC_135
1999;508;65-74;43;33;76;SEC_508
1999;248;12-15;26;19;45;SEC_248
1999;117;50-64;160;174;334;SEC_117
1999;123;00-02;10;18;28;SEC_123
1999;538;25-34;97;108;205;SEC_538
1999;533;75 i +;41;23;64;SEC_533
1999;108;75 i +;83;43;126;SEC_108
1999;233;12-15;7;8;15;SEC_233
1999;602;25-34;69;90;159;SEC_602
1999;317;35-49;59;80;139;SEC_317
1999;530;00-02;4;15;19;SEC_530
1999;246;75 i +;72;34;106;SEC_246
1999;325;35-49;199;175;374;SEC_325
1999;421;50-64;139;108;247;SEC_421
1999;111;25-34;73;93;166;SEC_111
1999;227;18-24;30;32;62;SEC_227
1999;631;16-17;11;9;20;SEC_631
1999;408;35-49;85;88;173;SEC_408
1999;612;35-49;73;75;148;SEC_612
1999;245;12-15;7;13;20;SEC_245
1999;518;12-15;11;21;32;SEC_518
1999;603;65-74;24;23;47;SEC_603
1999;103;25-34;59;55;114;SEC_103
1999;405;25-34;77;84;161;SEC_405
1999;402;03-11;21;15;36;SEC_402
1999;525;50-64;96;84;180;SEC_525
1999;130;25-34;86;102;188;SEC_130
1999;220;35-49;65;65;130;SEC_220
1999;432;75 i +;33;33;66;SEC_432
1999;525;12-15;12;11;23;SEC_525
1999;623;50-64;196;197;393;SEC_623
1999;526;25-34;57;58;115;SEC_526
1999;619;35-49;154;142;296;SEC_619
1999;237;03-11;39;31;70;SEC_237
1999;233;35-49;66;68;134;SEC_233
1999;215;03-11;23;20;43;SEC_215
1999;216;50-64;144;119;263;SEC_216
1999;515;03-11;18;21;39;SEC_515
1999;212;03-11;33;40;73;SEC_212
1999;503;50-64;75;86;161;SEC_503
1999;127;18-24;29;46;75;SEC_127
1999;322;50-64;95;92;187;SEC_322
1999;246;18-24;49;33;82;SEC_246
1999;618;12-15;10;13;23;SEC_618
1999;413;35-49;47;51;98;SEC_413
1999;225;12-15;9;12;21;SEC_225
1999;210;00-02;5;7;12;SEC_210
1999;439;50-64;95;86;181;SEC_439
1999;245;65-74;74;56;130;SEC_245
1999;134;35-49;143;123;266;SEC_134
1999;104;00-02;14;7;21;SEC_104
1999;228;25-34;62;62;124;SEC_228
1999;430;35-49;67;76;143;SEC_430
1999;414;25-34;73;67;140;SEC_414
1999;434;65-74;70;43;113;SEC_434
1999;521;00-02;4;4;8;SEC_521
1999;525;35-49;68;70;138;SEC_525
1999;222;12-15;12;17;29;SEC_222
1999;112;75 i +;58;19;77;SEC_112
1999;138;50-64;88;73;161;SEC_138
1999;216;75 i +;50;35;85;SEC_216
1999;317;75 i +;48;23;71;SEC_317
1999;136;75 i +;48;26;74;SEC_136
1999;424;50-64;68;60;128;SEC_424
1999;108;65-74;90;79;169;SEC_108
1999;301;75 i +;74;34;108;SEC_301
1999;440;25-34;93;108;201;SEC_440
1999;222;16-17;9;8;17;SEC_222
1999;510;50-64;115;112;227;SEC_510
1999;532;25-34;126;108;234;SEC_532
1999;411;65-74;97;77;174;SEC_411
1999;130;18-24;38;39;77;SEC_130
1999;613;75 i +;40;20;60;SEC_613
1999;242;12-15;12;17;29;SEC_242
1999;127;00-02;11;12;23;SEC_127
1999;306;35-49;170;160;330;SEC_306
1999;513;75 i +;40;15;55;SEC_513
1999;119;25-34;101;118;219;SEC_119
1999;233;16-17;5;7;12;SEC_233
1999;512;18-24;35;51;86;SEC_512
1999;242;16-17;6;11;17;SEC_242
1999;512;12-15;20;16;36;SEC_512
1999;617;65-74;56;52;108;SEC_617
1999;306;25-34;116;112;228;SEC_306
1999;432;65-74;75;60;135;SEC_432
1999;603;50-64;86;69;155;SEC_603
1999;626;65-74;53;66;119;SEC_626
1999;213;16-17;4;13;17;SEC_213
1999;406;16-17;17;19;36;SEC_406
1999;520;50-64;96;99;195;SEC_520
1999;429;25-34;31;45;76;SEC_429
1999;538;65-74;88;80;168;SEC_538
1999;201;18-24;25;34;59;SEC_201
1999;212;12-15;19;27;46;SEC_212
1999;401;18-24;55;53;108;SEC_401
1999;211;12-15;15;13;28;SEC_211
1999;502;65-74;67;62;129;SEC_502
1999;220;65-74;67;55;122;SEC_220
1999;623;18-24;113;121;234;SEC_623
1999;103;12-15;16;11;27;SEC_103
1999;409;12-15;8;8;16;SEC_409
1999;509;03-11;24;31;55;SEC_509
1999;232;00-02;9;9;18;SEC_232
1999;225;65-74;45;28;73;SEC_225
1999;243;65-74;106;89;195;SEC_243
1999;608;03-11;30;41;71;SEC_608
1999;412;00-02;7;10;17;SEC_412
1999;108;18-24;41;55;96;SEC_108
1999;428;35-49;43;49;92;SEC_428
1999;325;75 i +;128;72;200;SEC_325
1999;116;00-02;19;11;30;SEC_116
1999;413;03-11;27;18;45;SEC_413
1999;302;12-15;24;19;43;SEC_302
1999;439;25-34;99;93;192;SEC_439
1999;109;35-49;135;147;282;SEC_109
1999;426;16-17;6;10;16;SEC_426
1999;418;18-24;61;58;119;SEC_418
1999;530;16-17;9;12;21;SEC_530
1999;235;25-34;127;113;240;SEC_235
1999;632;18-24;86;82;168;SEC_632
1999;202;18-24;36;44;80;SEC_202
1999;324;35-49;77;77;154;SEC_324
1999;313;65-74;82;77;159;SEC_313
1999;239;00-02;9;11;20;SEC_239
1999;527;35-49;86;110;196;SEC_527
1999;624;00-02;9;8;17;SEC_624
1999;436;00-02;10;16;26;SEC_436
1999;136;25-34;94;94;188;SEC_136
1999;626;35-49;104;104;208;SEC_626
1999;307;00-02;14;13;27;SEC_307
1999;206;35-49;72;70;142;SEC_206
1999;320;65-74;26;14;40;SEC_320
1999;114;03-11;47;35;82;SEC_114
1999;214;16-17;5;9;14;SEC_214
1999;139;25-34;73;74;147;SEC_139
1999;608;25-34;80;104;184;SEC_608
1999;410;35-49;145;139;284;SEC_410
1999;314;12-15;66;71;137;SEC_314
1999;211;03-11;44;34;78;SEC_211
1999;419;18-24;33;51;84;SEC_419
1999;201;25-34;58;62;120;SEC_201
1999;312;50-64;202;181;383;SEC_312
1999;308;18-24;85;88;173;SEC_308
1999;205;75 i +;33;20;53;SEC_205
1999;307;03-11;43;62;105;SEC_307
1999;502;16-17;18;16;34;SEC_502
1999;140;16-17;6;7;13;SEC_140
1999;134;16-17;8;15;23;SEC_134
1999;628;16-17;19;20;39;SEC_628
1999;316;25-34;97;95;192;SEC_316
1999;415;35-49;64;70;134;SEC_415
1999;601;65-74;57;66;123;SEC_601
1999;414;12-15;12;21;33;SEC_414
1999;320;12-15;7;9;16;SEC_320
1999;231;25-34;95;71;166;SEC_231
1999;236;16-17;13;12;25;SEC_236
1999;416;12-15;8;7;15;SEC_416
1999;503;25-34;64;54;118;SEC_503
1999;629;00-02;6;7;13;SEC_629
1999;207;25-34;45;37;82;SEC_207
1999;310;75 i +;27;15;42;SEC_310
1999;424;25-34;30;59;89;SEC_424
1999;505;12-15;20;16;36;SEC_505
1999;215;75 i +;61;40;101;SEC_215
1999;626;18-24;69;77;146;SEC_626
1999;416;75 i +;26;16;42;SEC_416
1999;418;00-02;12;11;23;SEC_418
1999;614;65-74;47;42;89;SEC_614
1999;133;50-64;89;83;172;SEC_133
1999;506;18-24;175;155;330;SEC_506
1999;425;75 i +;47;23;70;SEC_425
1999;124;12-15;21;18;39;SEC_124
1999;308;16-17;17;13;30;SEC_308
1999;219;75 i +;80;36;116;SEC_219
1999;226;12-15;22;16;38;SEC_226
1999;530;75 i +;64;28;92;SEC_530
1999;231;65-74;80;71;151;SEC_231
1999;522;03-11;22;16;38;SEC_522
1999;436;12-15;10;15;25;SEC_436
1999;411;12-15;12;9;21;SEC_411
1999;237;65-74;86;65;151;SEC_237
1999;536;16-17;5;5;10;SEC_536
1999;226;18-24;57;60;117;SEC_226
1999;246;35-49;79;97;176;SEC_246
1999;614;75 i +;39;15;54;SEC_614
1999;622;03-11;30;44;74;SEC_622
1999;607;16-17;9;8;17;SEC_607
1999;412;16-17;25;22;47;SEC_412
1999;106;16-17;30;31;61;SEC_106
1999;604;75 i +;22;16;38;SEC_604
1999;117;35-49;252;243;495;SEC_117
1999;615;25-34;94;128;222;SEC_615
1999;423;35-49;72;82;154;SEC_423
1999;248;65-74;75;57;132;SEC_248
1999;434;18-24;33;19;52;SEC_434
1999;319;00-02;9;14;23;SEC_319
1999;534;75 i +;42;22;64;SEC_534
1999;135;65-74;64;50;114;SEC_135
1999;421;65-74;83;75;158;SEC_421
1999;609;50-64;143;135;278;SEC_609
1999;311;16-17;11;14;25;SEC_311
1999;116;25-34;144;143;287;SEC_116
1999;423;50-64;119;112;231;SEC_423
1999;502;03-11;49;33;82;SEC_502
1999;125;50-64;127;142;269;SEC_125
1999;440;75 i +;54;29;83;SEC_440
1999;432;50-64;139;145;284;SEC_432
1999;518;16-17;8;13;21;SEC_518
1999;522;75 i +;29;20;49;SEC_522
1999;115;65-74;73;51;124;SEC_115
1999;318;16-17;17;11;28;SEC_318
1999;438;75 i +;30;12;42;SEC_438
1999;506;50-64;209;234;443;SEC_506
1999;237;25-34;106;135;241;SEC_237
1999;429;16-17;7;9;16;SEC_429
1999;218;16-17;7;6;13;SEC_218
1999;118;16-17;32;24;56;SEC_118
1999;506;25-34;144;158;302;SEC_506
1999;628;00-02;5;10;15;SEC_628
1999;410;75 i +;67;46;113;SEC_410
1999;616;50-64;175;183;358;SEC_616
1999;619;12-15;21;35;56;SEC_619
1999;626;75 i +;25;17;42;SEC_626
1999;134;25-34;106;99;205;SEC_134
1999;125;25-34;92;84;176;SEC_125
1999;218;18-24;34;39;73;SEC_218
1999;311;65-74;86;74;160;SEC_311
1999;628;18-24;77;97;174;SEC_628
1999;526;35-49;55;62;117;SEC_526
1999;305;65-74;87;57;144;SEC_305
1999;434;75 i +;45;31;76;SEC_434
1999;222;75 i +;29;20;49;SEC_222
1999;124;16-17;13;14;27;SEC_124
1999;531;65-74;55;51;106;SEC_531
1999;201;50-64;82;67;149;SEC_201
1999;319;16-17;11;18;29;SEC_319
1999;301;25-34;194;210;404;SEC_301
1999;512;75 i +;46;22;68;SEC_512
1999;322;25-34;105;110;215;SEC_322
1999;324;12-15;19;19;38;SEC_324
1999;229;25-34;45;63;108;SEC_229
1999;129;16-17;16;10;26;SEC_129
1999;124;50-64;74;76;150;SEC_124
1999;308;75 i +;68;39;107;SEC_308
1999;407;75 i +;35;32;67;SEC_407
1999;403;00-02;11;10;21;SEC_403
1999;525;65-74;52;47;99;SEC_525
1999;602;50-64;91;75;166;SEC_602
1999;103;03-11;25;21;46;SEC_103
1999;627;03-11;24;48;72;SEC_627
1999;118;12-15;40;57;97;SEC_118
1999;309;25-34;62;56;118;SEC_309
1999;515;25-34;38;41;79;SEC_515
1999;230;12-15;13;12;25;SEC_230
1999;235;50-64;147;114;261;SEC_235
1999;532;12-15;20;17;37;SEC_532
1999;310;50-64;80;70;150;SEC_310
1999;627;12-15;23;31;54;SEC_627
1999;505;65-74;60;50;110;SEC_505
1999;213;75 i +;30;17;47;SEC_213
1999;536;75 i +;32;31;63;SEC_536
1999;208;18-24;70;77;147;SEC_208
1999;215;25-34;64;65;129;SEC_215
1999;605;16-17;4;4;8;SEC_605
1999;226;65-74;86;59;145;SEC_226
1999;408;50-64;83;67;150;SEC_408
1999;431;18-24;80;76;156;SEC_431
1999;619;75 i +;43;27;70;SEC_619
1999;629;65-74;40;39;79;SEC_629
1999;619;00-02;14;15;29;SEC_619
1999;307;50-64;160;153;313;SEC_307
1999;316;00-02;11;17;28;SEC_316
1999;618;25-34;54;69;123;SEC_618
1999;501;16-17;22;22;44;SEC_501
1999;510;25-34;99;114;213;SEC_510
1999;241;03-11;38;23;61;SEC_241
1999;245;16-17;6;8;14;SEC_245
1999;230;50-64;68;61;129;SEC_230
1999;114;35-49;164;165;329;SEC_114
1999;127;25-34;69;74;143;SEC_127
1999;508;00-02;3;7;10;SEC_508
1999;323;25-34;230;232;462;SEC_323
1999;627;35-49;152;124;276;SEC_627
1999;217;50-64;38;34;72;SEC_217
1999;204;03-11;8;20;28;SEC_204
1999;413;65-74;43;35;78;SEC_413
1999;529;03-11;24;38;62;SEC_529
1999;504;00-02;12;10;22;SEC_504
1999;414;03-11;23;31;54;SEC_414
1999;403;12-15;25;17;42;SEC_403
1999;523;18-24;65;65;130;SEC_523
1999;104;65-74;81;53;134;SEC_104
1999;526;65-74;38;34;72;SEC_526
1999;404;35-49;107;125;232;SEC_404
1999;101;65-74;33;43;76;SEC_101
1999;229;75 i +;47;20;67;SEC_229
1999;616;00-02;27;51;78;SEC_616
1999;626;00-02;15;9;24;SEC_626
1999;205;16-17;14;7;21;SEC_205
1999;113;25-34;95;93;188;SEC_113
1999;437;50-64;81;78;159;SEC_437
1999;441;35-49;256;252;508;SEC_441
1999;620;65-74;17;22;39;SEC_620
1999;603;25-34;60;77;137;SEC_603
1999;310;35-49;95;108;203;SEC_310
1999;422;65-74;87;61;148;SEC_422
1999;412;03-11;43;46;89;SEC_412
1999;231;75 i +;87;44;131;SEC_231
1999;128;75 i +;35;21;56;SEC_128
1999;219;35-49;96;104;200;SEC_219
1999;520;03-11;32;23;55;SEC_520
1999;215;65-74;71;50;121;SEC_215
1999;128;00-02;9;9;18;SEC_128
1999;223;12-15;14;14;28;SEC_223
1999;238;65-74;56;41;97;SEC_238
1999;315;50-64;108;129;237;SEC_315
1999;512;50-64;107;106;213;SEC_512
1999;522;25-34;48;59;107;SEC_522
1999;308;25-34;141;137;278;SEC_308
1999;320;50-64;97;82;179;SEC_320
1999;505;18-24;107;86;193;SEC_505
1999;237;16-17;12;10;22;SEC_237
1999;508;03-11;19;22;41;SEC_508
1999;219;50-64;107;89;196;SEC_219
1999;232;12-15;13;13;26;SEC_232
1999;405;03-11;24;20;44;SEC_405
1999;531;50-64;83;86;169;SEC_531
1999;407;65-74;80;72;152;SEC_407
1999;610;65-74;59;47;106;SEC_610
1999;246;03-11;32;23;55;SEC_246
1999;138;12-15;13;32;45;SEC_138
1999;517;03-11;34;37;71;SEC_517
1999;241;65-74;67;39;106;SEC_241
1999;237;35-49;107;113;220;SEC_237
1999;629;18-24;38;41;79;SEC_629
1999;441;12-15;69;56;125;SEC_441
1999;321;25-34;178;190;368;SEC_321
1999;425;03-11;26;37;63;SEC_425
1999;430;25-34;80;69;149;SEC_430
1999;116;75 i +;56;25;81;SEC_116
1999;231;35-49;90;84;174;SEC_231
1999;421;18-24;56;61;117;SEC_421
1999;407;03-11;19;29;48;SEC_407
1999;422;12-15;12;18;30;SEC_422
1999;122;65-74;46;41;87;SEC_122
1999;102;35-49;152;141;293;SEC_102
1999;313;03-11;76;53;129;SEC_313
1999;440;12-15;14;5;19;SEC_440
1999;247;75 i +;63;33;96;SEC_247
1999;115;35-49;154;147;301;SEC_115
1999;518;25-34;97;119;216;SEC_518
1999;234;50-64;79;68;147;SEC_234
1999;317;18-24;42;50;92;SEC_317
1999;624;50-64;158;180;338;SEC_624
1999;537;00-02;8;11;19;SEC_537
1999;318;12-15;15;25;40;SEC_318
1999;125;12-15;23;21;44;SEC_125
1999;608;16-17;10;8;18;SEC_608
1999;406;18-24;81;81;162;SEC_406
1999;441;50-64;180;179;359;SEC_441
1999;224;18-24;31;25;56;SEC_224
1999;230;65-74;64;44;108;SEC_230
1999;503;35-49;138;111;249;SEC_503
1999;206;50-64;87;69;156;SEC_206
1999;131;18-24;102;110;212;SEC_131
1999;307;16-17;19;18;37;SEC_307
1999;304;25-34;103;100;203;SEC_304
1999;428;25-34;50;50;100;SEC_428
1999;538;75 i +;57;31;88;SEC_538
1999;312;25-34;145;199;344;SEC_312
1999;527;12-15;12;19;31;SEC_527
1999;528;35-49;80;87;167;SEC_528
1999;213;50-64;88;92;180;SEC_213
1999;509;18-24;47;35;82;SEC_509
1999;520;35-49;80;63;143;SEC_520
1999;410;25-34;126;114;240;SEC_410
1999;630;16-17;21;15;36;SEC_630
1999;520;75 i +;40;25;65;SEC_520
1999;233;03-11;22;18;40;SEC_233
1999;206;25-34;69;74;143;SEC_206
1999;205;18-24;48;52;100;SEC_205
1999;314;16-17;47;41;88;SEC_314
1999;137;03-11;55;55;110;SEC_137
1999;226;50-64;92;94;186;SEC_226
1999;303;16-17;12;19;31;SEC_303
1999;114;65-74;65;62;127;SEC_114
1999;502;35-49;149;134;283;SEC_502
1999;217;03-11;16;15;31;SEC_217
1999;213;65-74;58;48;106;SEC_213
1999;619;18-24;93;96;189;SEC_619
1999;214;18-24;25;30;55;SEC_214
1999;531;16-17;2;6;8;SEC_531
1999;111;50-64;115;97;212;SEC_111
1999;128;25-34;101;90;191;SEC_128
1999;524;18-24;65;59;124;SEC_524
1999;421;16-17;11;8;19;SEC_421
1999;501;00-02;8;12;20;SEC_501
1999;502;12-15;26;32;58;SEC_502
1999;310;25-34;71;73;144;SEC_310
1999;132;18-24;133;166;299;SEC_132
1999;131;16-17;30;15;45;SEC_131
1999;125;18-24;78;104;182;SEC_125
1999;604;12-15;12;16;28;SEC_604
1999;605;18-24;38;50;88;SEC_605
1999;504;50-64;157;153;310;SEC_504
1999;213;00-02;6;8;14;SEC_213
1999;123;25-34;108;99;207;SEC_123
1999;249;25-34;75;89;164;SEC_249
1999;511;25-34;58;66;124;SEC_511
1999;125;03-11;40;43;83;SEC_125
1999;426;35-49;83;78;161;SEC_426
1999;534;25-34;77;100;177;SEC_534
1999;610;12-15;17;27;44;SEC_610
1999;226;75 i +;71;38;109;SEC_226
1999;228;16-17;3;4;7;SEC_228
1999;524;75 i +;52;22;74;SEC_524
1999;624;75 i +;28;11;39;SEC_624
1999;218;50-64;75;63;138;SEC_218
1999;223;00-02;9;8;17;SEC_223
1999;529;25-34;98;97;195;SEC_529
1999;309;00-02;6;12;18;SEC_309
1999;323;03-11;141;137;278;SEC_323
1999;621;35-49;205;154;359;SEC_621
1999;602;03-11;24;15;39;SEC_602
1999;531;00-02;6;11;17;SEC_531
1999;240;16-17;7;7;14;SEC_240
1999;417;12-15;9;9;18;SEC_417
1999;132;12-15;50;51;101;SEC_132
1999;616;18-24;207;221;428;SEC_616
1999;609;75 i +;28;11;39;SEC_609
1999;417;00-02;8;2;10;SEC_417
1999;429;18-24;34;44;78;SEC_429
1999;414;16-17;7;11;18;SEC_414
1999;307;75 i +;43;28;71;SEC_307
1999;524;50-64;117;95;212;SEC_524
1999;516;25-34;71;62;133;SEC_516
1999;601;35-49;133;132;265;SEC_601
1999;240;00-02;5;6;11;SEC_240
1999;119;75 i +;42;37;79;SEC_119
1999;247;03-11;28;36;64;SEC_247
1999;517;00-02;13;6;19;SEC_517
1999;630;00-02;2;12;14;SEC_630
1999;433;18-24;44;62;106;SEC_433
1999;314;65-74;68;55;123;SEC_314
1999;138;16-17;13;18;31;SEC_138
1999;305;50-64;103;117;220;SEC_305
1999;604;03-11;27;34;61;SEC_604
1999;219;18-24;43;43;86;SEC_219
1999;527;03-11;43;27;70;SEC_527
1999;501;75 i +;20;11;31;SEC_501
1999;436;75 i +;30;22;52;SEC_436
1999;627;25-34;80;95;175;SEC_627
1999;118;25-34;121;141;262;SEC_118
1999;524;03-11;37;43;80;SEC_524
1999;411;18-24;60;57;117;SEC_411
1999;414;00-02;7;9;16;SEC_414
1999;306;00-02;14;21;35;SEC_306
1999;401;65-74;108;87;195;SEC_401
1999;611;35-49;112;136;248;SEC_611
1999;107;50-64;192;188;380;SEC_107
1999;203;75 i +;53;26;79;SEC_203
1999;415;18-24;35;33;68;SEC_415
1999;211;25-34;108;115;223;SEC_211
1999;612;00-02;9;8;17;SEC_612
1999;323;35-49;434;403;837;SEC_323
1999;615;16-17;9;3;12;SEC_615
1999;249;75 i +;56;32;88;SEC_249
1999;129;65-74;45;32;77;SEC_129
1999;402;18-24;35;37;72;SEC_402
1999;221;00-02;12;10;22;SEC_221
1999;604;65-74;29;30;59;SEC_604
1999;535;50-64;145;150;295;SEC_535
1999;534;35-49;78;74;152;SEC_534
1999;410;18-24;86;103;189;SEC_410
1999;204;12-15;6;12;18;SEC_204
1999;425;35-49;76;80;156;SEC_425
1999;319;12-15;16;18;34;SEC_319
1999;129;18-24;65;63;128;SEC_129
1999;615;00-02;5;5;10;SEC_615
1999;621;16-17;24;37;61;SEC_621
1999;311;25-34;114;146;260;SEC_311
1999;302;03-11;51;51;102;SEC_302
1999;533;65-74;60;63;123;SEC_533
1999;523;03-11;29;44;73;SEC_523
1999;315;00-02;12;20;32;SEC_315
1999;603;12-15;7;14;21;SEC_603
1999;240;25-34;64;58;122;SEC_240
1999;235;75 i +;69;44;113;SEC_235
1999;417;25-34;57;58;115;SEC_417
1999;241;25-34;61;56;117;SEC_241
1999;316;16-17;62;65;127;SEC_316
1999;425;18-24;50;33;83;SEC_425
1999;530;35-49;108;108;216;SEC_530
1999;608;50-64;104;75;179;SEC_608
1999;132;25-34;165;170;335;SEC_132
1999;102;75 i +;77;37;114;SEC_102
1999;437;16-17;6;9;15;SEC_437
1999;135;18-24;86;106;192;SEC_135
1999;416;65-74;58;57;115;SEC_416
1999;506;35-49;232;194;426;SEC_506
1999;610;16-17;9;13;22;SEC_610
1999;237;00-02;14;9;23;SEC_237
1999;618;03-11;13;20;33;SEC_618
1999;225;50-64;55;41;96;SEC_225
1999;406;03-11;42;37;79;SEC_406
1999;232;35-49;98;78;176;SEC_232
1999;124;25-34;62;58;120;SEC_124
1999;408;03-11;25;19;44;SEC_408
1999;314;00-02;25;28;53;SEC_314
1999;416;16-17;4;7;11;SEC_416
1999;441;16-17;32;26;58;SEC_441
1999;401;50-64;105;92;197;SEC_401
1999;606;18-24;51;51;102;SEC_606
1999;242;25-34;83;84;167;SEC_242
1999;223;18-24;41;38;79;SEC_223
1999;123;03-11;41;55;96;SEC_123
1999;629;35-49;68;56;124;SEC_629
1999;631;75 i +;32;20;52;SEC_631
1999;609;25-34;85;108;193;SEC_609
1999;411;16-17;20;8;28;SEC_411
1999;245;00-02;10;12;22;SEC_245
1999;317;12-15;14;14;28;SEC_317
1999;317;50-64;59;63;122;SEC_317
1999;105;35-49;173;137;310;SEC_105
1999;318;03-11;45;45;90;SEC_318
1999;440;50-64;167;150;317;SEC_440
1999;210;25-34;62;66;128;SEC_210
1999;532;65-74;84;75;159;SEC_532
1999;204;25-34;48;40;88;SEC_204
1999;112;65-74;52;51;103;SEC_112
1999;527;16-17;13;6;19;SEC_527
1999;601;03-11;45;48;93;SEC_601
1999;228;65-74;44;36;80;SEC_228
1999;235;16-17;10;7;17;SEC_235
1999;311;18-24;70;77;147;SEC_311
1999;115;18-24;68;89;157;SEC_115
1999;517;50-64;94;90;184;SEC_517
1999;604;25-34;65;89;154;SEC_604
1999;415;12-15;9;11;20;SEC_415
1999;616;25-34;212;233;445;SEC_616
1999;138;75 i +;19;12;31;SEC_138
1999;207;75 i +;55;33;88;SEC_207
1999;427;03-11;16;29;45;SEC_427
1999;434;50-64;40;42;82;SEC_434
1999;528;25-34;117;118;235;SEC_528
1999;439;18-24;40;40;80;SEC_439
1999;419;65-74;37;36;73;SEC_419
1999;126;65-74;70;48;118;SEC_126
1999;429;75 i +;32;27;59;SEC_429
1999;537;03-11;44;28;72;SEC_537
1999;243;35-49;139;133;272;SEC_243
1999;529;50-64;121;124;245;SEC_529
1999;228;03-11;20;18;38;SEC_228
1999;514;25-34;54;52;106;SEC_514
1999;211;75 i +;85;44;129;SEC_211
1999;517;25-34;99;99;198;SEC_517
1999;114;18-24;110;114;224;SEC_114
1999;319;65-74;32;28;60;SEC_319
1999;231;03-11;29;32;61;SEC_231
1999;613;16-17;10;5;15;SEC_613
1999;409;75 i +;23;10;33;SEC_409
1999;311;35-49;125;108;233;SEC_311
1999;439;75 i +;42;21;63;SEC_439
1999;625;75 i +;16;8;24;SEC_625
1999;110;16-17;16;12;28;SEC_110
1999;103;16-17;14;9;23;SEC_103
1999;510;12-15;15;17;32;SEC_510
1999;410;12-15;25;20;45;SEC_410
1999;305;18-24;75;75;150;SEC_305
1999;227;00-02;8;6;14;SEC_227
1999;309;12-15;11;9;20;SEC_309
1999;209;12-15;10;9;19;SEC_209
1999;244;50-64;54;46;100;SEC_244
1999;523;65-74;88;74;162;SEC_523
1999;603;00-02;8;3;11;SEC_603
1999;401;75 i +;36;17;53;SEC_401
1999;513;18-24;39;37;76;SEC_513
1999;313;00-02;24;26;50;SEC_313
