AnyPadro;Seccio;GrupEdat;Dones;Homes;Total;IdSeccio
1998;423;00-02;6;10;16;SEC_423
1998;315;65-74;51;33;84;SEC_315
1998;522;00-02;5;5;10;SEC_522
1998;242;75 i +;48;46;94;SEC_242
1998;243;35-49;137;125;262;SEC_243
1998;211;65-74;96;76;172;SEC_211
1998;528;00-02;10;11;21;SEC_528
1998;426;00-02;10;10;20;SEC_426
1998;302;16-17;17;20;37;SEC_302
1998;506;75 i +;56;30;86;SEC_506
1998;630;50-64;93;104;197;SEC_630
1998;219;65-74;76;64;140;SEC_219
1998;404;75 i +;55;30;85;SEC_404
1998;320;65-74;24;11;35;SEC_320
1998;530;03-11;47;39;86;SEC_530
1998;508;16-17;11;7;18;SEC_508
1998;439;35-49;59;67;126;SEC_439
1998;322;35-49;121;118;239;SEC_322
1998;624;00-02;11;10;21;SEC_624
1998;405;00-02;9;9;18;SEC_405
1998;402;03-11;20;20;40;SEC_402
1998;612;35-49;68;77;145;SEC_612
1998;114;18-24;110;117;227;SEC_114
1998;428;00-02;4;4;8;SEC_428
1998;620;00-02;3;4;7;SEC_620
1998;234;16-17;8;10;18;SEC_234
1998;242;35-49;84;90;174;SEC_242
1998;219;00-02;13;12;25;SEC_219
1998;239;75 i +;60;36;96;SEC_239
1998;311;03-11;36;47;83;SEC_311
1998;118;50-64;135;160;295;SEC_118
1998;306;35-49;180;171;351;SEC_306
1998;245;16-17;16;8;24;SEC_245
1998;131;03-11;60;53;113;SEC_131
1998;103;12-15;18;15;33;SEC_103
1998;245;50-64;87;75;162;SEC_245
1998;441;35-49;257;252;509;SEC_441
1998;306;25-34;112;107;219;SEC_306
1998;319;00-02;5;9;14;SEC_319
1998;302;03-11;50;48;98;SEC_302
1998;520;00-02;7;11;18;SEC_520
1998;243;65-74;102;87;189;SEC_243
1998;218;03-11;17;24;41;SEC_218
1998;315;25-34;125;123;248;SEC_315
1998;234;65-74;86;55;141;SEC_234
1998;521;12-15;24;20;44;SEC_521
1998;314;25-34;174;175;349;SEC_314
1998;532;16-17;10;15;25;SEC_532
1998;110;16-17;16;14;30;SEC_110
1998;323;75 i +;43;13;56;SEC_323
1998;504;18-24;81;106;187;SEC_504
1998;214;35-49;49;52;101;SEC_214
1998;607;03-11;32;32;64;SEC_607
1998;432;50-64;139;149;288;SEC_432
1998;615;18-24;75;86;161;SEC_615
1998;530;75 i +;64;28;92;SEC_530
1998;103;25-34;58;60;118;SEC_103
1998;433;25-34;105;110;215;SEC_433
1998;130;50-64;114;92;206;SEC_130
1998;232;35-49;80;68;148;SEC_232
1998;620;03-11;20;26;46;SEC_620
1998;428;50-64;42;38;80;SEC_428
1998;123;00-02;10;15;25;SEC_123
1998;212;65-74;76;68;144;SEC_212
1998;521;25-34;81;92;173;SEC_521
1998;430;00-02;9;10;19;SEC_430
1998;437;12-15;18;18;36;SEC_437
1998;241;16-17;4;5;9;SEC_241
1998;422;65-74;89;70;159;SEC_422
1998;632;12-15;19;30;49;SEC_632
1998;414;03-11;25;32;57;SEC_414
1998;630;12-15;22;21;43;SEC_630
1998;437;75 i +;21;17;38;SEC_437
1998;418;50-64;126;118;244;SEC_418
1998;120;12-15;34;44;78;SEC_120
1998;307;16-17;30;26;56;SEC_307
1998;427;25-34;73;71;144;SEC_427
1998;535;75 i +;36;20;56;SEC_535
1998;419;18-24;34;55;89;SEC_419
1998;434;18-24;33;20;53;SEC_434
1998;534;75 i +;45;22;67;SEC_534
1998;221;12-15;16;25;41;SEC_221
1998;107;03-11;54;53;107;SEC_107
1998;625;16-17;35;35;70;SEC_625
1998;113;35-49;209;184;393;SEC_113
1998;507;65-74;37;36;73;SEC_507
1998;529;65-74;87;68;155;SEC_529
1998;629;35-49;66;55;121;SEC_629
1998;417;75 i +;21;13;34;SEC_417
1998;428;75 i +;28;18;46;SEC_428
1998;223;35-49;75;85;160;SEC_223
1998;316;03-11;117;121;238;SEC_316
1998;111;12-15;18;16;34;SEC_111
1998;501;65-74;17;24;41;SEC_501
1998;319;65-74;30;25;55;SEC_319
1998;612;65-74;49;46;95;SEC_612
1998;129;25-34;108;109;217;SEC_129
1998;534;35-49;79;80;159;SEC_534
1998;423;65-74;65;45;110;SEC_423
1998;405;25-34;81;89;170;SEC_405
1998;105;50-64;76;99;175;SEC_105
1998;437;65-74;47;38;85;SEC_437
1998;509;03-11;23;27;50;SEC_509
1998;302;18-24;125;126;251;SEC_302
1998;526;12-15;9;14;23;SEC_526
1998;134;25-34;109;99;208;SEC_134
1998;114;12-15;32;36;68;SEC_114
1998;219;16-17;4;19;23;SEC_219
1998;316;25-34;100;84;184;SEC_316
1998;522;16-17;10;10;20;SEC_522
1998;626;03-11;39;33;72;SEC_626
1998;305;25-34;90;102;192;SEC_305
1998;324;75 i +;49;19;68;SEC_324
1998;228;12-15;5;9;14;SEC_228
1998;140;18-24;63;61;124;SEC_140
1998;614;50-64;137;125;262;SEC_614
1998;623;35-49;165;137;302;SEC_623
1998;129;12-15;27;21;48;SEC_129
1998;503;12-15;28;24;52;SEC_503
1998;247;25-34;91;107;198;SEC_247
1998;418;25-34;87;105;192;SEC_418
1998;237;18-24;62;62;124;SEC_237
1998;422;18-24;37;43;80;SEC_422
1998;307;75 i +;41;22;63;SEC_307
1998;420;16-17;8;14;22;SEC_420
1998;105;35-49;184;145;329;SEC_105
1998;530;65-74;114;78;192;SEC_530
1998;418;12-15;21;28;49;SEC_418
1998;417;12-15;9;14;23;SEC_417
1998;530;00-02;10;16;26;SEC_530
1998;228;16-17;6;1;7;SEC_228
1998;247;65-74;85;71;156;SEC_247
1998;431;25-34;100;101;201;SEC_431
1998;407;03-11;20;29;49;SEC_407
1998;618;00-02;2;5;7;SEC_618
1998;523;35-49;104;114;218;SEC_523
1998;402;25-34;50;74;124;SEC_402
1998;516;12-15;10;3;13;SEC_516
1998;617;25-34;104;129;233;SEC_617
1998;535;18-24;86;104;190;SEC_535
1998;232;50-64;95;87;182;SEC_232
1998;235;25-34;120;114;234;SEC_235
1998;102;75 i +;81;37;118;SEC_102
1998;106;75 i +;42;25;67;SEC_106
1998;533;16-17;6;6;12;SEC_533
1998;417;35-49;54;60;114;SEC_417
1998;133;00-02;3;11;14;SEC_133
1998;516;16-17;8;4;12;SEC_516
1998;628;65-74;47;39;86;SEC_628
1998;238;16-17;9;8;17;SEC_238
1998;433;18-24;41;60;101;SEC_433
1998;325;35-49;190;169;359;SEC_325
1998;202;65-74;42;42;84;SEC_202
1998;406;65-74;66;75;141;SEC_406
1998;226;35-49;105;91;196;SEC_226
1998;407;18-24;41;49;90;SEC_407
1998;517;75 i +;54;28;82;SEC_517
1998;426;35-49;80;82;162;SEC_426
1998;121;16-17;5;5;10;SEC_121
1998;622;00-02;5;14;19;SEC_622
1998;311;00-02;11;10;21;SEC_311
1998;237;12-15;19;12;31;SEC_237
1998;212;25-34;127;107;234;SEC_212
1998;249;18-24;43;56;99;SEC_249
1998;442;25-34;57;48;105;SEC_442
1998;409;75 i +;20;10;30;SEC_409
1998;426;25-34;78;82;160;SEC_426
1998;614;18-24;64;76;140;SEC_614
1998;233;35-49;57;61;118;SEC_233
1998;138;25-34;58;65;123;SEC_138
1998;230;16-17;3;5;8;SEC_230
1998;507;75 i +;34;23;57;SEC_507
1998;115;75 i +;42;24;66;SEC_115
1998;623;75 i +;43;29;72;SEC_623
1998;234;03-11;19;30;49;SEC_234
1998;605;00-02;1;5;6;SEC_605
1998;416;18-24;28;35;63;SEC_416
1998;441;00-02;10;13;23;SEC_441
1998;413;18-24;26;33;59;SEC_413
1998;428;12-15;9;8;17;SEC_428
1998;315;03-11;53;61;114;SEC_315
1998;133;16-17;12;8;20;SEC_133
1998;110;75 i +;48;24;72;SEC_110
1998;217;75 i +;47;16;63;SEC_217
1998;204;12-15;7;10;17;SEC_204
1998;121;03-11;34;24;58;SEC_121
1998;237;50-64;137;125;262;SEC_237
1998;616;16-17;37;38;75;SEC_616
1998;322;50-64;96;100;196;SEC_322
1998;608;12-15;22;27;49;SEC_608
1998;538;12-15;18;17;35;SEC_538
1998;228;25-34;67;59;126;SEC_228
1998;608;18-24;62;81;143;SEC_608
1998;108;18-24;50;67;117;SEC_108
1998;114;00-02;21;21;42;SEC_114
1998;525;25-34;82;79;161;SEC_525
1998;124;25-34;54;63;117;SEC_124
1998;315;00-02;13;19;32;SEC_315
1998;403;65-74;65;55;120;SEC_403
1998;511;65-74;61;52;113;SEC_511
1998;522;75 i +;31;24;55;SEC_522
1998;123;65-74;82;70;152;SEC_123
1998;603;18-24;41;60;101;SEC_603
1998;117;75 i +;52;23;75;SEC_117
1998;101;00-02;13;20;33;SEC_101
1998;136;25-34;98;89;187;SEC_136
1998;314;75 i +;66;32;98;SEC_314
1998;240;03-11;15;24;39;SEC_240
1998;212;16-17;10;10;20;SEC_212
1998;531;16-17;6;11;17;SEC_531
1998;316;18-24;142;170;312;SEC_316
1998;524;03-11;37;42;79;SEC_524
1998;116;35-49;182;153;335;SEC_116
1998;622;12-15;22;19;41;SEC_622
1998;101;25-34;110;115;225;SEC_101
1998;439;03-11;36;28;64;SEC_439
1998;125;50-64;111;140;251;SEC_125
1998;417;00-02;9;6;15;SEC_417
1998;112;16-17;25;14;39;SEC_112
1998;311;12-15;15;14;29;SEC_311
1998;240;25-34;55;60;115;SEC_240
1998;115;25-34;99;112;211;SEC_115
1998;313;65-74;77;71;148;SEC_313
1998;201;18-24;35;37;72;SEC_201
1998;522;03-11;20;18;38;SEC_522
1998;124;65-74;44;35;79;SEC_124
1998;244;25-34;57;61;118;SEC_244
1998;601;18-24;101;127;228;SEC_601
1998;244;65-74;55;38;93;SEC_244
1998;138;00-02;4;7;11;SEC_138
1998;213;35-49;94;91;185;SEC_213
1998;405;65-74;82;64;146;SEC_405
1998;224;75 i +;41;14;55;SEC_224
1998;628;50-64;132;152;284;SEC_628
1998;625;75 i +;17;7;24;SEC_625
1998;428;03-11;19;15;34;SEC_428
1998;526;75 i +;30;15;45;SEC_526
1998;314;16-17;37;39;76;SEC_314
1998;404;03-11;54;37;91;SEC_404
1998;511;16-17;3;6;9;SEC_511
1998;304;03-11;33;50;83;SEC_304
1998;136;50-64;99;93;192;SEC_136
1998;520;65-74;50;56;106;SEC_520
1998;533;00-02;11;3;14;SEC_533
1998;218;65-74;46;33;79;SEC_218
1998;311;65-74;91;72;163;SEC_311
1998;414;00-02;4;11;15;SEC_414
1998;630;18-24;83;91;174;SEC_630
1998;129;18-24;83;72;155;SEC_129
1998;533;25-34;84;96;180;SEC_533
1998;242;50-64;114;103;217;SEC_242
1998;537;16-17;9;16;25;SEC_537
1998;432;16-17;16;22;38;SEC_432
1998;243;12-15;22;12;34;SEC_243
1998;248;03-11;31;34;65;SEC_248
1998;236;18-24;52;38;90;SEC_236
1998;631;75 i +;28;18;46;SEC_631
1998;516;25-34;66;57;123;SEC_516
1998;120;18-24;93;93;186;SEC_120
1998;109;75 i +;46;25;71;SEC_109
1998;225;75 i +;39;38;77;SEC_225
1998;421;00-02;7;14;21;SEC_421
1998;437;18-24;43;38;81;SEC_437
1998;517;03-11;38;38;76;SEC_517
1998;123;12-15;23;21;44;SEC_123
1998;607;18-24;50;56;106;SEC_607
1998;440;00-02;9;8;17;SEC_440
1998;515;16-17;5;0;5;SEC_515
1998;124;50-64;82;78;160;SEC_124
1998;203;25-34;61;59;120;SEC_203
1998;622;18-24;68;73;141;SEC_622
1998;501;12-15;24;21;45;SEC_501
1998;213;50-64;87;97;184;SEC_213
1998;209;00-02;7;7;14;SEC_209
1998;115;16-17;23;19;42;SEC_115
1998;238;12-15;12;14;26;SEC_238
1998;305;00-02;9;16;25;SEC_305
1998;140;16-17;8;5;13;SEC_140
1998;436;16-17;6;7;13;SEC_436
1998;422;03-11;31;41;72;SEC_422
1998;304;16-17;9;7;16;SEC_304
1998;215;50-64;85;61;146;SEC_215
1998;618;25-34;45;66;111;SEC_618
1998;523;16-17;18;19;37;SEC_523
1998;123;35-49;130;126;256;SEC_123
1998;431;12-15;26;28;54;SEC_431
1998;106;65-74;55;38;93;SEC_106
1998;320;50-64;86;80;166;SEC_320
1998;520;25-34;71;66;137;SEC_520
1998;308;50-64;149;152;301;SEC_308
1998;220;35-49;58;65;123;SEC_220
1998;430;35-49;63;75;138;SEC_430
1998;403;35-49;101;88;189;SEC_403
1998;520;12-15;17;18;35;SEC_520
1998;439;00-02;11;12;23;SEC_439
1998;211;16-17;6;13;19;SEC_211
1998;532;00-02;16;9;25;SEC_532
1998;617;16-17;13;21;34;SEC_617
1998;632;16-17;15;23;38;SEC_632
1998;425;75 i +;47;25;72;SEC_425
1998;208;25-34;110;141;251;SEC_208
1998;504;12-15;20;15;35;SEC_504
1998;233;16-17;6;3;9;SEC_233
1998;610;25-34;123;144;267;SEC_610
1998;139;25-34;84;71;155;SEC_139
1998;115;12-15;26;32;58;SEC_115
1998;519;65-74;40;42;82;SEC_519
1998;234;12-15;12;10;22;SEC_234
1998;235;12-15;16;10;26;SEC_235
1998;218;00-02;8;4;12;SEC_218
1998;135;75 i +;46;20;66;SEC_135
1998;207;50-64;70;50;120;SEC_207
1998;129;75 i +;38;20;58;SEC_129
1998;426;65-74;59;50;109;SEC_426
1998;204;00-02;4;4;8;SEC_204
1998;418;35-49;97;98;195;SEC_418
1998;416;16-17;9;8;17;SEC_416
1998;509;25-34;67;75;142;SEC_509
1998;616;75 i +;28;17;45;SEC_616
1998;441;50-64;181;183;364;SEC_441
1998;305;18-24;69;68;137;SEC_305
1998;614;75 i +;35;14;49;SEC_614
1998;210;00-02;6;3;9;SEC_210
1998;407;65-74;89;77;166;SEC_407
1998;411;00-02;8;7;15;SEC_411
1998;232;65-74;80;54;134;SEC_232
1998;631;50-64;155;175;330;SEC_631
1998;318;65-74;22;17;39;SEC_318
1998;241;75 i +;44;30;74;SEC_241
1998;135;16-17;20;26;46;SEC_135
1998;324;00-02;11;10;21;SEC_324
1998;125;75 i +;27;23;50;SEC_125
1998;604;18-24;48;61;109;SEC_604
1998;419;75 i +;40;20;60;SEC_419
1998;627;50-64;100;117;217;SEC_627
1998;325;18-24;116;123;239;SEC_325
1998;507;12-15;17;17;34;SEC_507
1998;246;03-11;30;28;58;SEC_246
1998;511;25-34;59;75;134;SEC_511
1998;527;35-49;74;102;176;SEC_527
1998;227;65-74;59;46;105;SEC_227
1998;522;18-24;31;44;75;SEC_522
1998;207;03-11;19;16;35;SEC_207
1998;132;18-24;147;164;311;SEC_132
1998;106;03-11;69;70;139;SEC_106
1998;124;18-24;54;49;103;SEC_124
1998;312;75 i +;42;32;74;SEC_312
1998;407;16-17;6;9;15;SEC_407
1998;501;75 i +;21;11;32;SEC_501
1998;430;18-24;49;39;88;SEC_430
1998;437;35-49;75;75;150;SEC_437
1998;132;03-11;83;76;159;SEC_132
1998;611;75 i +;51;32;83;SEC_611
1998;405;35-49;47;66;113;SEC_405
1998;419;35-49;55;70;125;SEC_419
1998;241;18-24;33;21;54;SEC_241
1998;131;12-15;31;32;63;SEC_131
1998;221;75 i +;42;29;71;SEC_221
1998;245;35-49;97;90;187;SEC_245
1998;408;25-34;69;88;157;SEC_408
1998;102;50-64;206;215;421;SEC_102
1998;103;03-11;24;24;48;SEC_103
1998;325;00-02;19;14;33;SEC_325
1998;248;65-74;79;56;135;SEC_248
1998;408;75 i +;33;17;50;SEC_408
1998;402;35-49;71;66;137;SEC_402
1998;238;35-49;56;70;126;SEC_238
1998;506;18-24;172;175;347;SEC_506
1998;118;25-34;124;128;252;SEC_118
1998;321;25-34;177;179;356;SEC_321
1998;620;25-34;60;54;114;SEC_620
1998;510;50-64;113;115;228;SEC_510
1998;435;16-17;7;10;17;SEC_435
1998;202;18-24;42;42;84;SEC_202
1998;309;35-49;89;69;158;SEC_309
1998;322;75 i +;38;20;58;SEC_322
1998;404;25-34;103;126;229;SEC_404
1998;537;18-24;76;80;156;SEC_537
1998;211;25-34;106;106;212;SEC_211
1998;531;18-24;38;50;88;SEC_531
1998;204;75 i +;28;17;45;SEC_204
1998;232;03-11;24;22;46;SEC_232
1998;520;35-49;84;67;151;SEC_520
1998;529;16-17;9;14;23;SEC_529
1998;427;16-17;9;5;14;SEC_427
1998;124;00-02;6;9;15;SEC_124
1998;128;65-74;47;42;89;SEC_128
1998;248;75 i +;60;42;102;SEC_248
1998;234;75 i +;83;33;116;SEC_234
1998;201;25-34;58;65;123;SEC_201
1998;520;50-64;90;98;188;SEC_520
1998;140;00-02;5;7;12;SEC_140
1998;225;00-02;4;4;8;SEC_225
1998;205;75 i +;32;19;51;SEC_205
1998;514;18-24;36;39;75;SEC_514
1998;119;25-34;102;110;212;SEC_119
1998;114;75 i +;56;19;75;SEC_114
1998;302;50-64;143;175;318;SEC_302
1998;220;16-17;11;5;16;SEC_220
1998;241;35-49;62;63;125;SEC_241
1998;626;65-74;55;63;118;SEC_626
1998;529;25-34;105;95;200;SEC_529
1998;134;18-24;58;77;135;SEC_134
1998;242;16-17;8;5;13;SEC_242
1998;522;12-15;22;12;34;SEC_522
1998;116;75 i +;55;16;71;SEC_116
1998;237;16-17;10;16;26;SEC_237
1998;606;18-24;46;52;98;SEC_606
1998;241;00-02;9;6;15;SEC_241
1998;618;16-17;7;5;12;SEC_618
1998;609;03-11;25;30;55;SEC_609
1998;226;03-11;33;31;64;SEC_226
1998;621;25-34;127;125;252;SEC_621
1998;434;50-64;46;44;90;SEC_434
1998;442;18-24;31;38;69;SEC_442
1998;510;35-49;88;86;174;SEC_510
1998;325;12-15;25;25;50;SEC_325
1998;223;75 i +;56;27;83;SEC_223
1998;435;18-24;41;52;93;SEC_435
1998;536;03-11;31;22;53;SEC_536
1998;613;35-49;81;73;154;SEC_613
1998;429;35-49;70;66;136;SEC_429
1998;138;50-64;86;70;156;SEC_138
1998;617;03-11;42;45;87;SEC_617
1998;310;50-64;73;71;144;SEC_310
1998;216;35-49;118;111;229;SEC_216
1998;525;35-49;68;71;139;SEC_525
1998;523;25-34;111;108;219;SEC_523
1998;439;75 i +;45;21;66;SEC_439
1998;313;03-11;78;64;142;SEC_313
1998;511;35-49;40;46;86;SEC_511
1998;526;35-49;58;58;116;SEC_526
1998;248;50-64;95;90;185;SEC_248
1998;116;25-34;145;146;291;SEC_116
1998;236;00-02;11;8;19;SEC_236
1998;402;50-64;93;79;172;SEC_402
1998;137;65-74;44;38;82;SEC_137
1998;626;50-64;125;103;228;SEC_626
1998;320;35-49;51;42;93;SEC_320
1998;136;75 i +;48;25;73;SEC_136
1998;632;03-11;48;48;96;SEC_632
1998;411;75 i +;45;24;69;SEC_411
1998;620;18-24;58;43;101;SEC_620
1998;513;50-64;98;86;184;SEC_513
1998;241;50-64;63;59;122;SEC_241
1998;206;25-34;67;72;139;SEC_206
1998;219;75 i +;81;36;117;SEC_219
1998;133;50-64;91;80;171;SEC_133
1998;245;12-15;9;15;24;SEC_245
1998;228;03-11;23;19;42;SEC_228
1998;318;12-15;21;23;44;SEC_318
1998;531;25-34;79;80;159;SEC_531
1998;109;18-24;55;51;106;SEC_109
1998;508;50-64;60;48;108;SEC_508
1998;117;16-17;33;35;68;SEC_117
1998;208;65-74;137;116;253;SEC_208
1998;505;65-74;54;47;101;SEC_505
1998;427;35-49;64;58;122;SEC_427
1998;617;12-15;31;20;51;SEC_617
1998;222;25-34;67;76;143;SEC_222
1998;228;18-24;31;37;68;SEC_228
1998;606;75 i +;32;14;46;SEC_606
1998;107;35-49;174;173;347;SEC_107
1998;441;18-24;125;130;255;SEC_441
1998;308;16-17;11;14;25;SEC_308
1998;525;03-11;23;31;54;SEC_525
1998;249;03-11;22;24;46;SEC_249
1998;231;03-11;29;34;63;SEC_231
1998;249;50-64;105;91;196;SEC_249
1998;225;50-64;54;41;95;SEC_225
1998;240;16-17;9;6;15;SEC_240
1998;425;35-49;75;79;154;SEC_425
1998;536;18-24;44;50;94;SEC_536
1998;626;35-49;110;110;220;SEC_626
1998;204;25-34;43;42;85;SEC_204
1998;423;16-17;7;7;14;SEC_423
1998;304;25-34;101;105;206;SEC_304
1998;309;00-02;6;13;19;SEC_309
1998;139;18-24;57;58;115;SEC_139
1998;439;16-17;3;12;15;SEC_439
1998;514;65-74;39;39;78;SEC_514
1998;528;03-11;45;28;73;SEC_528
1998;503;35-49;140;109;249;SEC_503
1998;621;50-64;152;207;359;SEC_621
1998;128;00-02;4;10;14;SEC_128
1998;314;65-74;63;54;117;SEC_314
1998;202;12-15;11;16;27;SEC_202
1998;239;25-34;91;96;187;SEC_239
1998;211;50-64;89;75;164;SEC_211
1998;609;16-17;9;9;18;SEC_609
1998;513;00-02;7;5;12;SEC_513
1998;609;35-49;75;49;124;SEC_609
1998;505;12-15;22;18;40;SEC_505
1998;615;50-64;164;166;330;SEC_615
1998;112;00-02;19;14;33;SEC_112
1998;105;12-15;23;26;49;SEC_105
1998;533;03-11;29;21;50;SEC_533
1998;116;16-17;32;20;52;SEC_116
1998;507;25-34;82;97;179;SEC_507
1998;433;35-49;84;75;159;SEC_433
1998;109;65-74;55;45;100;SEC_109
1998;622;65-74;46;29;75;SEC_622
1998;319;75 i +;27;18;45;SEC_319
1998;234;00-02;8;7;15;SEC_234
1998;120;16-17;23;20;43;SEC_120
1998;124;12-15;28;23;51;SEC_124
1998;606;16-17;15;11;26;SEC_606
1998;427;65-74;70;58;128;SEC_427
1998;607;65-74;57;52;109;SEC_607
1998;601;50-64;187;176;363;SEC_601
1998;618;75 i +;19;12;31;SEC_618
1998;325;03-11;61;57;118;SEC_325
1998;401;16-17;10;14;24;SEC_401
1998;246;12-15;20;11;31;SEC_246
1998;221;16-17;12;10;22;SEC_221
1998;247;18-24;77;53;130;SEC_247
1998;428;25-34;52;48;100;SEC_428
1998;202;75 i +;32;20;52;SEC_202
1998;406;25-34;99;102;201;SEC_406
1998;506;00-02;23;21;44;SEC_506
1998;242;25-34;86;82;168;SEC_242
1998;324;16-17;4;9;13;SEC_324
1998;302;65-74;55;46;101;SEC_302
1998;607;12-15;11;22;33;SEC_607
1998;111;25-34;75;85;160;SEC_111
1998;312;35-49;132;146;278;SEC_312
1998;208;18-24;80;79;159;SEC_208
1998;320;25-34;54;69;123;SEC_320
1998;504;65-74;60;66;126;SEC_504
1998;206;12-15;14;16;30;SEC_206
1998;623;65-74;50;38;88;SEC_623
1998;215;18-24;33;47;80;SEC_215
1998;514;35-49;65;67;132;SEC_514
1998;508;75 i +;24;21;45;SEC_508
1998;415;35-49;59;66;125;SEC_415
1998;439;18-24;57;39;96;SEC_439
1998;113;18-24;90;92;182;SEC_113
1998;240;00-02;2;6;8;SEC_240
1998;126;12-15;15;16;31;SEC_126
1998;519;03-11;12;26;38;SEC_519
1998;216;25-34;86;94;180;SEC_216
1998;126;18-24;89;84;173;SEC_126
1998;423;75 i +;45;22;67;SEC_423
1998;102;25-34;148;173;321;SEC_102
1998;220;18-24;35;27;62;SEC_220
1998;316;65-74;40;35;75;SEC_316
1998;204;03-11;11;18;29;SEC_204
1998;602;16-17;9;7;16;SEC_602
1998;411;65-74;91;81;172;SEC_411
1998;120;50-64;122;125;247;SEC_120
1998;308;00-02;9;18;27;SEC_308
1998;531;65-74;56;47;103;SEC_531
1998;214;65-74;43;41;84;SEC_214
1998;502;35-49;151;137;288;SEC_502
1998;621;35-49;220;170;390;SEC_621
1998;324;65-74;58;38;96;SEC_324
1998;222;12-15;14;16;30;SEC_222
1998;537;65-74;74;62;136;SEC_537
1998;507;35-49;83;76;159;SEC_507
1998;508;25-34;43;60;103;SEC_508
1998;610;75 i +;36;22;58;SEC_610
1998;413;16-17;4;6;10;SEC_413
1998;309;75 i +;25;12;37;SEC_309
1998;603;00-02;6;4;10;SEC_603
1998;130;65-74;80;64;144;SEC_130
1998;138;16-17;12;17;29;SEC_138
1998;632;18-24;97;97;194;SEC_632
1998;404;65-74;78;63;141;SEC_404
1998;432;35-49;145;124;269;SEC_432
1998;440;65-74;46;51;97;SEC_440
1998;427;50-64;82;53;135;SEC_427
1998;135;25-34;122;122;244;SEC_135
1998;630;00-02;4;14;18;SEC_630
1998;318;16-17;14;13;27;SEC_318
1998;427;18-24;45;51;96;SEC_427
1998;233;25-34;65;69;134;SEC_233
1998;115;03-11;40;61;101;SEC_115
1998;223;65-74;74;63;137;SEC_223
1998;304;18-24;52;66;118;SEC_304
1998;526;65-74;41;34;75;SEC_526
1998;110;00-02;8;7;15;SEC_110
1998;229;75 i +;46;17;63;SEC_229
1998;435;65-74;110;66;176;SEC_435
1998;432;03-11;31;47;78;SEC_432
1998;608;00-02;6;9;15;SEC_608
1998;512;25-34;76;93;169;SEC_512
1998;215;00-02;8;12;20;SEC_215
1998;212;03-11;33;44;77;SEC_212
1998;110;12-15;26;21;47;SEC_110
1998;527;00-02;11;12;23;SEC_527
1998;315;16-17;19;27;46;SEC_315
1998;246;65-74;83;61;144;SEC_246
1998;110;18-24;105;113;218;SEC_110
1998;202;00-02;2;6;8;SEC_202
1998;527;03-11;39;25;64;SEC_527
1998;401;18-24;61;59;120;SEC_401
1998;438;75 i +;35;10;45;SEC_438
1998;209;16-17;4;6;10;SEC_209
1998;219;03-11;36;33;69;SEC_219
1998;306;75 i +;60;40;100;SEC_306
1998;606;50-64;126;100;226;SEC_606
1998;426;75 i +;54;28;82;SEC_426
1998;529;18-24;53;46;99;SEC_529
1998;605;75 i +;20;16;36;SEC_605
1998;101;35-49;148;154;302;SEC_101
1998;536;25-34;83;83;166;SEC_536
1998;537;03-11;44;34;78;SEC_537
1998;217;16-17;10;5;15;SEC_217
1998;208;16-17;16;19;35;SEC_208
1998;128;16-17;15;12;27;SEC_128
1998;239;00-02;5;5;10;SEC_239
1998;314;18-24;139;147;286;SEC_314
1998;217;50-64;39;39;78;SEC_217
1998;106;50-64;137;167;304;SEC_106
1998;224;50-64;48;35;83;SEC_224
1998;625;65-74;27;31;58;SEC_625
1998;528;16-17;9;14;23;SEC_528
1998;429;18-24;42;43;85;SEC_429
1998;103;00-02;12;9;21;SEC_103
1998;620;12-15;15;13;28;SEC_620
1998;630;65-74;30;24;54;SEC_630
1998;619;75 i +;44;26;70;SEC_619
1998;318;18-24;47;56;103;SEC_318
1998;632;00-02;15;15;30;SEC_632
1998;602;12-15;11;12;23;SEC_602
1998;314;00-02;20;24;44;SEC_314
1998;322;65-74;67;53;120;SEC_322
1998;439;25-34;101;94;195;SEC_439
1998;423;35-49;74;82;156;SEC_423
1998;515;03-11;24;24;48;SEC_515
1998;612;16-17;16;11;27;SEC_612
1998;109;03-11;41;44;85;SEC_109
1998;312;00-02;17;13;30;SEC_312
1998;201;65-74;42;47;89;SEC_201
1998;226;75 i +;73;36;109;SEC_226
1998;117;18-24;119;154;273;SEC_117
1998;103;75 i +;47;23;70;SEC_103
1998;226;65-74;86;64;150;SEC_226
1998;102;03-11;54;56;110;SEC_102
1998;320;12-15;6;7;13;SEC_320
1998;310;65-74;38;32;70;SEC_310
1998;401;35-49;113;109;222;SEC_401
1998;112;25-34;121;99;220;SEC_112
1998;417;03-11;23;17;40;SEC_417
1998;222;75 i +;34;20;54;SEC_222
1998;233;12-15;5;11;16;SEC_233
1998;317;03-11;26;37;63;SEC_317
1998;617;75 i +;19;21;40;SEC_617
1998;406;75 i +;54;32;86;SEC_406
1998;513;65-74;47;43;90;SEC_513
1998;425;03-11;25;30;55;SEC_425
1998;222;00-02;6;8;14;SEC_222
1998;409;50-64;86;81;167;SEC_409
1998;431;50-64;114;116;230;SEC_431
1998;139;50-64;76;76;152;SEC_139
1998;121;50-64;75;46;121;SEC_121
1998;512;65-74;47;29;76;SEC_512
1998;245;18-24;35;60;95;SEC_245
1998;625;50-64;116;138;254;SEC_625
1998;239;12-15;12;16;28;SEC_239
1998;134;75 i +;71;30;101;SEC_134
1998;421;75 i +;49;31;80;SEC_421
1998;438;25-34;75;88;163;SEC_438
1998;412;18-24;82;106;188;SEC_412
1998;437;25-34;64;77;141;SEC_437
1998;248;18-24;44;60;104;SEC_248
1998;419;03-11;28;33;61;SEC_419
1998;114;65-74;61;63;124;SEC_114
1998;236;16-17;10;14;24;SEC_236
1998;210;75 i +;54;39;93;SEC_210
1998;302;25-34;124;138;262;SEC_302
1998;623;03-11;44;49;93;SEC_623
1998;139;75 i +;27;10;37;SEC_139
1998;109;25-34;102;89;191;SEC_109
1998;533;50-64;87;83;170;SEC_533
1998;315;12-15;36;32;68;SEC_315
1998;103;65-74;41;31;72;SEC_103
1998;119;03-11;31;49;80;SEC_119
1998;123;50-64;103;110;213;SEC_123
1998;424;65-74;30;34;64;SEC_424
1998;313;75 i +;56;28;84;SEC_313
1998;217;00-02;7;8;15;SEC_217
1998;517;18-24;52;72;124;SEC_517
1998;433;12-15;19;19;38;SEC_433
1998;425;00-02;6;6;12;SEC_425
1998;629;16-17;6;12;18;SEC_629
1998;517;00-02;11;5;16;SEC_517
1998;228;35-49;34;55;89;SEC_228
1998;516;35-49;42;61;103;SEC_516
1998;138;12-15;15;34;49;SEC_138
1998;532;12-15;20;17;37;SEC_532
1998;119;75 i +;41;32;73;SEC_119
1998;627;03-11;24;54;78;SEC_627
1998;107;12-15;31;41;72;SEC_107
1998;413;00-02;3;5;8;SEC_413
1998;525;75 i +;32;26;58;SEC_525
1998;421;18-24;67;64;131;SEC_421
1998;623;12-15;32;34;66;SEC_623
1998;625;00-02;10;8;18;SEC_625
1998;407;12-15;12;22;34;SEC_407
1998;134;12-15;32;30;62;SEC_134
1998;501;00-02;7;14;21;SEC_501
1998;621;65-74;44;34;78;SEC_621
1998;205;35-49;96;91;187;SEC_205
1998;519;75 i +;16;12;28;SEC_519
1998;101;50-64;90;82;172;SEC_101
1998;538;03-11;29;39;68;SEC_538
1998;239;65-74;100;80;180;SEC_239
1998;242;12-15;14;19;33;SEC_242
1998;318;75 i +;9;6;15;SEC_318
1998;440;75 i +;56;33;89;SEC_440
1998;306;16-17;23;15;38;SEC_306
1998;218;16-17;9;7;16;SEC_218
1998;209;03-11;15;39;54;SEC_209
1998;442;65-74;31;25;56;SEC_442
1998;203;18-24;24;32;56;SEC_203
1998;434;75 i +;49;34;83;SEC_434
1998;226;12-15;19;16;35;SEC_226
1998;241;65-74;72;46;118;SEC_241
1998;229;18-24;32;35;67;SEC_229
1998;501;18-24;123;133;256;SEC_501
1998;606;03-11;44;48;92;SEC_606
1998;424;00-02;7;4;11;SEC_424
1998;312;03-11;50;36;86;SEC_312
1998;303;18-24;108;105;213;SEC_303
1998;415;12-15;9;12;21;SEC_415
1998;130;00-02;6;12;18;SEC_130
1998;419;50-64;72;69;141;SEC_419
1998;435;75 i +;91;45;136;SEC_435
1998;616;00-02;26;31;57;SEC_616
1998;113;12-15;41;38;79;SEC_113
1998;532;35-49;113;97;210;SEC_532
1998;304;50-64;113;109;222;SEC_304
1998;311;35-49;129;109;238;SEC_311
1998;438;50-64;111;107;218;SEC_438
1998;112;12-15;36;31;67;SEC_112
1998;503;16-17;17;19;36;SEC_503
1998;125;03-11;38;38;76;SEC_125
1998;119;16-17;21;21;42;SEC_119
1998;309;65-74;29;29;58;SEC_309
1998;234;18-24;30;36;66;SEC_234
1998;529;35-49;82;82;164;SEC_529
1998;504;35-49;97;89;186;SEC_504
1998;405;50-64;121;90;211;SEC_405
1998;210;12-15;8;14;22;SEC_210
1998;107;65-74;75;65;140;SEC_107
1998;417;65-74;40;32;72;SEC_417
1998;137;12-15;28;27;55;SEC_137
1998;233;75 i +;70;35;105;SEC_233
1998;631;65-74;46;44;90;SEC_631
1998;322;25-34;103;104;207;SEC_322
1998;608;50-64;105;79;184;SEC_608
1998;536;65-74;77;68;145;SEC_536
1998;311;16-17;11;14;25;SEC_311
1998;224;25-34;44;53;97;SEC_224
1998;241;12-15;13;9;22;SEC_241
1998;116;00-02;19;16;35;SEC_116
1998;418;16-17;12;5;17;SEC_418
1998;206;65-74;58;56;114;SEC_206
1998;208;35-49;180;169;349;SEC_208
1998;503;65-74;31;16;47;SEC_503
1998;505;50-64;228;228;456;SEC_505
1998;508;65-74;42;35;77;SEC_508
1998;102;18-24;111;134;245;SEC_102
1998;205;50-64;84;71;155;SEC_205
1998;615;75 i +;20;12;32;SEC_615
1998;525;16-17;7;10;17;SEC_525
1998;418;00-02;7;16;23;SEC_418
1998;134;35-49;144;134;278;SEC_134
1998;221;18-24;65;64;129;SEC_221
1998;205;25-34;71;71;142;SEC_205
1998;407;75 i +;33;28;61;SEC_407
1998;408;03-11;30;18;48;SEC_408
1998;123;03-11;46;51;97;SEC_123
1998;441;12-15;72;58;130;SEC_441
1998;206;35-49;71;74;145;SEC_206
1998;313;16-17;37;32;69;SEC_313
1998;611;50-64;228;209;437;SEC_611
1998;126;03-11;25;23;48;SEC_126
1998;227;18-24;43;35;78;SEC_227
1998;315;18-24;93;81;174;SEC_315
1998;209;12-15;8;10;18;SEC_209
1998;434;03-11;23;24;47;SEC_434
1998;126;25-34;99;115;214;SEC_126
1998;627;65-74;26;23;49;SEC_627
1998;201;35-49;55;49;104;SEC_201
1998;128;25-34;87;87;174;SEC_128
1998;315;35-49;176;174;350;SEC_315
1998;624;75 i +;27;12;39;SEC_624
1998;528;35-49;75;83;158;SEC_528
1998;534;18-24;56;70;126;SEC_534
1998;501;50-64;124;152;276;SEC_501
1998;601;35-49;136;128;264;SEC_601
1998;532;50-64;153;153;306;SEC_532
1998;623;18-24;124;141;265;SEC_623
1998;422;50-64;84;80;164;SEC_422
1998;425;65-74;75;67;142;SEC_425
1998;407;50-64;102;87;189;SEC_407
1998;437;16-17;7;9;16;SEC_437
1998;318;00-02;10;14;24;SEC_318
1998;410;75 i +;61;44;105;SEC_410
1998;429;12-15;9;12;21;SEC_429
1998;416;25-34;60;68;128;SEC_416
1998;218;35-49;72;68;140;SEC_218
1998;605;35-49;53;44;97;SEC_605
1998;427;12-15;11;12;23;SEC_427
1998;617;50-64;128;105;233;SEC_617
1998;325;65-74;125;100;225;SEC_325
1998;523;18-24;58;66;124;SEC_523
1998;315;50-64;109;131;240;SEC_315
1998;213;12-15;22;22;44;SEC_213
1998;624;18-24;108;136;244;SEC_624
1998;130;75 i +;62;36;98;SEC_130
1998;425;16-17;12;6;18;SEC_425
1998;135;18-24;82;108;190;SEC_135
1998;510;16-17;10;14;24;SEC_510
1998;220;75 i +;40;19;59;SEC_220
1998;516;00-02;7;10;17;SEC_516
1998;611;65-74;82;68;150;SEC_611
1998;303;65-74;91;105;196;SEC_303
1998;412;65-74;81;87;168;SEC_412
1998;135;03-11;70;54;124;SEC_135
1998;206;50-64;98;77;175;SEC_206
1998;613;75 i +;38;24;62;SEC_613
1998;601;03-11;40;46;86;SEC_601
1998;502;03-11;48;39;87;SEC_502
1998;121;12-15;10;5;15;SEC_121
1998;125;18-24;94;111;205;SEC_125
1998;611;25-34;172;205;377;SEC_611
1998;323;25-34;192;201;393;SEC_323
1998;233;50-64;75;68;143;SEC_233
1998;305;03-11;73;52;125;SEC_305
1998;518;16-17;9;10;19;SEC_518
1998;240;65-74;67;46;113;SEC_240
1998;513;25-34;61;67;128;SEC_513
1998;605;65-74;41;33;74;SEC_605
1998;310;35-49;105;114;219;SEC_310
1998;105;03-11;48;65;113;SEC_105
1998;136;03-11;52;41;93;SEC_136
1998;219;50-64;108;99;207;SEC_219
1998;538;75 i +;56;26;82;SEC_538
1998;127;03-11;49;44;93;SEC_127
1998;201;16-17;4;3;7;SEC_201
1998;102;65-74;88;62;150;SEC_102
1998;120;25-34;110;109;219;SEC_120
1998;131;35-49;182;178;360;SEC_131
1998;514;16-17;7;9;16;SEC_514
1998;405;18-24;48;48;96;SEC_405
1998;116;12-15;40;29;69;SEC_116
1998;124;03-11;29;29;58;SEC_124
1998;518;12-15;14;23;37;SEC_518
1998;525;50-64;98;84;182;SEC_525
1998;103;35-49;88;71;159;SEC_103
1998;301;16-17;21;26;47;SEC_301
1998;205;03-11;29;30;59;SEC_205
1998;227;75 i +;44;22;66;SEC_227
1998;111;50-64;119;107;226;SEC_111
1998;429;03-11;14;23;37;SEC_429
1998;104;03-11;23;20;43;SEC_104
1998;631;03-11;37;27;64;SEC_631
1998;603;03-11;20;28;48;SEC_603
1998;125;12-15;27;22;49;SEC_125
1998;234;50-64;81;71;152;SEC_234
1998;237;00-02;8;9;17;SEC_237
1998;524;00-02;19;19;38;SEC_524
1998;430;12-15;14;13;27;SEC_430
1998;131;00-02;14;10;24;SEC_131
1998;402;65-74;48;62;110;SEC_402
1998;522;50-64;63;59;122;SEC_522
1998;603;16-17;9;10;19;SEC_603
1998;611;16-17;15;19;34;SEC_611
1998;510;00-02;9;4;13;SEC_510
1998;515;18-24;29;29;58;SEC_515
1998;101;65-74;34;42;76;SEC_101
1998;440;50-64;164;152;316;SEC_440
1998;418;75 i +;61;36;97;SEC_418
1998;231;35-49;90;83;173;SEC_231
1998;222;65-74;47;45;92;SEC_222
1998;512;00-02;8;6;14;SEC_512
1998;316;35-49;446;379;825;SEC_316
1998;319;50-64;69;69;138;SEC_319
1998;227;03-11;15;14;29;SEC_227
1998;510;25-34;96;120;216;SEC_510
1998;502;25-34;116;115;231;SEC_502
1998;534;12-15;11;17;28;SEC_534
1998;239;35-49;85;72;157;SEC_239
1998;112;35-49;177;170;347;SEC_112
1998;136;35-49;137;132;269;SEC_136
1998;132;00-02;23;27;50;SEC_132
1998;109;35-49;134;139;273;SEC_109
1998;518;75 i +;52;25;77;SEC_518
1998;227;35-49;57;47;104;SEC_227
1998;208;75 i +;120;70;190;SEC_208
1998;631;16-17;10;15;25;SEC_631
1998;410;12-15;24;26;50;SEC_410
1998;431;00-02;12;17;29;SEC_431
1998;424;35-49;49;49;98;SEC_424
1998;628;25-34;90;88;178;SEC_628
1998;524;18-24;76;58;134;SEC_524
1998;430;16-17;4;8;12;SEC_430
1998;128;50-64;104;102;206;SEC_128
1998;303;03-11;36;35;71;SEC_303
1998;249;35-49;93;87;180;SEC_249
1998;523;65-74;93;75;168;SEC_523
1998;218;25-34;53;59;112;SEC_218
1998;243;18-24;59;51;110;SEC_243
1998;413;03-11;25;20;45;SEC_413
1998;506;16-17;38;30;68;SEC_506
1998;304;00-02;10;13;23;SEC_304
1998;317;75 i +;46;18;64;SEC_317
1998;116;03-11;55;48;103;SEC_116
1998;415;75 i +;44;26;70;SEC_415
1998;619;25-34;120;140;260;SEC_619
1998;308;65-74;72;55;127;SEC_308
1998;607;16-17;13;12;25;SEC_607
1998;414;16-17;6;10;16;SEC_414
1998;406;50-64;144;132;276;SEC_406
1998;505;75 i +;41;27;68;SEC_505
1998;214;16-17;6;8;14;SEC_214
1998;521;50-64;143;195;338;SEC_521
1998;207;65-74;59;34;93;SEC_207
1998;535;12-15;29;38;67;SEC_535
1998;325;75 i +;132;70;202;SEC_325
1998;402;16-17;5;10;15;SEC_402
1998;228;75 i +;35;18;53;SEC_228
1998;605;18-24;41;54;95;SEC_605
1998;403;16-17;17;15;32;SEC_403
1998;232;12-15;10;15;25;SEC_232
1998;237;65-74;89;61;150;SEC_237
1998;206;00-02;3;9;12;SEC_206
1998;532;75 i +;68;42;110;SEC_532
1998;217;03-11;15;17;32;SEC_217
1998;619;35-49;164;141;305;SEC_619
1998;613;65-74;62;50;112;SEC_613
1998;134;16-17;11;14;25;SEC_134
1998;619;18-24;99;98;197;SEC_619
1998;318;25-34;67;64;131;SEC_318
1998;230;12-15;8;13;21;SEC_230
1998;139;16-17;17;19;36;SEC_139
1998;535;65-74;37;36;73;SEC_535
1998;512;12-15;19;14;33;SEC_512
1998;107;50-64;195;189;384;SEC_107
1998;625;25-34;84;97;181;SEC_625
1998;108;12-15;27;20;47;SEC_108
1998;420;12-15;18;22;40;SEC_420
1998;613;12-15;14;18;32;SEC_613
1998;601;12-15;25;31;56;SEC_601
1998;135;65-74;65;57;122;SEC_135
1998;114;03-11;54;36;90;SEC_114
1998;602;00-02;7;8;15;SEC_602
1998;216;50-64;146;120;266;SEC_216
1998;245;25-34;70;90;160;SEC_245
1998;243;03-11;50;51;101;SEC_243
1998;135;50-64;138;146;284;SEC_135
1998;221;00-02;8;6;14;SEC_221
1998;413;25-34;43;47;90;SEC_413
1998;226;18-24;64;58;122;SEC_226
1998;133;12-15;16;19;35;SEC_133
1998;441;25-34;119;123;242;SEC_441
1998;236;03-11;33;28;61;SEC_236
1998;402;75 i +;41;25;66;SEC_402
1998;249;25-34;87;95;182;SEC_249
1998;220;03-11;20;27;47;SEC_220
1998;235;50-64;150;123;273;SEC_235
1998;509;12-15;15;10;25;SEC_509
1998;320;75 i +;19;8;27;SEC_320
1998;203;00-02;5;8;13;SEC_203
1998;206;18-24;36;46;82;SEC_206
1998;113;00-02;11;12;23;SEC_113
1998;409;18-24;41;40;81;SEC_409
1998;310;12-15;34;25;59;SEC_310
1998;515;35-49;59;43;102;SEC_515
1998;603;12-15;9;11;20;SEC_603
1998;412;50-64;184;176;360;SEC_412
1998;609;50-64;142;141;283;SEC_609
1998;520;75 i +;39;27;66;SEC_520
1998;519;16-17;5;9;14;SEC_519
1998;620;35-49;68;61;129;SEC_620
1998;202;50-64;82;73;155;SEC_202
1998;231;25-34;89;80;169;SEC_231
1998;240;35-49;56;51;107;SEC_240
1998;316;75 i +;26;16;42;SEC_316
1998;602;75 i +;25;15;40;SEC_602
1998;214;25-34;57;71;128;SEC_214
1998;510;65-74;61;46;107;SEC_510
1998;609;75 i +;28;9;37;SEC_609
1998;528;50-64;141;128;269;SEC_528
1998;502;16-17;26;17;43;SEC_502
1998;310;75 i +;21;15;36;SEC_310
1998;203;65-74;57;46;103;SEC_203
1998;216;16-17;11;10;21;SEC_216
1998;602;18-24;37;27;64;SEC_602
1998;223;03-11;38;40;78;SEC_223
1998;237;25-34;105;125;230;SEC_237
1998;120;75 i +;43;23;66;SEC_120
1998;213;65-74;59;51;110;SEC_213
1998;121;75 i +;42;24;66;SEC_121
1998;538;50-64;139;116;255;SEC_538
1998;323;12-15;76;63;139;SEC_323
1998;107;00-02;13;20;33;SEC_107
1998;427;00-02;3;4;7;SEC_427
1998;104;35-49;71;58;129;SEC_104
1998;209;50-64;93;86;179;SEC_209
1998;205;16-17;6;9;15;SEC_205
1998;241;25-34;58;53;111;SEC_241
1998;415;50-64;54;54;108;SEC_415
1998;317;16-17;4;9;13;SEC_317
1998;115;00-02;13;15;28;SEC_115
1998;105;16-17;17;22;39;SEC_105
1998;433;75 i +;43;18;61;SEC_433
1998;225;35-49;43;38;81;SEC_225
1998;618;18-24;54;46;100;SEC_618
1998;202;25-34;56;79;135;SEC_202
1998;312;50-64;207;182;389;SEC_312
1998;420;18-24;54;71;125;SEC_420
1998;131;50-64;129;151;280;SEC_131
1998;214;75 i +;38;17;55;SEC_214
1998;618;50-64;71;85;156;SEC_618
1998;311;75 i +;83;36;119;SEC_311
1998;509;16-17;10;7;17;SEC_509
1998;109;50-64;91;96;187;SEC_109
1998;237;03-11;38;32;70;SEC_237
1998;212;35-49;102;117;219;SEC_212
1998;204;16-17;2;4;6;SEC_204
1998;222;18-24;40;51;91;SEC_222
1998;308;18-24;91;94;185;SEC_308
1998;616;65-74;46;37;83;SEC_616
1998;432;65-74;70;59;129;SEC_432
1998;247;16-17;7;8;15;SEC_247
1998;409;65-74;35;33;68;SEC_409
1998;521;16-17;18;13;31;SEC_521
1998;316;50-64;150;182;332;SEC_316
1998;106;35-49;281;246;527;SEC_106
1998;321;65-74;84;75;159;SEC_321
1998;138;75 i +;18;12;30;SEC_138
1998;538;18-24;67;60;127;SEC_538
1998;616;03-11;79;87;166;SEC_616
1998;235;03-11;32;27;59;SEC_235
1998;605;50-64;116;100;216;SEC_605
1998;214;03-11;18;18;36;SEC_214
1998;615;00-02;5;5;10;SEC_615
1998;303;12-15;16;26;42;SEC_303
1998;520;03-11;32;23;55;SEC_520
1998;132;35-49;258;228;486;SEC_132
1998;440;25-34;82;103;185;SEC_440
1998;302;00-02;12;15;27;SEC_302
1998;310;03-11;33;34;67;SEC_310
1998;223;00-02;9;6;15;SEC_223
1998;423;50-64;132;119;251;SEC_423
1998;214;50-64;69;59;128;SEC_214
1998;105;65-74;50;36;86;SEC_105
1998;619;12-15;25;42;67;SEC_619
1998;442;50-64;69;61;130;SEC_442
1998;532;18-24;74;86;160;SEC_532
1998;247;12-15;10;20;30;SEC_247
1998;306;00-02;15;13;28;SEC_306
1998;433;00-02;8;20;28;SEC_433
1998;305;35-49;203;187;390;SEC_305
1998;233;65-74;53;38;91;SEC_233
1998;239;50-64;122;87;209;SEC_239
1998;108;25-34;106;99;205;SEC_108
1998;232;18-24;48;45;93;SEC_232
1998;220;50-64;80;59;139;SEC_220
1998;136;12-15;28;23;51;SEC_136
1998;502;12-15;35;29;64;SEC_502
1998;441;16-17;25;28;53;SEC_441
1998;225;25-34;33;28;61;SEC_225
1998;524;35-49;88;109;197;SEC_524
1998;245;00-02;10;12;22;SEC_245
1998;608;16-17;17;8;25;SEC_608
1998;429;16-17;7;14;21;SEC_429
1998;325;50-64;198;179;377;SEC_325
1998;229;03-11;18;18;36;SEC_229
1998;412;00-02;10;7;17;SEC_412
1998;629;03-11;25;19;44;SEC_629
1998;511;00-02;8;4;12;SEC_511
1998;519;35-49;40;46;86;SEC_519
1998;207;12-15;7;8;15;SEC_207
1998;413;12-15;7;9;16;SEC_413
1998;133;35-49;95;82;177;SEC_133
1998;512;50-64;108;106;214;SEC_512
1998;422;25-34;75;80;155;SEC_422
1998;106;16-17;38;33;71;SEC_106
1998;534;00-02;8;8;16;SEC_534
1998;133;03-11;23;32;55;SEC_133
1998;113;16-17;31;22;53;SEC_113
1998;244;18-24;32;16;48;SEC_244
1998;608;65-74;50;44;94;SEC_608
1998;505;16-17;19;14;33;SEC_505
1998;314;12-15;78;86;164;SEC_314
1998;312;65-74;57;43;100;SEC_312
1998;205;18-24;48;54;102;SEC_205
1998;503;18-24;65;77;142;SEC_503
1998;223;18-24;43;44;87;SEC_223
1998;613;03-11;42;35;77;SEC_613
1998;415;03-11;22;17;39;SEC_415
1998;518;25-34;97;113;210;SEC_518
1998;424;16-17;3;9;12;SEC_424
1998;127;16-17;12;10;22;SEC_127
1998;304;35-49;99;102;201;SEC_304
1998;111;03-11;45;28;73;SEC_111
1998;221;50-64;110;112;222;SEC_221
1998;514;25-34;60;53;113;SEC_514
1998;112;18-24;91;90;181;SEC_112
1998;606;00-02;9;10;19;SEC_606
1998;510;75 i +;43;28;71;SEC_510
1998;324;03-11;40;33;73;SEC_324
1998;519;00-02;8;9;17;SEC_519
1998;137;35-49;167;147;314;SEC_137
1998;136;16-17;18;23;41;SEC_136
1998;521;75 i +;37;21;58;SEC_521
1998;213;16-17;12;15;27;SEC_213
1998;630;35-49;122;99;221;SEC_630
1998;303;75 i +;68;40;108;SEC_303
1998;536;50-64;106;97;203;SEC_536
1998;630;25-34;60;80;140;SEC_630
1998;233;00-02;4;7;11;SEC_233
1998;224;35-49;61;61;122;SEC_224
1998;309;03-11;26;34;60;SEC_309
1998;101;03-11;60;67;127;SEC_101
1998;221;35-49;110;90;200;SEC_221
1998;525;12-15;15;19;34;SEC_525
1998;408;12-15;16;15;31;SEC_408
1998;317;18-24;46;52;98;SEC_317
1998;521;03-11;27;27;54;SEC_521
1998;405;12-15;13;7;20;SEC_405
1998;238;03-11;19;20;39;SEC_238
1998;109;00-02;8;16;24;SEC_109
1998;228;00-02;3;7;10;SEC_228
1998;122;50-64;130;115;245;SEC_122
1998;410;65-74;111;107;218;SEC_410
1998;106;25-34;146;142;288;SEC_106
1998;201;50-64;87;74;161;SEC_201
1998;140;25-34;77;96;173;SEC_140
1998;408;35-49;90;86;176;SEC_408
1998;127;75 i +;30;13;43;SEC_127
1998;611;00-02;12;14;26;SEC_611
1998;618;12-15;7;15;22;SEC_618
1998;409;12-15;12;10;22;SEC_409
1998;303;35-49;109;108;217;SEC_303
1998;437;00-02;10;5;15;SEC_437
1998;533;65-74;58;56;114;SEC_533
1998;501;25-34;86;100;186;SEC_501
1998;622;50-64;69;75;144;SEC_622
1998;301;25-34;188;200;388;SEC_301
1998;619;00-02;6;21;27;SEC_619
1998;130;18-24;33;44;77;SEC_130
1998;132;16-17;22;40;62;SEC_132
1998;509;35-49;71;61;132;SEC_509
1998;418;03-11;33;33;66;SEC_418
1998;421;65-74;74;78;152;SEC_421
1998;140;35-49;80;68;148;SEC_140
1998;621;18-24;164;193;357;SEC_621
1998;320;18-24;37;49;86;SEC_320
1998;532;65-74;84;75;159;SEC_532
1998;518;00-02;5;9;14;SEC_518
1998;609;18-24;82;70;152;SEC_609
1998;247;35-49;99;109;208;SEC_247
1998;604;65-74;30;27;57;SEC_604
1998;512;18-24;39;53;92;SEC_512
1998;324;35-49;78;82;160;SEC_324
1998;215;03-11;24;19;43;SEC_215
1998;503;03-11;42;48;90;SEC_503
1998;442;12-15;9;12;21;SEC_442
1998;108;35-49;143;125;268;SEC_108
1998;240;12-15;9;13;22;SEC_240
1998;210;03-11;27;23;50;SEC_210
1998;111;00-02;3;12;15;SEC_111
1998;509;65-74;36;31;67;SEC_509
1998;248;16-17;6;16;22;SEC_248
1998;604;03-11;25;34;59;SEC_604
1998;132;65-74;70;66;136;SEC_132
1998;216;03-11;24;33;57;SEC_216
1998;430;50-64;88;91;179;SEC_430
1998;521;35-49;136;91;227;SEC_521
1998;225;18-24;21;32;53;SEC_225
1998;507;16-17;10;11;21;SEC_507
1998;214;18-24;37;31;68;SEC_214
1998;627;18-24;103;106;209;SEC_627
1998;626;25-34;92;120;212;SEC_626
1998;535;16-17;16;13;29;SEC_535
1998;219;35-49;107;100;207;SEC_219
1998;240;50-64;64;66;130;SEC_240
1998;313;18-24;128;117;245;SEC_313
1998;614;35-49;86;75;161;SEC_614
1998;416;12-15;9;10;19;SEC_416
1998;405;03-11;29;22;51;SEC_405
1998;507;50-64;89;105;194;SEC_507
1998;320;03-11;16;21;37;SEC_320
1998;513;35-49;49;53;102;SEC_513
1998;138;35-49;113;109;222;SEC_138
1998;220;00-02;6;6;12;SEC_220
1998;429;50-64;58;58;116;SEC_429
1998;242;00-02;11;10;21;SEC_242
1998;419;65-74;42;36;78;SEC_419
1998;235;16-17;9;15;24;SEC_235
1998;419;12-15;14;11;25;SEC_419
1998;430;65-74;57;51;108;SEC_430
1998;621;03-11;69;59;128;SEC_621
1998;227;00-02;6;10;16;SEC_227
1998;506;50-64;205;228;433;SEC_506
1998;517;65-74;64;52;116;SEC_517
1998;412;16-17;32;29;61;SEC_412
1998;410;03-11;46;46;92;SEC_410
1998;308;75 i +;59;38;97;SEC_308
1998;230;50-64;68;70;138;SEC_230
1998;413;50-64;56;49;105;SEC_413
1998;123;75 i +;65;39;104;SEC_123
1998;301;18-24;137;132;269;SEC_301
1998;606;65-74;68;64;132;SEC_606
1998;230;75 i +;40;22;62;SEC_230
1998;249;65-74;76;67;143;SEC_249
1998;425;25-34;90;76;166;SEC_425
1998;432;00-02;5;11;16;SEC_432
1998;616;12-15;67;64;131;SEC_616
1998;401;00-02;7;16;23;SEC_401
1998;214;00-02;6;4;10;SEC_214
1998;417;50-64;68;57;125;SEC_417
1998;501;16-17;25;32;57;SEC_501
1998;128;03-11;28;39;67;SEC_128
1998;115;50-64;113;124;237;SEC_115
1998;410;50-64;208;198;406;SEC_410
1998;510;12-15;15;16;31;SEC_510
1998;418;65-74;69;51;120;SEC_418
1998;519;25-34;61;48;109;SEC_519
1998;212;12-15;22;26;48;SEC_212
1998;531;50-64;85;85;170;SEC_531
1998;224;12-15;10;14;24;SEC_224
1998;423;18-24;56;58;114;SEC_423
1998;129;03-11;44;33;77;SEC_129
1998;218;75 i +;38;15;53;SEC_218
1998;310;25-34;66;71;137;SEC_310
1998;530;25-34;113;127;240;SEC_530
1998;414;12-15;16;26;42;SEC_414
1998;619;50-64;162;166;328;SEC_619
1998;442;75 i +;34;21;55;SEC_442
1998;421;50-64;144;115;259;SEC_421
1998;126;65-74;66;47;113;SEC_126
1998;128;75 i +;32;19;51;SEC_128
1998;508;35-49;50;54;104;SEC_508
1998;305;50-64;103;111;214;SEC_305
1998;419;00-02;13;13;26;SEC_419
1998;428;16-17;4;3;7;SEC_428
1998;438;12-15;18;7;25;SEC_438
1998;316;16-17;61;61;122;SEC_316
1998;524;50-64;124;102;226;SEC_524
1998;508;03-11;22;21;43;SEC_508
1998;103;16-17;16;8;24;SEC_103
1998;435;35-49;70;103;173;SEC_435
1998;129;50-64;121;127;248;SEC_129
1998;516;18-24;28;35;63;SEC_516
1998;318;03-11;47;55;102;SEC_318
1998;614;00-02;10;9;19;SEC_614
1998;108;75 i +;80;38;118;SEC_108
1998;208;50-64;205;162;367;SEC_208
1998;323;18-24;203;202;405;SEC_323
1998;439;12-15;8;20;28;SEC_439
1998;108;16-17;9;11;20;SEC_108
1998;515;00-02;5;9;14;SEC_515
1998;207;35-49;70;65;135;SEC_207
1998;309;50-64;61;63;124;SEC_309
1998;603;35-49;50;49;99;SEC_603
1998;117;12-15;61;62;123;SEC_117
1998;421;35-49;82;71;153;SEC_421
1998;438;18-24;48;46;94;SEC_438
1998;608;03-11;35;49;84;SEC_608
1998;222;50-64;79;79;158;SEC_222
1998;401;65-74;106;82;188;SEC_401
1998;434;25-34;33;38;71;SEC_434
1998;506;03-11;79;98;177;SEC_506
1998;137;75 i +;37;13;50;SEC_137
1998;626;75 i +;23;17;40;SEC_626
1998;312;18-24;86;80;166;SEC_312
1998;237;75 i +;68;36;104;SEC_237
1998;628;16-17;13;20;33;SEC_628
1998;118;18-24;154;172;326;SEC_118
1998;628;18-24;93;112;205;SEC_628
1998;438;00-02;9;3;12;SEC_438
1998;425;50-64;93;88;181;SEC_425
1998;623;25-34;139;149;288;SEC_623
1998;421;03-11;30;33;63;SEC_421
1998;413;75 i +;38;12;50;SEC_413
1998;616;25-34;159;171;330;SEC_616
1998;138;65-74;33;34;67;SEC_138
1998;321;75 i +;75;44;119;SEC_321
1998;210;18-24;44;45;89;SEC_210
1998;248;25-34;105;101;206;SEC_248
1998;243;50-64;139;116;255;SEC_243
1998;612;75 i +;40;18;58;SEC_612
1998;249;16-17;10;10;20;SEC_249
1998;127;18-24;32;46;78;SEC_127
1998;122;25-34;80;92;172;SEC_122
1998;317;00-02;17;10;27;SEC_317
1998;203;12-15;8;13;21;SEC_203
1998;321;16-17;46;47;93;SEC_321
1998;611;03-11;66;58;124;SEC_611
1998;120;00-02;15;25;40;SEC_120
1998;133;75 i +;42;27;69;SEC_133
1998;127;50-64;54;48;102;SEC_127
1998;511;03-11;11;22;33;SEC_511
1998;120;03-11;80;81;161;SEC_120
1998;412;03-11;46;52;98;SEC_412
1998;423;03-11;27;28;55;SEC_423
1998;224;00-02;4;6;10;SEC_224
1998;510;03-11;29;36;65;SEC_510
1998;537;25-34;112;102;214;SEC_537
1998;632;35-49;99;97;196;SEC_632
1998;120;65-74;56;46;102;SEC_120
1998;513;12-15;11;9;20;SEC_513
1998;246;25-34;93;91;184;SEC_246
1998;511;50-64;68;64;132;SEC_511
1998;134;03-11;35;58;93;SEC_134
1998;537;12-15;23;22;45;SEC_537
1998;224;03-11;14;22;36;SEC_224
1998;229;12-15;7;14;21;SEC_229
1998;306;50-64;122;113;235;SEC_306
1998;601;16-17;28;17;45;SEC_601
1998;210;35-49;75;81;156;SEC_210
1998;424;50-64;71;67;138;SEC_424
1998;501;03-11;38;35;73;SEC_501
1998;209;75 i +;80;40;120;SEC_209
1998;527;65-74;68;42;110;SEC_527
1998;402;18-24;44;39;83;SEC_402
1998;223;50-64;122;107;229;SEC_223
1998;118;35-49;256;223;479;SEC_118
1998;248;35-49;96;104;200;SEC_248
1998;504;00-02;8;9;17;SEC_504
1998;235;75 i +;66;43;109;SEC_235
1998;224;18-24;27;28;55;SEC_224
1998;618;65-74;26;20;46;SEC_618
1998;119;50-64;153;164;317;SEC_119
1998;518;03-11;36;37;73;SEC_518
1998;244;75 i +;36;30;66;SEC_244
1998;211;18-24;34;52;86;SEC_211
1998;521;18-24;107;129;236;SEC_521
1998;308;35-49;149;141;290;SEC_308
1998;114;16-17;29;21;50;SEC_114
1998;604;00-02;9;10;19;SEC_604
1998;208;00-02;9;6;15;SEC_208
1998;425;12-15;14;12;26;SEC_425
1998;522;25-34;45;50;95;SEC_522
1998;215;16-17;7;6;13;SEC_215
1998;617;18-24;70;95;165;SEC_617
1998;506;65-74;70;70;140;SEC_506
1998;604;16-17;6;9;15;SEC_604
1998;616;35-49;220;227;447;SEC_616
1998;404;35-49;111;118;229;SEC_404
1998;401;50-64;111;99;210;SEC_401
1998;301;12-15;38;59;97;SEC_301
1998;245;65-74;70;50;120;SEC_245
1998;313;50-64;162;155;317;SEC_313
1998;422;75 i +;59;40;99;SEC_422
1998;504;03-11;22;31;53;SEC_504
1998;606;12-15;20;19;39;SEC_606
1998;629;18-24;42;42;84;SEC_629
1998;434;16-17;4;6;10;SEC_434
1998;242;65-74;96;81;177;SEC_242
1998;302;12-15;26;26;52;SEC_302
1998;502;18-24;97;107;204;SEC_502
1998;136;65-74;60;55;115;SEC_136
1998;602;25-34;74;90;164;SEC_602
1998;312;25-34;136;192;328;SEC_312
1998;210;16-17;4;3;7;SEC_210
1998;510;18-24;65;51;116;SEC_510
1998;211;03-11;41;38;79;SEC_211
1998;217;35-49;63;67;130;SEC_217
1998;104;12-15;7;6;13;SEC_104
1998;211;12-15;15;16;31;SEC_211
1998;436;18-24;55;44;99;SEC_436
1998;433;16-17;12;10;22;SEC_433
1998;136;18-24;65;76;141;SEC_136
1998;435;03-11;41;38;79;SEC_435
1998;426;12-15;12;11;23;SEC_426
1998;130;16-17;8;9;17;SEC_130
1998;112;50-64;135;134;269;SEC_112
1998;521;00-02;5;10;15;SEC_521
1998;224;16-17;7;8;15;SEC_224
1998;116;18-24;120;119;239;SEC_116
1998;307;18-24;114;105;219;SEC_307
1998;614;25-34;96;98;194;SEC_614
1998;217;65-74;45;35;80;SEC_217
1998;409;16-17;16;10;26;SEC_409
1998;529;12-15;12;15;27;SEC_529
1998;507;03-11;29;25;54;SEC_507
1998;121;65-74;96;79;175;SEC_121
1998;111;18-24;50;84;134;SEC_111
1998;615;65-74;30;28;58;SEC_615
1998;611;12-15;23;18;41;SEC_611
1998;509;50-64;80;88;168;SEC_509
1998;538;00-02;8;11;19;SEC_538
1998;207;00-02;7;6;13;SEC_207
1998;206;03-11;30;27;57;SEC_206
1998;204;18-24;23;21;44;SEC_204
1998;319;35-49;109;97;206;SEC_319
1998;322;12-15;26;18;44;SEC_322
1998;434;00-02;6;5;11;SEC_434
1998;137;16-17;22;12;34;SEC_137
1998;225;65-74;52;33;85;SEC_225
1998;138;03-11;27;44;71;SEC_138
1998;631;25-34;108;110;218;SEC_631
1998;244;35-49;56;64;120;SEC_244
1998;424;12-15;10;13;23;SEC_424
1998;514;75 i +;32;13;45;SEC_514
1998;127;00-02;8;11;19;SEC_127
1998;236;25-34;70;83;153;SEC_236
1998;246;35-49;86;98;184;SEC_246
1998;603;50-64;84;74;158;SEC_603
1998;535;35-49;124;111;235;SEC_535
1998;507;18-24;60;64;124;SEC_507
1998;249;00-02;8;8;16;SEC_249
1998;426;03-11;23;36;59;SEC_426
1998;117;35-49;270;247;517;SEC_117
1998;204;35-49;41;48;89;SEC_204
1998;245;75 i +;71;35;106;SEC_245
1998;617;00-02;12;14;26;SEC_617
1998;219;18-24;51;49;100;SEC_219
1998;536;35-49;65;67;132;SEC_536
1998;527;18-24;45;39;84;SEC_527
1998;442;16-17;6;5;11;SEC_442
1998;524;16-17;12;15;27;SEC_524
1998;307;12-15;36;32;68;SEC_307
1998;631;00-02;10;10;20;SEC_631
1998;536;00-02;7;9;16;SEC_536
1998;127;65-74;43;37;80;SEC_127
1998;410;16-17;20;15;35;SEC_410
1998;518;50-64;133;110;243;SEC_518
1998;233;03-11;23;18;41;SEC_233
1998;624;25-34;94;119;213;SEC_624
1998;128;18-24;75;72;147;SEC_128
1998;221;25-34;99;90;189;SEC_221
1998;215;65-74;76;56;132;SEC_215
1998;410;35-49;152;141;293;SEC_410
1998;415;18-24;30;28;58;SEC_415
1998;612;18-24;81;95;176;SEC_612
1998;210;65-74;89;61;150;SEC_210
1998;526;50-64;58;67;125;SEC_526
1998;604;35-49;62;69;131;SEC_604
1998;118;12-15;57;57;114;SEC_118
1998;104;00-02;9;5;14;SEC_104
1998;132;50-64;175;222;397;SEC_132
1998;609;12-15;14;18;32;SEC_609
1998;119;65-74;69;60;129;SEC_119
1998;301;50-64;220;220;440;SEC_301
1998;522;35-49;69;53;122;SEC_522
1998;202;03-11;16;16;32;SEC_202
1998;137;18-24;94;88;182;SEC_137
1998;440;16-17;13;8;21;SEC_440
1998;129;35-49;98;107;205;SEC_129
1998;514;50-64;80;65;145;SEC_514
1998;307;65-74;76;67;143;SEC_307
1998;618;03-11;18;21;39;SEC_618
1998;102;00-02;14;21;35;SEC_102
1998;518;35-49;73;88;161;SEC_518
1998;205;00-02;15;12;27;SEC_205
1998;505;18-24;116;101;217;SEC_505
1998;429;00-02;1;4;5;SEC_429
1998;248;00-02;12;8;20;SEC_248
1998;311;25-34;126;145;271;SEC_311
1998;414;50-64;91;86;177;SEC_414
1998;213;25-34;63;71;134;SEC_213
1998;306;18-24;74;83;157;SEC_306
1998;243;00-02;6;17;23;SEC_243
1998;242;18-24;35;40;75;SEC_242
1998;504;75 i +;54;35;89;SEC_504
1998;610;65-74;59;50;109;SEC_610
1998;403;03-11;26;31;57;SEC_403
1998;138;18-24;52;53;105;SEC_138
1998;414;75 i +;37;24;61;SEC_414
1998;538;16-17;7;12;19;SEC_538
1998;632;75 i +;26;10;36;SEC_632
1998;302;35-49;177;133;310;SEC_302
1998;307;35-49;212;186;398;SEC_307
1998;106;12-15;57;53;110;SEC_106
1998;118;16-17;26;36;62;SEC_118
1998;118;65-74;46;36;82;SEC_118
1998;601;75 i +;62;26;88;SEC_601
1998;625;03-11;53;67;120;SEC_625
1998;535;00-02;4;2;6;SEC_535
1998;140;50-64;127;116;243;SEC_140
1998;305;65-74;88;63;151;SEC_305
1998;323;03-11;124;130;254;SEC_323
1998;530;16-17;6;10;16;SEC_530
1998;223;16-17;9;9;18;SEC_223
1998;313;00-02;18;20;38;SEC_313
1998;116;50-64;168;178;346;SEC_116
1998;622;03-11;38;47;85;SEC_622
1998;411;35-49;93;83;176;SEC_411
1998;615;16-17;5;4;9;SEC_615
1998;535;25-34;54;95;149;SEC_535
1998;506;35-49;237;198;435;SEC_506
1998;303;50-64;229;204;433;SEC_303
1998;432;12-15;20;24;44;SEC_432
1998;227;50-64;67;61;128;SEC_227
1998;231;18-24;51;46;97;SEC_231
1998;505;03-11;43;32;75;SEC_505
1998;229;50-64;65;64;129;SEC_229
1998;420;75 i +;66;39;105;SEC_420
1998;620;75 i +;13;4;17;SEC_620
1998;614;65-74;48;44;92;SEC_614
1998;101;75 i +;24;8;32;SEC_101
1998;305;12-15;40;37;77;SEC_305
1998;523;00-02;9;9;18;SEC_523
1998;626;18-24;78;94;172;SEC_626
1998;626;16-17;10;12;22;SEC_626
1998;529;00-02;8;12;20;SEC_529
1998;201;00-02;5;10;15;SEC_201
1998;102;35-49;149;132;281;SEC_102
1998;122;65-74;48;37;85;SEC_122
1998;424;03-11;16;9;25;SEC_424
1998;305;75 i +;71;40;111;SEC_305
1998;628;35-49;116;85;201;SEC_628
1998;609;25-34;78;99;177;SEC_609
1998;114;50-64;216;187;403;SEC_114
1998;406;12-15;23;35;58;SEC_406
1998;226;00-02;3;6;9;SEC_226
1998;109;16-17;14;17;31;SEC_109
1998;430;25-34;76;71;147;SEC_430
1998;614;03-11;25;46;71;SEC_614
1998;536;12-15;7;13;20;SEC_536
1998;314;50-64;145;164;309;SEC_314
1998;515;65-74;33;26;59;SEC_515
1998;203;50-64;66;69;135;SEC_203
1998;223;25-34;93;93;186;SEC_223
1998;309;16-17;9;10;19;SEC_309
1998;117;03-11;73;70;143;SEC_117
1998;532;03-11;38;31;69;SEC_532
1998;622;16-17;16;21;37;SEC_622
1998;627;25-34;73;85;158;SEC_627
1998;301;35-49;150;177;327;SEC_301
1998;422;00-02;9;11;20;SEC_422
1998;125;65-74;53;40;93;SEC_125
1998;203;03-11;13;20;33;SEC_203
1998;401;75 i +;35;16;51;SEC_401
1998;126;50-64;155;163;318;SEC_126
1998;316;00-02;12;22;34;SEC_316
1998;525;65-74;52;41;93;SEC_525
1998;313;12-15;55;40;95;SEC_313
1998;309;18-24;46;51;97;SEC_309
1998;109;12-15;23;25;48;SEC_109
1998;118;03-11;78;64;142;SEC_118
1998;134;00-02;12;13;25;SEC_134
1998;442;00-02;8;4;12;SEC_442
1998;231;12-15;12;10;22;SEC_231
1998;105;00-02;7;19;26;SEC_105
1998;519;50-64;63;49;112;SEC_519
1998;206;75 i +;64;34;98;SEC_206
1998;415;25-34;67;66;133;SEC_415
1998;528;12-15;13;14;27;SEC_528
1998;435;50-64;84;68;152;SEC_435
1998;205;12-15;21;16;37;SEC_205
1998;106;00-02;17;23;40;SEC_106
1998;404;18-24;64;58;122;SEC_404
1998;604;25-34;66;88;154;SEC_604
1998;314;03-11;96;122;218;SEC_314
1998;538;25-34;110;106;216;SEC_538
1998;244;12-15;6;7;13;SEC_244
1998;605;25-34;75;78;153;SEC_605
1998;417;18-24;40;33;73;SEC_417
1998;629;65-74;39;34;73;SEC_629
1998;238;00-02;2;4;6;SEC_238
1998;126;00-02;9;8;17;SEC_126
1998;247;03-11;38;39;77;SEC_247
1998;216;65-74;77;67;144;SEC_216
1998;210;25-34;62;63;125;SEC_210
1998;607;50-64;163;143;306;SEC_607
1998;227;12-15;7;10;17;SEC_227
1998;122;75 i +;42;27;69;SEC_122
1998;536;16-17;11;8;19;SEC_536
1998;321;03-11;85;105;190;SEC_321
1998;219;12-15;18;22;40;SEC_219
1998;405;75 i +;31;22;53;SEC_405
1998;607;35-49;82;94;176;SEC_607
1998;436;50-64;69;67;136;SEC_436
1998;528;75 i +;38;25;63;SEC_528
1998;104;75 i +;59;33;92;SEC_104
1998;410;25-34;131;114;245;SEC_410
1998;212;50-64;142;118;260;SEC_212
1998;440;12-15;17;6;23;SEC_440
1998;226;25-34;66;67;133;SEC_226
1998;212;75 i +;63;34;97;SEC_212
1998;231;50-64;95;85;180;SEC_231
1998;236;65-74;92;69;161;SEC_236
1998;615;35-49;62;40;102;SEC_615
1998;131;18-24;104;127;231;SEC_131
1998;617;35-49;107;102;209;SEC_617
1998;123;25-34;105;104;209;SEC_123
1998;612;12-15;16;22;38;SEC_612
1998;117;00-02;27;21;48;SEC_117
1998;102;16-17;19;14;33;SEC_102
1998;219;25-34;87;92;179;SEC_219
1998;310;16-17;13;15;28;SEC_310
1998;301;03-11;70;84;154;SEC_301
1998;629;25-34;51;63;114;SEC_629
1998;130;25-34;87;102;189;SEC_130
1998;243;25-34;132;129;261;SEC_243
1998;422;16-17;9;10;19;SEC_422
1998;243;16-17;13;12;25;SEC_243
1998;523;50-64;140;131;271;SEC_523
1998;527;50-64;93;83;176;SEC_527
1998;631;35-49;115;72;187;SEC_631
1998;417;25-34;56;59;115;SEC_417
1998;533;75 i +;41;21;62;SEC_533
1998;119;00-02;12;12;24;SEC_119
1998;125;00-02;6;7;13;SEC_125
1998;119;12-15;35;29;64;SEC_119
1998;624;65-74;36;39;75;SEC_624
1998;509;18-24;42;47;89;SEC_509
1998;527;16-17;10;10;20;SEC_527
1998;107;16-17;24;26;50;SEC_107
1998;212;00-02;10;16;26;SEC_212
1998;322;18-24;67;82;149;SEC_322
1998;127;25-34;67;75;142;SEC_127
1998;324;50-64;73;70;143;SEC_324
1998;416;35-49;51;58;109;SEC_416
1998;516;50-64;67;58;125;SEC_516
1998;616;18-24;189;193;382;SEC_616
1998;535;03-11;34;34;68;SEC_535
1998;122;00-02;10;9;19;SEC_122
1998;436;25-34;70;89;159;SEC_436
1998;626;12-15;17;22;39;SEC_626
1998;127;12-15;25;16;41;SEC_127
1998;507;00-02;8;12;20;SEC_507
1998;625;35-49;214;187;401;SEC_625
1998;107;25-34;148;184;332;SEC_107
1998;205;65-74;55;50;105;SEC_205
1998;130;35-49;67;79;146;SEC_130
1998;514;00-02;8;9;17;SEC_514
1998;412;12-15;36;35;71;SEC_412
1998;511;12-15;5;8;13;SEC_511
1998;323;65-74;59;39;98;SEC_323
1998;508;12-15;12;14;26;SEC_508
1998;121;35-49;53;74;127;SEC_121
1998;238;50-64;72;62;134;SEC_238
1998;211;00-02;12;12;24;SEC_211
1998;525;18-24;42;53;95;SEC_525
1998;406;00-02;9;14;23;SEC_406
1998;433;03-11;44;36;80;SEC_433
1998;104;50-64;81;74;155;SEC_104
1998;139;03-11;27;36;63;SEC_139
1998;229;35-49;49;48;97;SEC_229
1998;524;75 i +;49;26;75;SEC_524
1998;420;65-74;90;68;158;SEC_420
1998;234;35-49;76;69;145;SEC_234
1998;428;35-49;44;43;87;SEC_428
1998;314;35-49;330;334;664;SEC_314
1998;230;00-02;13;13;26;SEC_230
1998;601;65-74;58;61;119;SEC_601
1998;621;12-15;29;49;78;SEC_621
1998;137;25-34;116;101;217;SEC_137
1998;531;12-15;9;17;26;SEC_531
1998;421;12-15;9;18;27;SEC_421
1998;137;03-11;50;54;104;SEC_137
1998;512;16-17;6;7;13;SEC_512
1998;631;18-24;97;126;223;SEC_631
1998;132;75 i +;55;25;80;SEC_132
1998;306;12-15;35;33;68;SEC_306
1998;416;03-11;20;20;40;SEC_416
1998;126;35-49;80;68;148;SEC_126
1998;230;18-24;41;29;70;SEC_230
1998;223;12-15;12;18;30;SEC_223
1998;113;03-11;64;75;139;SEC_113
1998;247;50-64;97;93;190;SEC_247
1998;319;12-15;17;24;41;SEC_319
1998;121;25-34;88;87;175;SEC_121
1998;504;25-34;99;112;211;SEC_504
1998;431;65-74;90;73;163;SEC_431
1998;218;50-64;77;70;147;SEC_218
1998;612;50-64;180;161;341;SEC_612
1998;230;25-34;73;82;155;SEC_230
1998;322;00-02;17;19;36;SEC_322
1998;406;03-11;43;40;83;SEC_406
1998;103;50-64;67;66;133;SEC_103
1998;414;18-24;38;46;84;SEC_414
1998;215;25-34;75;73;148;SEC_215
1998;411;03-11;37;20;57;SEC_411
1998;517;12-15;16;18;34;SEC_517
1998;511;18-24;38;31;69;SEC_511
1998;317;50-64;63;68;131;SEC_317
1998;407;25-34;88;105;193;SEC_407
1998;528;65-74;62;54;116;SEC_528
1998;319;03-11;23;29;52;SEC_319
1998;627;75 i +;21;12;33;SEC_627
1998;115;35-49;158;145;303;SEC_115
1998;304;75 i +;76;37;113;SEC_304
1998;627;00-02;9;8;17;SEC_627
1998;435;25-34;73;72;145;SEC_435
1998;436;75 i +;31;21;52;SEC_436
1998;321;00-02;24;19;43;SEC_321
1998;401;12-15;25;38;63;SEC_401
1998;130;03-11;33;31;64;SEC_130
1998;426;16-17;8;12;20;SEC_426
1998;431;16-17;14;12;26;SEC_431
1998;110;65-74;52;48;100;SEC_110
1998;220;65-74;67;60;127;SEC_220
1998;610;00-02;6;10;16;SEC_610
1998;512;75 i +;44;23;67;SEC_512
1998;621;00-02;17;19;36;SEC_621
1998;111;35-49;102;97;199;SEC_111
1998;218;12-15;6;13;19;SEC_218
1998;309;25-34;64;55;119;SEC_309
1998;321;18-24;164;148;312;SEC_321
1998;424;75 i +;20;11;31;SEC_424
1998;614;16-17;15;10;25;SEC_614
1998;122;35-49;53;60;113;SEC_122
1998;232;75 i +;60;32;92;SEC_232
1998;217;12-15;12;12;24;SEC_217
1998;323;16-17;45;53;98;SEC_323
1998;220;25-34;73;70;143;SEC_220
1998;411;25-34;62;72;134;SEC_411
1998;231;16-17;6;7;13;SEC_231
1998;532;25-34;118;106;224;SEC_532
1998;236;50-64;110;97;207;SEC_236
1998;139;35-49;91;98;189;SEC_139
1998;413;35-49;49;55;104;SEC_413
1998;310;00-02;8;8;16;SEC_310
1998;304;12-15;13;16;29;SEC_304
1998;431;18-24;77;83;160;SEC_431
1998;229;16-17;2;5;7;SEC_229
1998;237;35-49;107;109;216;SEC_237
1998;213;18-24;58;66;124;SEC_213
1998;628;12-15;26;24;50;SEC_628
1998;123;16-17;16;15;31;SEC_123
1998;249;12-15;12;16;28;SEC_249
1998;530;35-49;106;109;215;SEC_530
1998;226;16-17;15;15;30;SEC_226
1998;105;25-34;82;93;175;SEC_105
1998;242;03-11;30;27;57;SEC_242
1998;210;50-64;101;79;180;SEC_210
1998;244;50-64;55;48;103;SEC_244
1998;420;35-49;89;109;198;SEC_420
1998;403;00-02;7;9;16;SEC_403
1998;623;16-17;22;37;59;SEC_623
1998;422;12-15;17;16;33;SEC_422
1998;425;18-24;42;44;86;SEC_425
1998;203;16-17;6;8;14;SEC_203
1998;319;16-17;16;16;32;SEC_319
1998;231;00-02;14;3;17;SEC_231
1998;411;16-17;14;9;23;SEC_411
1998;313;25-34;142;141;283;SEC_313
1998;317;65-74;56;41;97;SEC_317
1998;311;18-24;76;80;156;SEC_311
1998;414;35-49;81;73;154;SEC_414
1998;606;25-34;110;113;223;SEC_606
1998;526;18-24;33;40;73;SEC_526
1998;301;75 i +;81;34;115;SEC_301
1998;530;12-15;20;25;45;SEC_530
1998;222;03-11;42;29;71;SEC_222
1998;308;25-34;123;121;244;SEC_308
1998;229;25-34;49;56;105;SEC_229
1998;533;35-49;71;68;139;SEC_533
1998;322;03-11;43;49;92;SEC_322
1998;608;75 i +;30;10;40;SEC_608
1998;526;16-17;9;8;17;SEC_526
1998;523;12-15;25;19;44;SEC_523
1998;113;25-34;96;82;178;SEC_113
1998;402;00-02;7;2;9;SEC_402
1998;122;16-17;9;4;13;SEC_122
1998;534;65-74;54;47;101;SEC_534
1998;129;00-02;12;14;26;SEC_129
1998;409;03-11;15;19;34;SEC_409
1998;503;75 i +;20;11;31;SEC_503
1998;601;25-34;88;144;232;SEC_601
1998;535;50-64;145;153;298;SEC_535
1998;512;03-11;29;30;59;SEC_512
1998;225;03-11;10;12;22;SEC_225
1998;131;75 i +;35;18;53;SEC_131
1998;406;16-17;18;13;31;SEC_406
1998;529;75 i +;59;38;97;SEC_529
1998;126;16-17;13;5;18;SEC_126
1998;530;50-64;132;116;248;SEC_530
1998;409;25-34;54;65;119;SEC_409
1998;235;35-49;89;98;187;SEC_235
1998;216;00-02;10;9;19;SEC_216
1998;215;12-15;12;10;22;SEC_215
1998;528;18-24;61;78;139;SEC_528
1998;244;00-02;8;4;12;SEC_244
1998;316;12-15;103;120;223;SEC_316
1998;517;25-34;103;104;207;SEC_517
1998;106;18-24;130;174;304;SEC_106
1998;423;12-15;13;13;26;SEC_423
1998;403;18-24;59;73;132;SEC_403
1998;321;35-49;320;307;627;SEC_321
1998;135;12-15;29;31;60;SEC_135
1998;403;75 i +;49;25;74;SEC_403
1998;201;03-11;21;23;44;SEC_201
1998;135;00-02;17;13;30;SEC_135
1998;317;35-49;67;81;148;SEC_317
1998;612;03-11;31;33;64;SEC_612
1998;119;35-49;166;142;308;SEC_119
1998;627;35-49;171;141;312;SEC_627
1998;438;35-49;67;63;130;SEC_438
1998;440;35-49;78;81;159;SEC_440
1998;436;12-15;9;13;22;SEC_436
1998;608;25-34;85;108;193;SEC_608
1998;628;03-11;39;37;76;SEC_628
1998;515;25-34;48;44;92;SEC_515
1998;403;50-64;158;147;305;SEC_403
1998;438;16-17;11;9;20;SEC_438
1998;607;75 i +;36;16;52;SEC_607
1998;213;00-02;11;9;20;SEC_213
1998;621;75 i +;25;13;38;SEC_621
1998;246;16-17;9;7;16;SEC_246
1998;115;65-74;73;51;124;SEC_115
1998;517;50-64;110;104;214;SEC_517
1998;127;35-49;103;97;200;SEC_127
1998;313;35-49;237;217;454;SEC_313
1998;229;00-02;9;7;16;SEC_229
1998;440;18-24;87;83;170;SEC_440
1998;436;35-49;66;79;145;SEC_436
1998;628;00-02;8;6;14;SEC_628
1998;104;65-74;72;52;124;SEC_104
1998;125;16-17;7;23;30;SEC_125
1998;407;35-49;83;84;167;SEC_407
1998;423;25-34;67;86;153;SEC_423
1998;610;03-11;30;38;68;SEC_610
1998;518;18-24;59;62;121;SEC_518
1998;536;75 i +;32;24;56;SEC_536
1998;203;75 i +;56;26;82;SEC_203
1998;529;50-64;125;132;257;SEC_529
1998;518;65-74;56;63;119;SEC_518
1998;611;18-24;97;95;192;SEC_611
1998;239;18-24;45;47;92;SEC_239
1998;131;65-74;59;54;113;SEC_131
1998;415;65-74;46;34;80;SEC_415
1998;624;16-17;15;20;35;SEC_624
1998;225;16-17;2;5;7;SEC_225
1998;209;18-24;27;29;56;SEC_209
1998;202;35-49;57;54;111;SEC_202
1998;614;12-15;12;19;31;SEC_614
1998;139;00-02;13;11;24;SEC_139
1998;519;18-24;16;36;52;SEC_519
1998;125;25-34;89;84;173;SEC_125
1998;515;12-15;13;8;21;SEC_515
1998;208;12-15;24;34;58;SEC_208
1998;207;16-17;12;7;19;SEC_207
1998;306;65-74;106;83;189;SEC_306
1998;537;35-49;107;105;212;SEC_537
1998;323;00-02;37;26;63;SEC_323
1998;132;25-34;169;175;344;SEC_132
1998;122;18-24;50;51;101;SEC_122
1998;533;12-15;13;17;30;SEC_533
1998;211;35-49;96;105;201;SEC_211
1998;310;18-24;49;55;104;SEC_310
1998;622;75 i +;33;12;45;SEC_622
1998;411;12-15;19;13;32;SEC_411
1998;112;03-11;58;64;122;SEC_112
1998;114;25-34;149;158;307;SEC_114
1998;240;18-24;26;24;50;SEC_240
1998;613;25-34;152;165;317;SEC_613
1998;436;65-74;37;23;60;SEC_436
1998;234;25-34;69;83;152;SEC_234
1998;118;00-02;17;22;39;SEC_118
1998;412;25-34;103;125;228;SEC_412
1998;238;75 i +;57;30;87;SEC_238
1998;411;18-24;68;69;137;SEC_411
1998;435;00-02;6;13;19;SEC_435
1998;603;25-34;60;69;129;SEC_603
1998;318;35-49;136;136;272;SEC_318
1998;128;35-49;97;96;193;SEC_128
1998;244;16-17;7;4;11;SEC_244
1998;610;12-15;19;23;42;SEC_610
1998;104;18-24;35;38;73;SEC_104
1998;537;50-64;157;130;287;SEC_537
1998;408;16-17;8;12;20;SEC_408
1998;520;18-24;54;63;117;SEC_520
1998;632;25-34;88;115;203;SEC_632
1998;607;25-34;97;112;209;SEC_607
1998;135;35-49;170;169;339;SEC_135
1998;235;65-74;110;91;201;SEC_235
1998;303;00-02;14;19;33;SEC_303
1998;416;65-74;60;61;121;SEC_416
1998;526;00-02;4;6;10;SEC_526
1998;602;03-11;17;14;31;SEC_602
1998;602;35-49;39;35;74;SEC_602
1998;629;12-15;10;14;24;SEC_629
1998;225;12-15;10;12;22;SEC_225
1998;620;50-64;92;84;176;SEC_620
1998;407;00-02;10;11;21;SEC_407
1998;243;75 i +;86;45;131;SEC_243
1998;108;00-02;15;11;26;SEC_108
1998;249;75 i +;56;30;86;SEC_249
1998;503;00-02;8;8;16;SEC_503
1998;619;03-11;47;47;94;SEC_619
1998;411;50-64;119;114;233;SEC_411
1998;324;18-24;30;51;81;SEC_324
1998;123;18-24;70;65;135;SEC_123
1998;524;65-74;75;57;132;SEC_524
1998;111;75 i +;38;25;63;SEC_111
1998;630;16-17;26;20;46;SEC_630
1998;134;65-74;45;36;81;SEC_134
1998;114;35-49;172;171;343;SEC_114
1998;325;25-34;170;163;333;SEC_325
1998;607;00-02;5;11;16;SEC_607
1998;101;18-24;64;64;128;SEC_101
1998;621;16-17;22;33;55;SEC_621
1998;216;75 i +;50;30;80;SEC_216
1998;410;00-02;14;17;31;SEC_410
1998;246;50-64;87;74;161;SEC_246
1998;113;75 i +;37;21;58;SEC_113
1998;321;50-64;200;227;427;SEC_321
1998;323;50-64;177;207;384;SEC_323
1998;404;12-15;21;20;41;SEC_404
1998;301;00-02;18;23;41;SEC_301
1998;620;16-17;14;11;25;SEC_620
1998;105;18-24;87;74;161;SEC_105
1998;419;16-17;4;9;13;SEC_419
1998;613;00-02;12;10;22;SEC_613
1998;424;18-24;35;54;89;SEC_424
1998;401;25-34;84;90;174;SEC_401
1998;227;25-34;58;55;113;SEC_227
1998;601;00-02;12;12;24;SEC_601
1998;420;03-11;39;40;79;SEC_420
1998;404;16-17;17;18;35;SEC_404
1998;603;75 i +;12;14;26;SEC_603
1998;534;03-11;32;25;57;SEC_534
1998;604;75 i +;21;15;36;SEC_604
1998;513;18-24;37;44;81;SEC_513
1998;110;50-64;156;152;308;SEC_110
1998;631;12-15;24;12;36;SEC_631
1998;440;03-11;15;26;41;SEC_440
1998;431;35-49;123;120;243;SEC_431
1998;617;65-74;53;47;100;SEC_617
1998;610;18-24;96;100;196;SEC_610
1998;622;35-49;108;101;209;SEC_622
1998;124;16-17;10;16;26;SEC_124
1998;228;50-64;79;61;140;SEC_228
1998;117;65-74;67;47;114;SEC_117
1998;235;18-24;63;51;114;SEC_235
1998;222;35-49;69;68;137;SEC_222
1998;320;16-17;3;5;8;SEC_320
1998;630;75 i +;23;10;33;SEC_630
1998;110;35-49;157;132;289;SEC_110
1998;430;03-11;24;34;58;SEC_430
1998;528;25-34;106;119;225;SEC_528
1998;307;25-34;100;87;187;SEC_307
1998;303;25-34;179;205;384;SEC_303
1998;117;25-34;155;160;315;SEC_117
1998;125;35-49;149;119;268;SEC_125
1998;516;75 i +;29;9;38;SEC_516
1998;429;25-34;31;45;76;SEC_429
1998;117;50-64;151;173;324;SEC_117
1998;302;75 i +;44;18;62;SEC_302
1998;511;75 i +;33;13;46;SEC_511
1998;317;25-34;63;82;145;SEC_317
1998;416;75 i +;26;15;41;SEC_416
1998;410;18-24;98;117;215;SEC_410
1998;239;03-11;20;29;49;SEC_239
1998;627;16-17;22;26;48;SEC_627
1998;206;16-17;10;7;17;SEC_206
1998;434;12-15;12;12;24;SEC_434
1998;140;12-15;13;14;27;SEC_140
1998;325;16-17;21;17;38;SEC_325
1998;233;18-24;30;33;63;SEC_233
1998;207;18-24;26;24;50;SEC_207
1998;417;16-17;6;9;15;SEC_417
1998;611;35-49;117;128;245;SEC_611
1998;531;00-02;8;9;17;SEC_531
1998;612;25-34;107;129;236;SEC_612
1998;508;18-24;44;24;68;SEC_508
1998;246;18-24;48;37;85;SEC_246
1998;312;12-15;25;18;43;SEC_312
1998;207;25-34;58;45;103;SEC_207
1998;502;50-64;146;162;308;SEC_502
1998;215;35-49;63;64;127;SEC_215
1998;604;50-64;93;72;165;SEC_604
1998;512;35-49;69;66;135;SEC_512
1998;246;00-02;13;13;26;SEC_246
1998;504;50-64;169;157;326;SEC_504
1998;403;25-34;85;98;183;SEC_403
1998;305;16-17;17;22;39;SEC_305
1998;428;65-74;45;36;81;SEC_428
1998;244;03-11;16;16;32;SEC_244
1998;204;65-74;53;43;96;SEC_204
1998;318;50-64;58;67;125;SEC_318
1998;132;12-15;50;56;106;SEC_132
1998;503;25-34;67;52;119;SEC_503
1998;240;75 i +;40;19;59;SEC_240
1998;433;65-74;49;40;89;SEC_433
1998;521;65-74;42;35;77;SEC_521
1998;418;18-24;60;64;124;SEC_418
1998;402;12-15;10;14;24;SEC_402
1998;513;75 i +;40;17;57;SEC_513
1998;320;00-02;5;6;11;SEC_320
1998;401;03-11;49;39;88;SEC_401
1998;409;35-49;61;65;126;SEC_409
1998;610;16-17;14;14;28;SEC_610
1998;442;03-11;19;18;37;SEC_442
1998;229;65-74;54;49;103;SEC_229
1998;517;35-49;95;100;195;SEC_517
1998;116;65-74;61;61;122;SEC_116
1998;139;12-15;13;18;31;SEC_139
1998;623;50-64;198;202;400;SEC_623
1998;323;35-49;400;369;769;SEC_323
1998;113;50-64;105;114;219;SEC_113
1998;623;00-02;17;13;30;SEC_623
1998;130;12-15;10;10;20;SEC_130
1998;632;65-74;39;37;76;SEC_632
1998;121;00-02;12;11;23;SEC_121
1998;228;65-74;44;36;80;SEC_228
1998;632;50-64;112;105;217;SEC_632
1998;602;65-74;21;27;48;SEC_602
1998;437;50-64;83;80;163;SEC_437
1998;111;16-17;7;9;16;SEC_111
1998;429;65-74;42;34;76;SEC_429
1998;615;12-15;17;6;23;SEC_615
1998;610;50-64;208;211;419;SEC_610
1998;319;18-24;48;53;101;SEC_319
1998;531;35-49;75;72;147;SEC_531
1998;207;75 i +;56;33;89;SEC_207
1998;304;65-74;92;73;165;SEC_304
1998;239;16-17;10;9;19;SEC_239
1998;437;03-11;26;34;60;SEC_437
1998;312;16-17;6;20;26;SEC_312
1998;403;12-15;28;20;48;SEC_403
1998;245;03-11;30;30;60;SEC_245
1998;426;18-24;49;60;109;SEC_426
1998;247;00-02;8;10;18;SEC_247
1998;101;16-17;16;17;33;SEC_101
1998;612;00-02;7;14;21;SEC_612
1998;204;50-64;53;45;98;SEC_204
1998;624;12-15;25;25;50;SEC_624
1998;619;65-74;67;61;128;SEC_619
1998;630;03-11;29;27;56;SEC_630
1998;514;03-11;33;20;53;SEC_514
1998;626;00-02;13;11;24;SEC_626
1998;624;50-64;157;185;342;SEC_624
1998;609;65-74;29;33;62;SEC_609
1998;513;16-17;6;1;7;SEC_513
1998;112;65-74;54;48;102;SEC_112
1998;236;35-49;84;82;166;SEC_236
1998;215;75 i +;61;42;103;SEC_215
1998;115;18-24;65;98;163;SEC_115
1998;502;65-74;75;65;140;SEC_502
1998;508;00-02;5;9;14;SEC_508
1998;102;12-15;29;22;51;SEC_102
1998;524;12-15;19;21;40;SEC_524
1998;246;75 i +;68;34;102;SEC_246
1998;321;12-15;48;49;97;SEC_321
1998;619;16-17;27;21;48;SEC_619
1998;309;12-15;11;9;20;SEC_309
1998;538;65-74;86;82;168;SEC_538
1998;238;18-24;25;38;63;SEC_238
1998;317;12-15;12;13;25;SEC_317
1998;140;75 i +;40;22;62;SEC_140
1998;527;12-15;17;21;38;SEC_527
1998;216;12-15;22;28;50;SEC_216
1998;230;65-74;70;44;114;SEC_230
1998;527;75 i +;49;28;77;SEC_527
1998;523;75 i +;86;38;124;SEC_523
1998;604;12-15;16;14;30;SEC_604
1998;202;16-17;6;9;15;SEC_202
1998;429;75 i +;32;21;53;SEC_429
1998;137;50-64;120;126;246;SEC_137
1998;538;35-49;93;92;185;SEC_538
1998;324;25-34;80;70;150;SEC_324
1998;505;35-49;107;83;190;SEC_505
1998;248;12-15;26;22;48;SEC_248
1998;118;75 i +;31;18;49;SEC_118
1998;438;65-74;33;38;71;SEC_438
1998;201;12-15;13;9;22;SEC_201
1998;618;35-49;64;46;110;SEC_618
1998;121;18-24;30;30;60;SEC_121
1998;214;12-15;8;11;19;SEC_214
1998;502;75 i +;61;35;96;SEC_502
1998;615;03-11;8;20;28;SEC_615
1998;238;65-74;58;41;99;SEC_238
1998;534;50-64;101;100;201;SEC_534
1998;404;00-02;13;23;36;SEC_404
1998;422;35-49;88;98;186;SEC_422
1998;220;12-15;8;15;23;SEC_220
1998;107;75 i +;53;26;79;SEC_107
1998;112;75 i +;61;21;82;SEC_112
1998;236;12-15;11;8;19;SEC_236
1998;605;16-17;9;7;16;SEC_605
1998;537;00-02;11;8;19;SEC_537
1998;136;00-02;13;16;29;SEC_136
1998;133;25-34;63;81;144;SEC_133
1998;408;50-64;91;76;167;SEC_408
1998;103;18-24;41;41;82;SEC_103
1998;530;18-24;63;77;140;SEC_530
1998;503;50-64;72;80;152;SEC_503
1998;247;75 i +;58;29;87;SEC_247
1998;236;75 i +;54;41;95;SEC_236
1998;415;00-02;7;10;17;SEC_415
1998;434;35-49;52;56;108;SEC_434
1998;131;16-17;30;20;50;SEC_131
1998;208;03-11;40;45;85;SEC_208
1998;108;65-74;89;88;177;SEC_108
1998;209;65-74;78;62;140;SEC_209
1998;610;35-49;100;78;178;SEC_610
1998;520;16-17;5;13;18;SEC_520
1998;212;18-24;65;72;137;SEC_212
1998;405;16-17;3;8;11;SEC_405
1998;415;16-17;13;9;22;SEC_415
1998;104;25-34;68;91;159;SEC_104
1998;139;65-74;33;24;57;SEC_139
1998;505;25-34;129;138;267;SEC_505
1998;426;50-64;77;69;146;SEC_426
1998;230;03-11;22;29;51;SEC_230
1998;439;65-74;53;57;110;SEC_439
1998;613;16-17;7;9;16;SEC_613
1998;516;65-74;37;24;61;SEC_516
1998;129;16-17;14;10;24;SEC_129
1998;424;25-34;34;53;87;SEC_424
1998;441;65-74;112;85;197;SEC_441
1998;432;18-24;82;90;172;SEC_432
1998;306;03-11;54;59;113;SEC_306
1998;420;25-34;113;106;219;SEC_420
1998;625;12-15;53;44;97;SEC_625
1998;513;03-11;16;23;39;SEC_513
1998;526;03-11;25;29;54;SEC_526
1998;126;75 i +;38;16;54;SEC_126
1998;124;75 i +;30;19;49;SEC_124
1998;527;25-34;84;90;174;SEC_527
1998;231;75 i +;80;39;119;SEC_231
1998;416;50-64;85;68;153;SEC_416
1998;434;65-74;72;44;116;SEC_434
1998;433;50-64;84;80;164;SEC_433
1998;303;16-17;17;15;32;SEC_303
1998;129;65-74;48;35;83;SEC_129
1998;624;35-49;116;76;192;SEC_624
1998;107;18-24;132;123;255;SEC_107
1998;122;12-15;11;14;25;SEC_122
1998;533;18-24;47;47;94;SEC_533
1998;509;75 i +;39;19;58;SEC_509
1998;134;50-64;117;108;225;SEC_134
1998;111;65-74;40;39;79;SEC_111
1998;238;25-34;57;50;107;SEC_238
1998;408;00-02;5;11;16;SEC_408
1998;216;18-24;83;81;164;SEC_216
1998;515;75 i +;25;11;36;SEC_515
1998;413;65-74;43;40;83;SEC_413
1998;218;18-24;37;41;78;SEC_218
1998;104;16-17;6;7;13;SEC_104
1998;322;16-17;22;13;35;SEC_322
1998;421;16-17;14;9;23;SEC_421
1998;209;35-49;85;87;172;SEC_209
1998;613;18-24;108;94;202;SEC_613
1998;615;25-34;97;118;215;SEC_615
1998;531;03-11;23;29;52;SEC_531
1998;211;75 i +;81;43;124;SEC_211
1998;509;00-02;7;10;17;SEC_509
1998;502;00-02;12;6;18;SEC_502
1998;421;25-34;120;130;250;SEC_421
1998;534;25-34;81;80;161;SEC_534
1998;519;12-15;12;10;22;SEC_519
1998;416;00-02;8;9;17;SEC_416
1998;525;00-02;9;5;14;SEC_525
1998;324;12-15;26;17;43;SEC_324
1998;110;25-34;88;93;181;SEC_110
1998;428;18-24;21;23;44;SEC_428
1998;427;03-11;16;28;44;SEC_427
1998;523;03-11;25;39;64;SEC_523
1998;517;16-17;12;14;26;SEC_517
1998;227;16-17;4;5;9;SEC_227
1998;505;00-02;9;2;11;SEC_505
1998;438;03-11;22;26;48;SEC_438
1998;203;35-49;51;61;112;SEC_203
1998;537;75 i +;50;25;75;SEC_537
1998;315;75 i +;51;29;80;SEC_315
1998;531;75 i +;45;23;68;SEC_531
1998;235;00-02;13;14;27;SEC_235
1998;307;00-02;12;14;26;SEC_307
1998;620;65-74;15;23;38;SEC_620
1998;105;75 i +;46;28;74;SEC_105
1998;616;50-64;146;154;300;SEC_616
1998;307;03-11;43;64;107;SEC_307
1998;311;50-64;139;130;269;SEC_311
1998;122;03-11;31;16;47;SEC_122
1998;441;75 i +;55;43;98;SEC_441
1998;436;00-02;11;17;28;SEC_436
1998;217;25-34;50;62;112;SEC_217
1998;308;12-15;29;37;66;SEC_308
1998;504;16-17;9;7;16;SEC_504
1998;420;00-02;11;13;24;SEC_420
1998;432;25-34;82;83;165;SEC_432
1998;232;25-34;73;72;145;SEC_232
1998;119;18-24;122;131;253;SEC_119
1998;435;12-15;10;27;37;SEC_435
1998;524;25-34;117;105;222;SEC_524
1998;120;35-49;221;226;447;SEC_120
1998;213;75 i +;28;14;42;SEC_213
1998;602;50-64;92;82;174;SEC_602
1998;430;75 i +;50;24;74;SEC_430
1998;110;03-11;38;44;82;SEC_110
1998;439;50-64;103;95;198;SEC_439
1998;406;35-49;127;126;253;SEC_406
1998;534;16-17;9;9;18;SEC_534
1998;301;65-74;102;86;188;SEC_301
1998;605;12-15;8;7;15;SEC_605
1998;414;65-74;69;64;133;SEC_414
1998;213;03-11;26;29;55;SEC_213
1998;409;00-02;2;12;14;SEC_409
1998;232;16-17;9;7;16;SEC_232
1998;221;65-74;65;67;132;SEC_221
1998;515;50-64;48;56;104;SEC_515
1998;124;35-49;109;91;200;SEC_124
1998;133;18-24;55;61;116;SEC_133
1998;226;50-64;93;90;183;SEC_226
1998;436;03-11;23;28;51;SEC_436
1998;629;75 i +;24;10;34;SEC_629
1998;406;18-24;92;98;190;SEC_406
1998;108;03-11;48;44;92;SEC_108
1998;101;12-15;33;35;68;SEC_101
1998;412;35-49;179;180;359;SEC_412
1998;231;65-74;89;73;162;SEC_231
1998;608;35-49;91;89;180;SEC_608
1998;232;00-02;11;7;18;SEC_232
1998;603;65-74;24;23;47;SEC_603
1998;131;25-34;125;122;247;SEC_131
1998;414;25-34;83;73;156;SEC_414
1998;412;75 i +;49;32;81;SEC_412
1998;629;50-64;67;58;125;SEC_629
1998;427;75 i +;41;32;73;SEC_427
1998;140;65-74;59;55;114;SEC_140
1998;419;25-34;78;88;166;SEC_419
1998;108;50-64;112;102;214;SEC_108
1998;217;18-24;20;21;41;SEC_217
1998;506;12-15;38;44;82;SEC_506
1998;224;65-74;40;36;76;SEC_224
1998;432;75 i +;31;27;58;SEC_432
1998;609;00-02;7;8;15;SEC_609
1998;408;65-74;47;48;95;SEC_408
1998;209;25-34;76;91;167;SEC_209
1998;133;65-74;54;50;104;SEC_133
1998;441;03-11;100;77;177;SEC_441
1998;625;18-24;112;126;238;SEC_625
1998;140;03-11;16;16;32;SEC_140
1998;222;16-17;11;12;23;SEC_222
1998;516;03-11;16;19;35;SEC_516
1998;622;25-34;86;94;180;SEC_622
1998;307;50-64;160;143;303;SEC_307
1998;431;03-11;33;41;74;SEC_431
1998;201;75 i +;39;11;50;SEC_201
1998;113;65-74;49;35;84;SEC_113
1998;308;03-11;40;45;85;SEC_308
1998;404;50-64;138;119;257;SEC_404
1998;529;03-11;20;35;55;SEC_529
1998;624;03-11;36;38;74;SEC_624
1998;442;35-49;56;56;112;SEC_442
1998;137;00-02;13;15;28;SEC_137
1998;501;35-49;151;122;273;SEC_501
1998;629;00-02;7;9;16;SEC_629
1998;526;25-34;60;56;116;SEC_526
1998;606;35-49;87;97;184;SEC_606
1998;522;65-74;42;38;80;SEC_522
1998;221;03-11;42;50;92;SEC_221
1998;420;50-64;123;110;233;SEC_420
1998;628;75 i +;33;14;47;SEC_628
1998;627;12-15;36;32;68;SEC_627
1998;319;25-34;57;65;122;SEC_319
1998;128;12-15;18;18;36;SEC_128
1998;514;12-15;11;11;22;SEC_514
1998;230;35-49;48;56;104;SEC_230
1998;506;25-34;147;148;295;SEC_506
1998;241;03-11;34;23;57;SEC_241
1998;605;03-11;13;19;32;SEC_605
1998;613;50-64;206;212;418;SEC_613
1998;431;75 i +;64;36;100;SEC_431
1998;408;18-24;41;56;97;SEC_408
