AnyPadro;Seccio;GrupEdat;Dones;Homes;Total;IdSeccio
1996;322;03-11;45;48;93;SEC_322
1996;434;16-17;12;7;19;SEC_434
1996;442;25-34;56;49;105;SEC_442
1996;115;18-24;70;119;189;SEC_115
1996;102;03-11;53;58;111;SEC_102
1996;418;18-24;68;58;126;SEC_418
1996;529;00-02;4;9;13;SEC_529
1996;302;65-74;47;44;91;SEC_302
1996;514;65-74;33;34;67;SEC_514
1996;114;03-11;62;42;104;SEC_114
1996;217;16-17;4;7;11;SEC_217
1996;503;25-34;70;54;124;SEC_503
1996;433;35-49;81;81;162;SEC_433
1996;305;00-02;15;14;29;SEC_305
1996;433;03-11;46;27;73;SEC_433
1996;610;03-11;36;42;78;SEC_610
1996;408;00-02;9;7;16;SEC_408
1996;502;75 i +;50;24;74;SEC_502
1996;538;50-64;163;129;292;SEC_538
1996;302;25-34;131;135;266;SEC_302
1996;514;75 i +;29;15;44;SEC_514
1996;501;18-24;129;143;272;SEC_501
1996;110;75 i +;42;22;64;SEC_110
1996;308;16-17;26;19;45;SEC_308
1996;512;12-15;11;9;20;SEC_512
1996;228;75 i +;27;17;44;SEC_228
1996;504;35-49;103;97;200;SEC_504
1996;625;65-74;18;23;41;SEC_625
1996;520;16-17;11;15;26;SEC_520
1996;408;65-74;48;42;90;SEC_408
1996;531;35-49;78;74;152;SEC_531
1996;317;75 i +;44;16;60;SEC_317
1996;602;16-17;6;1;7;SEC_602
1996;414;12-15;14;22;36;SEC_414
1996;422;16-17;8;13;21;SEC_422
1996;135;65-74;58;51;109;SEC_135
1996;439;12-15;5;21;26;SEC_439
1996;222;25-34;74;62;136;SEC_222
1996;316;03-11;146;159;305;SEC_316
1996;113;50-64;92;93;185;SEC_113
1996;501;12-15;37;39;76;SEC_501
1996;537;18-24;80;78;158;SEC_537
1996;525;16-17;13;15;28;SEC_525
1996;421;50-64;153;134;287;SEC_421
1996;233;18-24;32;45;77;SEC_233
1996;322;25-34;90;106;196;SEC_322
1996;607;03-11;31;42;73;SEC_607
1996;618;35-49;74;53;127;SEC_618
1996;624;65-74;31;34;65;SEC_624
1996;321;25-34;171;166;337;SEC_321
1996;234;16-17;5;7;12;SEC_234
1996;111;16-17;10;20;30;SEC_111
1996;612;16-17;14;17;31;SEC_612
1996;504;16-17;9;25;34;SEC_504
1996;502;03-11;51;44;95;SEC_502
1996;119;18-24;137;135;272;SEC_119
1996;423;25-34;82;80;162;SEC_423
1996;225;75 i +;25;25;50;SEC_225
1996;623;00-02;20;19;39;SEC_623
1996;417;65-74;42;31;73;SEC_417
1996;111;03-11;50;37;87;SEC_111
1996;130;03-11;25;27;52;SEC_130
1996;407;25-34;95;112;207;SEC_407
1996;205;03-11;33;37;70;SEC_205
1996;110;16-17;24;31;55;SEC_110
1996;440;16-17;20;18;38;SEC_440
1996;427;12-15;13;12;25;SEC_427
1996;301;75 i +;78;27;105;SEC_301
1996;238;75 i +;52;25;77;SEC_238
1996;132;65-74;64;59;123;SEC_132
1996;130;16-17;7;6;13;SEC_130
1996;323;00-02;37;39;76;SEC_323
1996;312;00-02;11;14;25;SEC_312
1996;202;50-64;78;77;155;SEC_202
1996;515;12-15;13;5;18;SEC_515
1996;414;35-49;84;70;154;SEC_414
1996;124;16-17;13;9;22;SEC_124
1996;412;65-74;68;75;143;SEC_412
1996;538;03-11;24;35;59;SEC_538
1996;631;03-11;44;28;72;SEC_631
1996;625;16-17;32;42;74;SEC_625
1996;433;50-64;84;89;173;SEC_433
1996;424;16-17;6;12;18;SEC_424
1996;138;18-24;54;53;107;SEC_138
1996;135;50-64;129;139;268;SEC_135
1996;232;18-24;50;53;103;SEC_232
1996;311;18-24;87;87;174;SEC_311
1996;610;18-24;118;137;255;SEC_610
1996;205;35-49;104;102;206;SEC_205
1996;441;16-17;39;30;69;SEC_441
1996;401;75 i +;27;13;40;SEC_401
1996;209;35-49;79;88;167;SEC_209
1996;604;16-17;13;19;32;SEC_604
1996;439;16-17;9;6;15;SEC_439
1996;511;03-11;10;20;30;SEC_511
1996;230;00-02;6;10;16;SEC_230
1996;606;50-64;133;119;252;SEC_606
1996;132;18-24;142;154;296;SEC_132
1996;319;65-74;31;27;58;SEC_319
1996;422;12-15;27;17;44;SEC_422
1996;437;18-24;54;54;108;SEC_437
1996;123;18-24;69;64;133;SEC_123
1996;615;65-74;27;21;48;SEC_615
1996;622;03-11;47;49;96;SEC_622
1996;523;75 i +;81;33;114;SEC_523
1996;530;12-15;20;33;53;SEC_530
1996;420;12-15;20;24;44;SEC_420
1996;406;35-49;145;144;289;SEC_406
1996;134;25-34;105;99;204;SEC_134
1996;316;25-34;91;72;163;SEC_316
1996;415;75 i +;36;20;56;SEC_415
1996;623;16-17;35;34;69;SEC_623
1996;522;12-15;25;18;43;SEC_522
1996;227;35-49;56;48;104;SEC_227
1996;311;25-34;126;122;248;SEC_311
1996;518;65-74;56;53;109;SEC_518
1996;502;25-34;107;127;234;SEC_502
1996;424;35-49;54;53;107;SEC_424
1996;134;50-64;112;106;218;SEC_134
1996;520;12-15;11;22;33;SEC_520
1996;628;12-15;29;35;64;SEC_628
1996;204;16-17;3;8;11;SEC_204
1996;121;16-17;6;5;11;SEC_121
1996;529;25-34;99;105;204;SEC_529
1996;249;65-74;69;64;133;SEC_249
1996;533;35-49;63;66;129;SEC_533
1996;407;12-15;12;16;28;SEC_407
1996;503;18-24;64;66;130;SEC_503
1996;505;12-15;35;26;61;SEC_505
1996;632;03-11;40;48;88;SEC_632
1996;111;50-64;111;111;222;SEC_111
1996;619;03-11;54;66;120;SEC_619
1996;533;03-11;29;26;55;SEC_533
1996;243;25-34;140;141;281;SEC_243
1996;318;25-34;77;65;142;SEC_318
1996;522;75 i +;27;21;48;SEC_522
1996;106;25-34;130;133;263;SEC_106
1996;222;50-64;80;81;161;SEC_222
1996;304;35-49;98;91;189;SEC_304
1996;504;65-74;58;60;118;SEC_504
1996;438;00-02;4;6;10;SEC_438
1996;423;18-24;55;61;116;SEC_423
1996;203;03-11;12;22;34;SEC_203
1996;316;16-17;33;54;87;SEC_316
1996;603;25-34;59;68;127;SEC_603
1996;218;12-15;11;14;25;SEC_218
1996;428;35-49;37;40;77;SEC_428
1996;303;18-24;120;134;254;SEC_303
1996;504;75 i +;47;31;78;SEC_504
1996;622;16-17;24;13;37;SEC_622
1996;441;00-02;15;10;25;SEC_441
1996;406;18-24;84;99;183;SEC_406
1996;304;16-17;10;12;22;SEC_304
1996;623;03-11;53;55;108;SEC_623
1996;601;25-34;93;132;225;SEC_601
1996;130;25-34;68;93;161;SEC_130
1996;425;18-24;62;55;117;SEC_425
1996;512;25-34;77;81;158;SEC_512
1996;620;75 i +;14;2;16;SEC_620
1996;242;75 i +;56;39;95;SEC_242
1996;304;75 i +;68;42;110;SEC_304
1996;528;03-11;43;33;76;SEC_528
1996;233;00-02;9;4;13;SEC_233
1996;112;25-34;113;115;228;SEC_112
1996;405;65-74;62;60;122;SEC_405
1996;617;50-64;134;113;247;SEC_617
1996;419;16-17;6;13;19;SEC_419
1996;518;16-17;12;11;23;SEC_518
1996;522;50-64;68;69;137;SEC_522
1996;422;00-02;6;8;14;SEC_422
1996;312;12-15;14;30;44;SEC_312
1996;603;75 i +;10;13;23;SEC_603
1996;401;03-11;58;43;101;SEC_401
1996;131;75 i +;30;14;44;SEC_131
1996;246;35-49;88;86;174;SEC_246
1996;231;50-64;110;101;211;SEC_231
1996;220;35-49;65;60;125;SEC_220
1996;216;18-24;78;100;178;SEC_216
1996;109;35-49;138;138;276;SEC_109
1996;510;75 i +;35;23;58;SEC_510
1996;535;12-15;26;34;60;SEC_535
1996;317;12-15;12;17;29;SEC_317
1996;436;35-49;56;73;129;SEC_436
1996;127;03-11;52;42;94;SEC_127
1996;320;03-11;20;22;42;SEC_320
1996;537;16-17;23;18;41;SEC_537
1996;202;65-74;43;37;80;SEC_202
1996;217;65-74;46;32;78;SEC_217
1996;530;18-24;74;85;159;SEC_530
1996;402;25-34;48;73;121;SEC_402
1996;303;75 i +;60;34;94;SEC_303
1996;109;75 i +;51;24;75;SEC_109
1996;102;25-34;134;163;297;SEC_102
1996;222;65-74;54;49;103;SEC_222
1996;409;35-49;67;68;135;SEC_409
1996;116;35-49;187;158;345;SEC_116
1996;317;65-74;54;45;99;SEC_317
1996;315;25-34;133;132;265;SEC_315
1996;514;25-34;60;56;116;SEC_514
1996;605;35-49;62;46;108;SEC_605
1996;305;75 i +;63;36;99;SEC_305
1996;412;16-17;22;33;55;SEC_412
1996;122;35-49;50;45;95;SEC_122
1996;615;25-34;78;90;168;SEC_615
1996;425;12-15;20;13;33;SEC_425
1996;621;50-64;130;166;296;SEC_621
1996;207;35-49;71;62;133;SEC_207
1996;136;65-74;58;49;107;SEC_136
1996;407;65-74;85;70;155;SEC_407
1996;533;12-15;12;15;27;SEC_533
1996;310;18-24;42;55;97;SEC_310
1996;534;12-15;12;18;30;SEC_534
1996;527;75 i +;45;22;67;SEC_527
1996;227;16-17;8;4;12;SEC_227
1996;417;50-64;68;59;127;SEC_417
1996;307;65-74;69;61;130;SEC_307
1996;610;35-49;136;80;216;SEC_610
1996;501;16-17;23;26;49;SEC_501
1996;611;18-24;123;129;252;SEC_611
1996;249;03-11;29;27;56;SEC_249
1996;229;18-24;32;37;69;SEC_229
1996;426;12-15;10;18;28;SEC_426
1996;225;35-49;53;38;91;SEC_225
1996;101;25-34;98;106;204;SEC_101
1996;132;25-34;154;178;332;SEC_132
1996;220;75 i +;35;18;53;SEC_220
1996;518;50-64;138;125;263;SEC_518
1996;623;25-34;111;109;220;SEC_623
1996;630;18-24;82;79;161;SEC_630
1996;139;12-15;26;24;50;SEC_139
1996;436;18-24;54;47;101;SEC_436
1996;525;50-64;98;87;185;SEC_525
1996;521;00-02;7;8;15;SEC_521
1996;241;75 i +;43;24;67;SEC_241
1996;404;65-74;60;58;118;SEC_404
1996;513;03-11;18;22;40;SEC_513
1996;611;35-49;112;110;222;SEC_611
1996;212;75 i +;56;31;87;SEC_212
1996;402;12-15;11;19;30;SEC_402
1996;202;75 i +;27;17;44;SEC_202
1996;626;16-17;15;13;28;SEC_626
1996;424;18-24;35;46;81;SEC_424
1996;308;35-49;161;143;304;SEC_308
1996;521;75 i +;27;14;41;SEC_521
1996;621;75 i +;25;12;37;SEC_621
1996;532;16-17;10;13;23;SEC_532
1996;413;16-17;3;8;11;SEC_413
1996;226;50-64;99;87;186;SEC_226
1996;232;75 i +;65;29;94;SEC_232
1996;223;12-15;15;20;35;SEC_223
1996;401;35-49;120;113;233;SEC_401
1996;139;00-02;12;16;28;SEC_139
1996;222;16-17;13;14;27;SEC_222
1996;537;65-74;77;60;137;SEC_537
1996;106;35-49;306;265;571;SEC_106
1996;313;12-15;68;49;117;SEC_313
1996;621;16-17;46;38;84;SEC_621
1996;135;12-15;40;43;83;SEC_135
1996;603;00-02;9;7;16;SEC_603
1996;224;12-15;10;13;23;SEC_224
1996;427;16-17;11;5;16;SEC_427
1996;319;03-11;30;34;64;SEC_319
1996;601;12-15;47;38;85;SEC_601
1996;624;16-17;19;22;41;SEC_624
1996;306;50-64;130;107;237;SEC_306
1996;427;75 i +;41;30;71;SEC_427
1996;318;35-49;126;137;263;SEC_318
1996;536;50-64;109;96;205;SEC_536
1996;102;00-02;11;15;26;SEC_102
1996;419;03-11;25;26;51;SEC_419
1996;604;65-74;30;26;56;SEC_604
1996;246;65-74;82;69;151;SEC_246
1996;533;25-34;84;100;184;SEC_533
1996;440;50-64;151;174;325;SEC_440
1996;502;16-17;26;14;40;SEC_502
1996;536;03-11;32;24;56;SEC_536
1996;109;03-11;51;46;97;SEC_109
1996;409;12-15;23;15;38;SEC_409
1996;423;16-17;12;13;25;SEC_423
1996;112;03-11;64;68;132;SEC_112
1996;309;03-11;27;28;55;SEC_309
1996;431;50-64;133;119;252;SEC_431
1996;416;65-74;54;42;96;SEC_416
1996;319;18-24;39;52;91;SEC_319
1996;602;25-34;75;85;160;SEC_602
1996;631;25-34;91;93;184;SEC_631
1996;401;00-02;9;10;19;SEC_401
1996;228;35-49;38;52;90;SEC_228
1996;601;65-74;49;41;90;SEC_601
1996;133;16-17;14;20;34;SEC_133
1996;429;16-17;16;9;25;SEC_429
1996;116;03-11;56;52;108;SEC_116
1996;317;25-34;74;82;156;SEC_317
1996;423;35-49;70;75;145;SEC_423
1996;629;12-15;11;19;30;SEC_629
1996;617;25-34;106;126;232;SEC_617
1996;230;16-17;7;6;13;SEC_230
1996;124;75 i +;30;14;44;SEC_124
1996;103;18-24;44;38;82;SEC_103
1996;310;35-49;107;117;224;SEC_310
1996;629;65-74;34;28;62;SEC_629
1996;422;18-24;44;42;86;SEC_422
1996;526;18-24;41;51;92;SEC_526
1996;119;00-02;5;10;15;SEC_119
1996;504;18-24;105;111;216;SEC_504
1996;528;12-15;16;21;37;SEC_528
1996;536;65-74;72;65;137;SEC_536
1996;503;65-74;27;19;46;SEC_503
1996;535;16-17;17;27;44;SEC_535
1996;207;00-02;9;7;16;SEC_207
1996;620;18-24;71;48;119;SEC_620
1996;610;00-02;6;12;18;SEC_610
1996;136;18-24;55;72;127;SEC_136
1996;434;65-74;73;45;118;SEC_434
1996;605;03-11;16;15;31;SEC_605
1996;303;50-64;222;220;442;SEC_303
1996;502;12-15;42;25;67;SEC_502
1996;303;65-74;81;95;176;SEC_303
1996;120;65-74;65;45;110;SEC_120
1996;208;00-02;11;11;22;SEC_208
1996;113;12-15;48;44;92;SEC_113
1996;238;50-64;72;68;140;SEC_238
1996;440;00-02;10;7;17;SEC_440
1996;208;50-64;215;183;398;SEC_208
1996;103;75 i +;39;23;62;SEC_103
1996;115;25-34;106;113;219;SEC_115
1996;140;25-34;75;83;158;SEC_140
1996;303;25-34;169;179;348;SEC_303
1996;312;25-34;123;135;258;SEC_312
1996;212;03-11;38;55;93;SEC_212
1996;513;50-64;98;92;190;SEC_513
1996;430;50-64;100;105;205;SEC_430
1996;206;18-24;37;50;87;SEC_206
1996;124;00-02;6;11;17;SEC_124
1996;525;03-11;31;32;63;SEC_525
1996;134;65-74;54;38;92;SEC_134
1996;528;65-74;65;52;117;SEC_528
1996;211;65-74;109;78;187;SEC_211
1996;219;18-24;51;56;107;SEC_219
1996;610;12-15;30;27;57;SEC_610
1996;319;12-15;27;31;58;SEC_319
1996;113;00-02;13;15;28;SEC_113
1996;246;75 i +;64;33;97;SEC_246
1996;501;00-02;10;11;21;SEC_501
1996;501;03-11;33;39;72;SEC_501
1996;614;25-34;84;85;169;SEC_614
1996;415;65-74;51;30;81;SEC_415
1996;139;25-34;79;70;149;SEC_139
1996;514;16-17;7;11;18;SEC_514
1996;432;50-64;131;144;275;SEC_432
1996;244;65-74;49;47;96;SEC_244
1996;531;75 i +;41;24;65;SEC_531
1996;626;75 i +;22;18;40;SEC_626
1996;512;65-74;50;33;83;SEC_512
1996;112;65-74;55;41;96;SEC_112
1996;325;16-17;35;24;59;SEC_325
1996;302;16-17;30;30;60;SEC_302
1996;248;16-17;12;15;27;SEC_248
1996;434;35-49;58;58;116;SEC_434
1996;409;03-11;26;25;51;SEC_409
1996;305;35-49;202;183;385;SEC_305
1996;509;50-64;87;89;176;SEC_509
1996;306;00-02;18;14;32;SEC_306
1996;314;18-24;127;147;274;SEC_314
1996;235;00-02;14;10;24;SEC_235
1996;315;03-11;63;72;135;SEC_315
1996;247;16-17;19;9;28;SEC_247
1996;207;12-15;15;16;31;SEC_207
1996;401;12-15;23;31;54;SEC_401
1996;114;18-24;125;122;247;SEC_114
1996;226;18-24;68;57;125;SEC_226
1996;510;00-02;7;10;17;SEC_510
1996;617;16-17;17;18;35;SEC_617
1996;627;18-24;98;103;201;SEC_627
1996;118;35-49;276;260;536;SEC_118
1996;215;25-34;79;70;149;SEC_215
1996;441;75 i +;44;33;77;SEC_441
1996;526;00-02;13;3;16;SEC_526
1996;126;18-24;115;109;224;SEC_126
1996;138;50-64;80;73;153;SEC_138
1996;239;00-02;9;13;22;SEC_239
1996;530;03-11;45;41;86;SEC_530
1996;227;12-15;9;9;18;SEC_227
1996;433;65-74;59;38;97;SEC_433
1996;236;50-64;119;116;235;SEC_236
1996;421;16-17;16;18;34;SEC_421
1996;315;35-49;164;165;329;SEC_315
1996;509;18-24;51;57;108;SEC_509
1996;325;18-24;113;136;249;SEC_325
1996;620;65-74;13;16;29;SEC_620
1996;240;16-17;4;5;9;SEC_240
1996;523;16-17;10;20;30;SEC_523
1996;101;65-74;34;37;71;SEC_101
1996;214;12-15;9;16;25;SEC_214
1996;224;18-24;32;27;59;SEC_224
1996;628;18-24;114;124;238;SEC_628
1996;323;65-74;48;35;83;SEC_323
1996;139;16-17;15;11;26;SEC_139
1996;429;00-02;2;9;11;SEC_429
1996;622;75 i +;35;12;47;SEC_622
1996;428;65-74;35;35;70;SEC_428
1996;305;12-15;29;36;65;SEC_305
1996;109;00-02;10;13;23;SEC_109
1996;609;25-34;72;86;158;SEC_609
1996;627;12-15;47;44;91;SEC_627
1996;126;50-64;146;167;313;SEC_126
1996;441;50-64;164;168;332;SEC_441
1996;206;03-11;26;20;46;SEC_206
1996;508;50-64;64;59;123;SEC_508
1996;104;00-02;7;8;15;SEC_104
1996;606;75 i +;29;14;43;SEC_606
1996;105;65-74;54;41;95;SEC_105
1996;408;25-34;82;96;178;SEC_408
1996;103;03-11;29;24;53;SEC_103
1996;306;35-49;183;175;358;SEC_306
1996;430;25-34;75;74;149;SEC_430
1996;306;12-15;40;30;70;SEC_306
1996;535;25-34;47;61;108;SEC_535
1996;312;18-24;71;84;155;SEC_312
1996;138;12-15;21;30;51;SEC_138
1996;236;18-24;59;52;111;SEC_236
1996;412;75 i +;45;23;68;SEC_412
1996;415;35-49;61;67;128;SEC_415
1996;604;03-11;29;38;67;SEC_604
1996;215;65-74;68;49;117;SEC_215
1996;138;25-34;64;63;127;SEC_138
1996;528;75 i +;33;19;52;SEC_528
1996;430;16-17;12;9;21;SEC_430
1996;137;35-49;188;160;348;SEC_137
1996;225;50-64;58;46;104;SEC_225
1996;201;12-15;13;9;22;SEC_201
1996;323;50-64;154;165;319;SEC_323
1996;247;18-24;74;58;132;SEC_247
1996;427;50-64;97;62;159;SEC_427
1996;113;75 i +;33;15;48;SEC_113
1996;202;00-02;5;6;11;SEC_202
1996;606;16-17;14;15;29;SEC_606
1996;440;03-11;20;23;43;SEC_440
1996;515;16-17;5;5;10;SEC_515
1996;247;65-74;83;64;147;SEC_247
1996;225;03-11;14;18;32;SEC_225
1996;624;25-34;72;111;183;SEC_624
1996;230;03-11;19;28;47;SEC_230
1996;523;35-49;111;108;219;SEC_523
1996;238;18-24;26;37;63;SEC_238
1996;413;18-24;35;37;72;SEC_413
1996;301;50-64;217;209;426;SEC_301
1996;228;00-02;8;5;13;SEC_228
1996;131;65-74;55;51;106;SEC_131
1996;203;50-64;73;66;139;SEC_203
1996;625;03-11;70;81;151;SEC_625
1996;629;03-11;30;18;48;SEC_629
1996;315;75 i +;45;20;65;SEC_315
1996;323;18-24;181;180;361;SEC_323
1996;532;03-11;39;36;75;SEC_532
1996;409;16-17;8;13;21;SEC_409
1996;221;00-02;15;10;25;SEC_221
1996;320;12-15;9;14;23;SEC_320
1996;308;18-24;98;89;187;SEC_308
1996;632;12-15;28;40;68;SEC_632
1996;217;12-15;13;12;25;SEC_217
1996;312;75 i +;23;11;34;SEC_312
1996;439;65-74;56;51;107;SEC_439
1996;325;50-64;191;168;359;SEC_325
1996;237;75 i +;67;32;99;SEC_237
1996;242;25-34;77;84;161;SEC_242
1996;517;00-02;7;10;17;SEC_517
1996;126;03-11;28;30;58;SEC_126
1996;410;00-02;13;12;25;SEC_410
1996;307;35-49;230;203;433;SEC_307
1996;629;75 i +;20;11;31;SEC_629
1996;312;35-49;125;110;235;SEC_312
1996;207;25-34;55;44;99;SEC_207
1996;619;65-74;61;54;115;SEC_619
1996;618;18-24;59;68;127;SEC_618
1996;414;16-17;10;16;26;SEC_414
1996;324;35-49;86;74;160;SEC_324
1996;505;50-64;200;232;432;SEC_505
1996;203;12-15;10;15;25;SEC_203
1996;617;35-49;105;108;213;SEC_617
1996;431;25-34;108;110;218;SEC_431
1996;511;50-64;77;71;148;SEC_511
1996;424;00-02;5;4;9;SEC_424
1996;506;00-02;19;22;41;SEC_506
1996;221;75 i +;43;25;68;SEC_221
1996;119;35-49;190;163;353;SEC_119
1996;232;65-74;70;67;137;SEC_232
1996;119;12-15;42;38;80;SEC_119
1996;611;00-02;12;10;22;SEC_611
1996;403;03-11;37;36;73;SEC_403
1996;617;03-11;50;44;94;SEC_617
1996;105;75 i +;37;22;59;SEC_105
1996;428;25-34;52;46;98;SEC_428
1996;111;65-74;43;36;79;SEC_111
1996;308;65-74;67;59;126;SEC_308
1996;216;16-17;27;10;37;SEC_216
1996;403;75 i +;44;19;63;SEC_403
1996;127;12-15;21;14;35;SEC_127
1996;612;75 i +;33;12;45;SEC_612
1996;523;18-24;82;78;160;SEC_523
1996;321;75 i +;66;36;102;SEC_321
1996;237;65-74;82;60;142;SEC_237
1996;526;50-64;60;77;137;SEC_526
1996;609;00-02;9;10;19;SEC_609
1996;412;18-24;93;97;190;SEC_412
1996;614;18-24;90;87;177;SEC_614
1996;611;75 i +;37;23;60;SEC_611
1996;614;03-11;23;43;66;SEC_614
1996;320;00-02;6;4;10;SEC_320
1996;608;12-15;28;19;47;SEC_608
1996;407;50-64;118;106;224;SEC_407
1996;618;00-02;5;7;12;SEC_618
1996;625;12-15;74;55;129;SEC_625
1996;311;16-17;17;17;34;SEC_311
1996;122;03-11;28;10;38;SEC_122
1996;429;35-49;76;80;156;SEC_429
1996;527;18-24;57;40;97;SEC_527
1996;304;03-11;27;49;76;SEC_304
1996;534;25-34;79;80;159;SEC_534
1996;248;03-11;38;35;73;SEC_248
1996;101;18-24;66;59;125;SEC_101
1996;223;03-11;33;40;73;SEC_223
1996;102;65-74;86;63;149;SEC_102
1996;618;12-15;8;16;24;SEC_618
1996;108;75 i +;73;33;106;SEC_108
1996;210;16-17;14;6;20;SEC_210
1996;117;75 i +;44;20;64;SEC_117
1996;301;25-34;154;149;303;SEC_301
1996;511;35-49;46;52;98;SEC_511
1996;325;35-49;180;170;350;SEC_325
1996;246;12-15;20;12;32;SEC_246
1996;228;03-11;15;12;27;SEC_228
1996;502;00-02;15;11;26;SEC_502
1996;441;25-34;124;116;240;SEC_441
1996;116;25-34;127;138;265;SEC_116
1996;309;65-74;26;24;50;SEC_309
1996;305;50-64;97;105;202;SEC_305
1996;235;25-34;118;123;241;SEC_235
1996;516;03-11;19;14;33;SEC_516
1996;506;50-64;186;211;397;SEC_506
1996;536;00-02;9;9;18;SEC_536
1996;613;03-11;43;42;85;SEC_613
1996;434;03-11;25;21;46;SEC_434
1996;112;75 i +;53;23;76;SEC_112
1996;227;50-64;65;64;129;SEC_227
1996;235;12-15;13;22;35;SEC_235
1996;439;00-02;6;9;15;SEC_439
1996;432;03-11;43;53;96;SEC_432
1996;607;25-34;95;110;205;SEC_607
1996;529;16-17;13;8;21;SEC_529
1996;220;65-74;69;47;116;SEC_220
1996;103;00-02;6;8;14;SEC_103
1996;428;12-15;7;6;13;SEC_428
1996;423;50-64;133;126;259;SEC_423
1996;442;03-11;25;24;49;SEC_442
1996;121;35-49;53;56;109;SEC_121
1996;526;16-17;4;12;16;SEC_526
1996;512;50-64;107;117;224;SEC_512
1996;135;00-02;16;16;32;SEC_135
1996;627;35-49;188;154;342;SEC_627
1996;219;25-34;92;91;183;SEC_219
1996;420;00-02;17;13;30;SEC_420
1996;610;75 i +;32;21;53;SEC_610
1996;247;12-15;8;20;28;SEC_247
1996;411;18-24;71;72;143;SEC_411
1996;129;03-11;48;44;92;SEC_129
1996;411;75 i +;37;19;56;SEC_411
1996;226;65-74;90;67;157;SEC_226
1996;110;50-64;131;142;273;SEC_110
1996;529;12-15;20;21;41;SEC_529
1996;502;35-49;153;144;297;SEC_502
1996;114;12-15;48;43;91;SEC_114
1996;133;12-15;22;19;41;SEC_133
1996;401;25-34;73;89;162;SEC_401
1996;236;75 i +;42;37;79;SEC_236
1996;134;03-11;52;63;115;SEC_134
1996;531;12-15;9;21;30;SEC_531
1996;427;35-49;64;70;134;SEC_427
1996;521;50-64;126;175;301;SEC_521
1996;114;35-49;184;176;360;SEC_114
1996;509;16-17;9;5;14;SEC_509
1996;503;35-49;137;122;259;SEC_503
1996;410;12-15;41;37;78;SEC_410
1996;632;75 i +;28;8;36;SEC_632
1996;125;50-64;103;131;234;SEC_125
1996;609;18-24;102;92;194;SEC_609
1996;616;75 i +;21;15;36;SEC_616
1996;440;35-49;100;84;184;SEC_440
1996;123;03-11;42;42;84;SEC_123
1996;420;35-49;90;104;194;SEC_420
1996;245;65-74;70;53;123;SEC_245
1996;440;75 i +;47;31;78;SEC_440
1996;310;75 i +;22;12;34;SEC_310
1996;245;00-02;3;5;8;SEC_245
1996;605;75 i +;17;11;28;SEC_605
1996;115;16-17;16;17;33;SEC_115
1996;129;18-24;103;80;183;SEC_129
1996;129;65-74;42;36;78;SEC_129
1996;429;03-11;18;25;43;SEC_429
1996;314;50-64;130;146;276;SEC_314
1996;405;03-11;22;22;44;SEC_405
1996;209;18-24;35;37;72;SEC_209
1996;615;75 i +;25;11;36;SEC_615
1996;429;12-15;13;21;34;SEC_429
1996;109;50-64;103;99;202;SEC_109
1996;124;12-15;30;30;60;SEC_124
1996;126;00-02;10;5;15;SEC_126
1996;608;25-34;82;102;184;SEC_608
1996;624;50-64;137;165;302;SEC_624
1996;423;65-74;55;43;98;SEC_423
1996;626;25-34;92;117;209;SEC_626
1996;302;03-11;57;47;104;SEC_302
1996;603;35-49;57;50;107;SEC_603
1996;246;25-34;81;90;171;SEC_246
1996;628;75 i +;28;14;42;SEC_628
1996;104;25-34;51;81;132;SEC_104
1996;423;12-15;17;15;32;SEC_423
1996;613;65-74;48;39;87;SEC_613
1996;206;25-34;56;63;119;SEC_206
1996;611;03-11;65;50;115;SEC_611
1996;235;75 i +;57;40;97;SEC_235
1996;240;03-11;19;26;45;SEC_240
1996;437;65-74;41;40;81;SEC_437
1996;515;00-02;6;10;16;SEC_515
1996;233;03-11;21;17;38;SEC_233
1996;524;16-17;20;11;31;SEC_524
1996;533;18-24;54;53;107;SEC_533
1996;308;12-15;23;34;57;SEC_308
1996;119;65-74;66;56;122;SEC_119
1996;320;16-17;10;13;23;SEC_320
1996;431;12-15;28;32;60;SEC_431
1996;527;12-15;15;20;35;SEC_527
1996;115;03-11;43;64;107;SEC_115
1996;413;50-64;59;60;119;SEC_413
1996;602;75 i +;19;11;30;SEC_602
1996;136;12-15;33;40;73;SEC_136
1996;135;18-24;73;96;169;SEC_135
1996;426;65-74;55;45;100;SEC_426
1996;508;12-15;18;10;28;SEC_508
1996;614;12-15;21;19;40;SEC_614
1996;241;12-15;10;9;19;SEC_241
1996;235;35-49;92;92;184;SEC_235
1996;419;65-74;44;34;78;SEC_419
1996;514;03-11;34;22;56;SEC_514
1996;530;75 i +;57;30;87;SEC_530
1996;527;00-02;8;6;14;SEC_527
1996;608;50-64;118;85;203;SEC_608
1996;504;50-64;163;156;319;SEC_504
1996;130;35-49;58;58;116;SEC_130
1996;529;35-49;79;69;148;SEC_529
1996;621;18-24;150;199;349;SEC_621
1996;314;35-49;341;335;676;SEC_314
1996;121;12-15;9;10;19;SEC_121
1996;306;75 i +;56;32;88;SEC_306
1996;238;25-34;60;55;115;SEC_238
1996;402;50-64;96;99;195;SEC_402
1996;318;16-17;16;10;26;SEC_318
1996;619;50-64;155;166;321;SEC_619
1996;104;03-11;23;21;44;SEC_104
1996;118;50-64;112;135;247;SEC_118
1996;408;03-11;36;25;61;SEC_408
1996;105;00-02;7;15;22;SEC_105
1996;137;50-64;101;111;212;SEC_137
1996;631;35-49;139;92;231;SEC_631
1996;534;18-24;65;72;137;SEC_534
1996;119;03-11;46;60;106;SEC_119
1996;621;65-74;36;24;60;SEC_621
1996;432;00-02;9;11;20;SEC_432
1996;613;25-34;137;147;284;SEC_613
1996;104;18-24;42;46;88;SEC_104
1996;203;18-24;36;32;68;SEC_203
1996;107;35-49;190;179;369;SEC_107
1996;103;25-34;63;65;128;SEC_103
1996;613;75 i +;36;24;60;SEC_613
1996;137;16-17;30;20;50;SEC_137
1996;131;16-17;26;38;64;SEC_131
1996;438;12-15;18;11;29;SEC_438
1996;422;25-34;70;78;148;SEC_422
1996;231;35-49;78;68;146;SEC_231
1996;104;12-15;8;9;17;SEC_104
1996;110;12-15;24;26;50;SEC_110
1996;626;50-64;133;115;248;SEC_626
1996;529;75 i +;55;31;86;SEC_529
1996;248;00-02;10;8;18;SEC_248
1996;217;03-11;21;14;35;SEC_217
1996;237;50-64;141;132;273;SEC_237
1996;520;03-11;30;34;64;SEC_520
1996;310;00-02;8;10;18;SEC_310
1996;313;00-02;17;18;35;SEC_313
1996;134;12-15;30;27;57;SEC_134
1996;436;16-17;9;12;21;SEC_436
1996;628;65-74;41;33;74;SEC_628
1996;425;00-02;3;11;14;SEC_425
1996;632;25-34;91;107;198;SEC_632
1996;116;65-74;64;58;122;SEC_116
1996;511;25-34;56;77;133;SEC_511
1996;621;12-15;48;63;111;SEC_621
1996;321;65-74;84;72;156;SEC_321
1996;525;35-49;74;75;149;SEC_525
1996;136;16-17;17;17;34;SEC_136
1996;428;18-24;23;26;49;SEC_428
1996;607;18-24;72;77;149;SEC_607
1996;609;35-49;96;56;152;SEC_609
1996;614;65-74;44;34;78;SEC_614
1996;226;16-17;17;10;27;SEC_226
1996;533;75 i +;43;24;67;SEC_533
1996;522;18-24;36;49;85;SEC_522
1996;609;50-64;119;154;273;SEC_609
1996;237;18-24;64;75;139;SEC_237
1996;102;18-24;143;151;294;SEC_102
1996;532;12-15;20;25;45;SEC_532
1996;409;75 i +;17;10;27;SEC_409
1996;231;03-11;27;23;50;SEC_231
1996;424;50-64;69;66;135;SEC_424
1996;316;75 i +;25;15;40;SEC_316
1996;237;16-17;19;9;28;SEC_237
1996;513;18-24;40;48;88;SEC_513
1996;204;35-49;41;42;83;SEC_204
1996;221;18-24;75;66;141;SEC_221
1996;321;18-24;160;146;306;SEC_321
1996;619;12-15;44;38;82;SEC_619
1996;136;25-34;90;95;185;SEC_136
1996;506;25-34;142;159;301;SEC_506
1996;103;35-49;80;69;149;SEC_103
1996;211;12-15;11;23;34;SEC_211
1996;314;00-02;24;25;49;SEC_314
1996;313;18-24;113;119;232;SEC_313
1996;519;16-17;1;7;8;SEC_519
1996;420;50-64;139;125;264;SEC_420
1996;243;16-17;14;9;23;SEC_243
1996;405;25-34;78;88;166;SEC_405
1996;118;03-11;85;83;168;SEC_118
1996;140;16-17;10;20;30;SEC_140
1996;622;18-24;80;81;161;SEC_622
1996;430;65-74;58;44;102;SEC_430
1996;442;50-64;64;62;126;SEC_442
1996;404;03-11;45;39;84;SEC_404
1996;530;65-74;97;72;169;SEC_530
1996;515;03-11;27;23;50;SEC_515
1996;536;16-17;9;10;19;SEC_536
1996;139;65-74;31;26;57;SEC_139
1996;216;00-02;12;13;25;SEC_216
1996;223;18-24;57;54;111;SEC_223
1996;520;75 i +;34;23;57;SEC_520
1996;410;50-64;208;187;395;SEC_410
1996;307;75 i +;38;22;60;SEC_307
1996;515;18-24;36;35;71;SEC_515
1996;105;50-64;73;85;158;SEC_105
1996;221;65-74;59;59;118;SEC_221
1996;620;35-49;77;65;142;SEC_620
1996;122;00-02;11;5;16;SEC_122
1996;521;35-49;157;112;269;SEC_521
1996;406;50-64;143;137;280;SEC_406
1996;243;12-15;27;18;45;SEC_243
1996;315;16-17;21;28;49;SEC_315
1996;236;35-49;90;79;169;SEC_236
1996;419;50-64;79;72;151;SEC_419
1996;117;12-15;59;67;126;SEC_117
1996;201;16-17;11;9;20;SEC_201
1996;121;50-64;94;61;155;SEC_121
1996;617;18-24;86;117;203;SEC_617
1996;533;16-17;8;7;15;SEC_533
1996;110;00-02;10;15;25;SEC_110
1996;527;16-17;6;13;19;SEC_527
1996;127;18-24;27;30;57;SEC_127
1996;426;50-64;81;76;157;SEC_426
1996;435;25-34;62;80;142;SEC_435
1996;211;16-17;8;10;18;SEC_211
1996;108;50-64;107;98;205;SEC_108
1996;519;12-15;9;14;23;SEC_519
1996;204;00-02;6;6;12;SEC_204
1996;303;03-11;36;48;84;SEC_303
1996;102;75 i +;67;31;98;SEC_102
1996;226;25-34;65;75;140;SEC_226
1996;226;00-02;6;5;11;SEC_226
1996;224;35-49;57;59;116;SEC_224
1996;527;35-49;82;87;169;SEC_527
1996;414;18-24;51;57;108;SEC_414
1996;524;35-49;93;97;190;SEC_524
1996;628;00-02;9;6;15;SEC_628
1996;129;50-64;106;123;229;SEC_129
1996;605;00-02;2;8;10;SEC_605
1996;406;03-11;55;50;105;SEC_406
1996;223;75 i +;50;23;73;SEC_223
1996;415;18-24;30;36;66;SEC_415
1996;322;75 i +;34;14;48;SEC_322
1996;413;00-02;5;4;9;SEC_413
1996;523;50-64;161;144;305;SEC_523
1996;438;25-34;71;86;157;SEC_438
1996;428;00-02;5;7;12;SEC_428
1996;230;12-15;10;8;18;SEC_230
1996;512;75 i +;34;16;50;SEC_512
1996;232;12-15;10;15;25;SEC_232
1996;538;12-15;19;22;41;SEC_538
1996;422;35-49;89;104;193;SEC_422
1996;313;03-11;90;81;171;SEC_313
1996;219;16-17;10;9;19;SEC_219
1996;241;16-17;12;5;17;SEC_241
1996;234;75 i +;69;30;99;SEC_234
1996;431;35-49;125;128;253;SEC_431
1996;630;75 i +;23;7;30;SEC_630
1996;119;50-64;132;153;285;SEC_119
1996;436;75 i +;28;17;45;SEC_436
1996;614;00-02;10;12;22;SEC_614
1996;625;75 i +;16;10;26;SEC_625
1996;628;03-11;38;37;75;SEC_628
1996;134;35-49;147;142;289;SEC_134
1996;202;16-17;12;11;23;SEC_202
1996;501;25-34;65;71;136;SEC_501
1996;133;03-11;26;36;62;SEC_133
1996;311;65-74;92;71;163;SEC_311
1996;220;12-15;14;12;26;SEC_220
1996;322;16-17;15;23;38;SEC_322
1996;219;00-02;7;8;15;SEC_219
1996;220;00-02;4;5;9;SEC_220
1996;439;25-34;117;111;228;SEC_439
1996;219;75 i +;70;30;100;SEC_219
1996;629;16-17;13;10;23;SEC_629
1996;131;03-11;62;66;128;SEC_131
1996;320;65-74;45;23;68;SEC_320
1996;601;03-11;49;59;108;SEC_601
1996;239;16-17;13;10;23;SEC_239
1996;616;18-24;177;176;353;SEC_616
1996;426;16-17;12;17;29;SEC_426
1996;535;65-74;34;27;61;SEC_535
1996;521;18-24;122;141;263;SEC_521
1996;432;35-49;162;136;298;SEC_432
1996;510;35-49;84;91;175;SEC_510
1996;215;35-49;70;68;138;SEC_215
1996;435;16-17;9;15;24;SEC_435
1996;511;75 i +;29;9;38;SEC_511
1996;529;18-24;59;61;120;SEC_529
1996;507;16-17;17;16;33;SEC_507
1996;319;00-02;7;13;20;SEC_319
1996;408;18-24;46;51;97;SEC_408
1996;513;12-15;12;4;16;SEC_513
1996;431;00-02;9;14;23;SEC_431
1996;244;03-11;15;15;30;SEC_244
1996;530;25-34;120;125;245;SEC_530
1996;205;18-24;45;53;98;SEC_205
1996;322;65-74;63;58;121;SEC_322
1996;604;25-34;73;92;165;SEC_604
1996;122;18-24;50;64;114;SEC_122
1996;222;18-24;40;70;110;SEC_222
1996;120;50-64;91;109;200;SEC_120
1996;518;35-49;71;85;156;SEC_518
1996;311;00-02;10;17;27;SEC_311
1996;322;18-24;92;76;168;SEC_322
1996;218;18-24;37;41;78;SEC_218
1996;530;35-49;103;99;202;SEC_530
1996;418;75 i +;53;36;89;SEC_418
1996;321;03-11;94;114;208;SEC_321
1996;607;65-74;55;41;96;SEC_607
1996;317;35-49;60;82;142;SEC_317
1996;101;12-15;38;35;73;SEC_101
1996;601;00-02;12;11;23;SEC_601
1996;509;75 i +;41;18;59;SEC_509
1996;133;00-02;4;10;14;SEC_133
1996;323;16-17;59;60;119;SEC_323
1996;131;18-24;112;136;248;SEC_131
1996;117;00-02;24;21;45;SEC_117
1996;430;35-49;61;71;132;SEC_430
1996;208;65-74;137;107;244;SEC_208
1996;501;75 i +;22;10;32;SEC_501
1996;325;25-34;146;132;278;SEC_325
1996;435;03-11;41;45;86;SEC_435
1996;518;03-11;29;38;67;SEC_518
1996;108;65-74;96;83;179;SEC_108
1996;505;16-17;29;16;45;SEC_505
1996;204;25-34;44;46;90;SEC_204
1996;617;65-74;46;44;90;SEC_617
1996;125;65-74;56;32;88;SEC_125
1996;439;50-64;111;108;219;SEC_439
1996;201;25-34;46;56;102;SEC_201
1996;218;50-64;70;70;140;SEC_218
1996;112;18-24;100;100;200;SEC_112
1996;311;50-64;136;139;275;SEC_311
1996;424;25-34;38;60;98;SEC_424
1996;127;00-02;11;7;18;SEC_127
1996;416;35-49;48;44;92;SEC_416
1996;433;75 i +;34;21;55;SEC_433
1996;613;50-64;202;228;430;SEC_613
1996;249;18-24;54;58;112;SEC_249
1996;129;12-15;27;19;46;SEC_129
1996;623;12-15;38;54;92;SEC_623
1996;314;03-11;116;153;269;SEC_314
1996;132;75 i +;54;24;78;SEC_132
1996;508;18-24;47;30;77;SEC_508
1996;245;35-49;79;84;163;SEC_245
1996;315;65-74;53;46;99;SEC_315
1996;111;00-02;6;9;15;SEC_111
1996;411;65-74;80;75;155;SEC_411
1996;135;75 i +;37;16;53;SEC_135
1996;441;12-15;63;66;129;SEC_441
1996;140;18-24;72;70;142;SEC_140
1996;632;65-74;36;35;71;SEC_632
1996;319;25-34;69;65;134;SEC_319
1996;608;75 i +;25;8;33;SEC_608
1996;206;75 i +;57;30;87;SEC_206
1996;216;12-15;24;25;49;SEC_216
1996;232;16-17;11;12;23;SEC_232
1996;405;18-24;42;56;98;SEC_405
1996;507;18-24;62;67;129;SEC_507
1996;627;75 i +;18;10;28;SEC_627
1996;239;03-11;18;33;51;SEC_239
1996;611;12-15;26;29;55;SEC_611
1996;234;18-24;32;41;73;SEC_234
1996;122;75 i +;36;19;55;SEC_122
1996;524;00-02;12;13;25;SEC_524
1996;505;18-24;154;146;300;SEC_505
1996;521;25-34;68;79;147;SEC_521
1996;114;65-74;60;49;109;SEC_114
1996;439;75 i +;41;18;59;SEC_439
1996;517;35-49;92;96;188;SEC_517
1996;408;50-64;93;85;178;SEC_408
1996;415;03-11;20;24;44;SEC_415
1996;222;12-15;20;20;40;SEC_222
1996;241;03-11;31;25;56;SEC_241
1996;315;18-24;104;75;179;SEC_315
1996;238;35-49;65;73;138;SEC_238
1996;611;25-34;172;190;362;SEC_611
1996;510;16-17;5;6;11;SEC_510
1996;309;50-64;60;59;119;SEC_309
1996;530;00-02;11;10;21;SEC_530
1996;616;16-17;40;44;84;SEC_616
1996;224;16-17;7;8;15;SEC_224
1996;521;12-15;28;26;54;SEC_521
1996;210;50-64;108;88;196;SEC_210
1996;216;50-64;144;123;267;SEC_216
1996;134;16-17;16;19;35;SEC_134
1996;211;35-49;78;97;175;SEC_211
1996;435;65-74;118;82;200;SEC_435
1996;321;35-49;332;316;648;SEC_321
1996;319;35-49;107;99;206;SEC_319
1996;437;75 i +;17;8;25;SEC_437
1996;531;00-02;8;5;13;SEC_531
1996;524;18-24;86;73;159;SEC_524
1996;117;25-34;146;128;274;SEC_117
1996;213;75 i +;23;11;34;SEC_213
1996;615;03-11;19;23;42;SEC_615
1996;243;50-64;153;128;281;SEC_243
1996;318;50-64;56;56;112;SEC_318
1996;625;35-49;230;216;446;SEC_625
1996;135;35-49;184;178;362;SEC_135
1996;504;03-11;24;36;60;SEC_504
1996;306;18-24;76;71;147;SEC_306
1996;231;75 i +;72;29;101;SEC_231
1996;323;35-49;404;395;799;SEC_323
1996;238;00-02;2;12;14;SEC_238
1996;517;12-15;26;26;52;SEC_517
1996;601;18-24;114;129;243;SEC_601
1996;246;16-17;12;7;19;SEC_246
1996;441;65-74;110;88;198;SEC_441
1996;535;50-64;129;152;281;SEC_535
1996;139;18-24;63;73;136;SEC_139
1996;110;18-24;115;110;225;SEC_110
1996;232;00-02;6;5;11;SEC_232
1996;537;12-15;23;27;50;SEC_537
1996;223;25-34;101;91;192;SEC_223
1996;211;00-02;15;16;31;SEC_211
1996;437;03-11;31;39;70;SEC_437
1996;110;25-34;83;89;172;SEC_110
1996;511;16-17;7;7;14;SEC_511
1996;210;03-11;25;26;51;SEC_210
1996;536;75 i +;25;28;53;SEC_536
1996;519;75 i +;14;12;26;SEC_519
1996;510;65-74;56;38;94;SEC_510
1996;115;50-64;100;106;206;SEC_115
1996;418;00-02;13;13;26;SEC_418
1996;313;16-17;43;29;72;SEC_313
1996;241;00-02;7;7;14;SEC_241
1996;236;00-02;9;4;13;SEC_236
1996;135;25-34;118;112;230;SEC_135
1996;249;00-02;5;10;15;SEC_249
1996;247;50-64;106;111;217;SEC_247
1996;408;75 i +;27;18;45;SEC_408
1996;528;35-49;95;84;179;SEC_528
1996;301;03-11;63;74;137;SEC_301
1996;427;18-24;45;54;99;SEC_427
1996;131;50-64;125;131;256;SEC_131
1996;121;00-02;11;6;17;SEC_121
1996;210;75 i +;48;37;85;SEC_210
1996;242;18-24;43;54;97;SEC_242
1996;620;25-34;52;50;102;SEC_620
1996;108;12-15;27;27;54;SEC_108
1996;223;65-74;72;56;128;SEC_223
1996;140;35-49;85;73;158;SEC_140
1996;204;03-11;11;22;33;SEC_204
1996;437;50-64;93;88;181;SEC_437
1996;139;75 i +;27;6;33;SEC_139
1996;621;35-49;239;209;448;SEC_621
1996;125;18-24;104;111;215;SEC_125
1996;203;16-17;4;6;10;SEC_203
1996;233;25-34;69;70;139;SEC_233
1996;109;65-74;42;42;84;SEC_109
1996;214;18-24;38;50;88;SEC_214
1996;229;35-49;48;47;95;SEC_229
1996;403;18-24;72;84;156;SEC_403
1996;613;18-24;143;128;271;SEC_613
1996;325;75 i +;119;62;181;SEC_325
1996;218;25-34;57;59;116;SEC_218
1996;537;00-02;14;9;23;SEC_537
1996;436;50-64;77;59;136;SEC_436
1996;219;50-64;109;107;216;SEC_219
1996;216;65-74;83;64;147;SEC_216
1996;413;12-15;8;9;17;SEC_413
1996;405;35-49;45;61;106;SEC_405
1996;109;12-15;20;41;61;SEC_109
1996;436;03-11;27;28;55;SEC_436
1996;233;16-17;7;9;16;SEC_233
1996;401;16-17;18;16;34;SEC_401
1996;518;25-34;91;101;192;SEC_518
1996;211;18-24;42;55;97;SEC_211
1996;418;50-64;130;116;246;SEC_418
1996;425;25-34;79;71;150;SEC_425
1996;214;65-74;41;36;77;SEC_214
1996;518;12-15;13;18;31;SEC_518
1996;535;00-02;8;6;14;SEC_535
1996;631;16-17;21;14;35;SEC_631
1996;249;12-15;15;25;40;SEC_249
1996;121;25-34;87;101;188;SEC_121
1996;621;03-11;59;69;128;SEC_621
1996;526;12-15;16;14;30;SEC_526
1996;242;16-17;10;8;18;SEC_242
1996;133;75 i +;39;29;68;SEC_133
1996;222;35-49;79;75;154;SEC_222
1996;318;75 i +;9;7;16;SEC_318
1996;519;35-49;36;34;70;SEC_519
1996;233;65-74;55;34;89;SEC_233
1996;624;18-24;130;154;284;SEC_624
1996;130;65-74;76;64;140;SEC_130
1996;312;50-64;125;133;258;SEC_312
1996;125;35-49;165;136;301;SEC_125
1996;535;18-24;99;119;218;SEC_535
1996;242;50-64;125;106;231;SEC_242
1996;105;35-49;176;160;336;SEC_105
1996;411;12-15;27;13;40;SEC_411
1996;411;16-17;18;17;35;SEC_411
1996;110;65-74;51;39;90;SEC_110
1996;606;00-02;11;12;23;SEC_606
1996;411;25-34;77;75;152;SEC_411
1996;520;65-74;46;47;93;SEC_520
1996;205;75 i +;32;15;47;SEC_205
1996;525;12-15;15;26;41;SEC_525
1996;211;25-34;108;107;215;SEC_211
1996;410;18-24;124;122;246;SEC_410
1996;324;16-17;10;9;19;SEC_324
1996;317;16-17;7;9;16;SEC_317
1996;507;03-11;41;36;77;SEC_507
1996;513;16-17;10;14;24;SEC_513
1996;616;00-02;14;11;25;SEC_616
1996;133;50-64;84;77;161;SEC_133
1996;630;12-15;37;35;72;SEC_630
1996;430;00-02;8;11;19;SEC_430
1996;502;18-24;93;129;222;SEC_502
1996;529;50-64;142;145;287;SEC_529
1996;116;00-02;22;13;35;SEC_116
1996;427;25-34;72;70;142;SEC_427
1996;536;25-34;88;81;169;SEC_536
1996;123;12-15;27;31;58;SEC_123
1996;215;75 i +;63;39;102;SEC_215
1996;224;75 i +;37;16;53;SEC_224
1996;213;16-17;17;13;30;SEC_213
1996;227;00-02;7;5;12;SEC_227
1996;614;75 i +;40;16;56;SEC_614
1996;249;35-49;91;92;183;SEC_249
1996;626;65-74;43;53;96;SEC_626
1996;237;00-02;12;11;23;SEC_237
1996;316;50-64;112;146;258;SEC_316
1996;111;12-15;17;13;30;SEC_111
1996;435;35-49;72;94;166;SEC_435
1996;239;18-24;59;59;118;SEC_239
1996;324;75 i +;45;13;58;SEC_324
1996;426;03-11;32;34;66;SEC_426
1996;133;25-34;68;77;145;SEC_133
1996;607;75 i +;33;11;44;SEC_607
1996;118;00-02;17;23;40;SEC_118
1996;120;00-02;14;13;27;SEC_120
1996;223;35-49;90;87;177;SEC_223
1996;516;35-49;45;56;101;SEC_516
1996;309;75 i +;21;9;30;SEC_309
1996;128;18-24;87;73;160;SEC_128
1996;236;12-15;13;16;29;SEC_236
1996;507;75 i +;31;20;51;SEC_507
1996;505;35-49;140;98;238;SEC_505
1996;246;18-24;53;46;99;SEC_246
1996;104;75 i +;54;28;82;SEC_104
1996;436;12-15;12;11;23;SEC_436
1996;627;00-02;5;9;14;SEC_627
1996;201;35-49;60;47;107;SEC_201
1996;314;25-34;187;176;363;SEC_314
1996;521;65-74;49;39;88;SEC_521
1996;243;03-11;37;48;85;SEC_243
1996;207;16-17;9;7;16;SEC_207
1996;244;75 i +;38;20;58;SEC_244
1996;534;00-02;7;9;16;SEC_534
1996;517;50-64;129;114;243;SEC_517
1996;430;75 i +;43;19;62;SEC_430
1996;215;03-11;25;20;45;SEC_215
1996;249;25-34;93;94;187;SEC_249
1996;522;25-34;56;54;110;SEC_522
1996;435;50-64;86;76;162;SEC_435
1996;410;03-11;42;45;87;SEC_410
1996;603;03-11;20;25;45;SEC_603
1996;616;65-74;45;35;80;SEC_616
1996;204;50-64;54;50;104;SEC_204
1996;127;35-49;92;89;181;SEC_127
1996;107;03-11;64;70;134;SEC_107
1996;117;50-64;138;161;299;SEC_117
1996;629;18-24;43;53;96;SEC_629
1996;406;00-02;11;13;24;SEC_406
1996;409;00-02;1;7;8;SEC_409
1996;403;65-74;52;51;103;SEC_403
1996;536;35-49;72;75;147;SEC_536
1996;419;25-34;74;75;149;SEC_419
1996;502;65-74;74;70;144;SEC_502
1996;116;75 i +;52;14;66;SEC_116
1996;233;50-64;89;76;165;SEC_233
1996;438;16-17;2;10;12;SEC_438
1996;116;12-15;53;37;90;SEC_116
1996;416;03-11;18;20;38;SEC_416
1996;309;16-17;17;12;29;SEC_309
1996;503;16-17;17;18;35;SEC_503
1996;103;16-17;6;15;21;SEC_103
1996;601;75 i +;63;21;84;SEC_601
1996;123;16-17;22;12;34;SEC_123
1996;137;65-74;43;35;78;SEC_137
1996;316;35-49;481;419;900;SEC_316
1996;215;18-24;43;47;90;SEC_215
1996;117;18-24;123;162;285;SEC_117
1996;531;16-17;8;8;16;SEC_531
1996;525;65-74;43;37;80;SEC_525
1996;424;03-11;18;15;33;SEC_424
1996;528;00-02;11;14;25;SEC_528
1996;610;65-74;64;47;111;SEC_610
1996;305;65-74;83;60;143;SEC_305
1996;213;00-02;4;8;12;SEC_213
1996;626;03-11;36;39;75;SEC_626
1996;525;25-34;71;77;148;SEC_525
1996;302;35-49;197;174;371;SEC_302
1996;622;12-15;31;30;61;SEC_622
1996;311;35-49;131;102;233;SEC_311
1996;620;03-11;25;29;54;SEC_620
1996;244;35-49;51;53;104;SEC_244
1996;105;03-11;52;66;118;SEC_105
1996;623;65-74;47;33;80;SEC_623
1996;520;00-02;13;8;21;SEC_520
1996;101;50-64;78;84;162;SEC_101
1996;413;25-34;45;53;98;SEC_413
1996;204;12-15;6;10;16;SEC_204
1996;317;03-11;33;37;70;SEC_317
1996;530;50-64;154;134;288;SEC_530
1996;434;50-64;50;52;102;SEC_434
1996;538;75 i +;49;25;74;SEC_538
1996;537;03-11;43;42;85;SEC_537
1996;416;75 i +;19;11;30;SEC_416
1996;624;12-15;34;32;66;SEC_624
1996;517;18-24;62;78;140;SEC_517
1996;247;35-49;92;107;199;SEC_247
1996;307;25-34;95;78;173;SEC_307
1996;607;50-64;162;152;314;SEC_607
1996;308;50-64;137;135;272;SEC_308
1996;310;65-74;39;32;71;SEC_310
1996;318;65-74;21;18;39;SEC_318
1996;228;12-15;10;12;22;SEC_228
1996;620;12-15;23;14;37;SEC_620
1996;513;25-34;62;70;132;SEC_513
1996;223;00-02;13;10;23;SEC_223
1996;440;18-24;117;95;212;SEC_440
1996;231;12-15;11;13;24;SEC_231
1996;138;35-49;117;119;236;SEC_138
1996;228;25-34;65;58;123;SEC_228
1996;601;16-17;19;43;62;SEC_601
1996;140;75 i +;32;17;49;SEC_140
1996;404;25-34;104;123;227;SEC_404
1996;516;65-74;29;22;51;SEC_516
1996;138;75 i +;17;11;28;SEC_138
1996;238;03-11;19;24;43;SEC_238
1996;615;00-02;5;4;9;SEC_615
1996;632;18-24;105;112;217;SEC_632
1996;114;75 i +;52;17;69;SEC_114
1996;606;18-24;58;60;118;SEC_606
1996;409;18-24;40;47;87;SEC_409
1996;124;18-24;69;53;122;SEC_124
1996;130;12-15;13;12;25;SEC_130
1996;403;00-02;1;6;7;SEC_403
1996;136;35-49;145;141;286;SEC_136
1996;521;16-17;22;29;51;SEC_521
1996;127;65-74;38;30;68;SEC_127
1996;217;50-64;46;47;93;SEC_217
1996;315;12-15;41;40;81;SEC_315
1996;305;18-24;67;68;135;SEC_305
1996;127;75 i +;26;14;40;SEC_127
1996;631;50-64;140;165;305;SEC_631
1996;609;12-15;15;22;37;SEC_609
1996;603;65-74;24;24;48;SEC_603
1996;210;65-74;86;66;152;SEC_210
1996;307;50-64;147;137;284;SEC_307
1996;309;35-49;87;74;161;SEC_309
1996;324;00-02;11;10;21;SEC_324
1996;242;03-11;32;27;59;SEC_242
1996;524;03-11;46;46;92;SEC_524
1996;430;03-11;24;33;57;SEC_430
1996;435;00-02;7;9;16;SEC_435
1996;503;03-11;54;46;100;SEC_503
1996;248;25-34;98;101;199;SEC_248
1996;210;35-49;84;84;168;SEC_210
1996;432;25-34;79;83;162;SEC_432
1996;430;18-24;50;44;94;SEC_430
1996;442;12-15;11;11;22;SEC_442
1996;510;12-15;20;25;45;SEC_510
1996;113;25-34;76;73;149;SEC_113
1996;404;35-49;104;114;218;SEC_404
1996;244;18-24;33;25;58;SEC_244
1996;112;35-49;188;182;370;SEC_112
1996;126;65-74;60;38;98;SEC_126
1996;415;00-02;10;13;23;SEC_415
1996;132;35-49;259;229;488;SEC_132
1996;417;75 i +;17;14;31;SEC_417
1996;628;35-49;134;97;231;SEC_628
1996;509;12-15;18;14;32;SEC_509
1996;630;35-49;135;121;256;SEC_630
1996;535;03-11;51;48;99;SEC_535
1996;202;12-15;11;11;22;SEC_202
1996;612;12-15;24;25;49;SEC_612
1996;619;35-49;172;149;321;SEC_619
1996;228;50-64;79;70;149;SEC_228
1996;414;03-11;25;37;62;SEC_414
1996;123;50-64;105;107;212;SEC_123
1996;127;50-64;58;55;113;SEC_127
1996;235;03-11;27;34;61;SEC_235
1996;247;25-34;102;101;203;SEC_247
1996;111;75 i +;31;22;53;SEC_111
1996;207;75 i +;45;22;67;SEC_207
1996;225;12-15;8;11;19;SEC_225
1996;625;25-34;84;95;179;SEC_625
1996;249;50-64;118;96;214;SEC_249
1996;248;18-24;46;56;102;SEC_248
1996;239;75 i +;65;32;97;SEC_239
1996;442;16-17;5;11;16;SEC_442
1996;510;25-34;94;104;198;SEC_510
1996;607;16-17;11;14;25;SEC_607
1996;418;16-17;10;17;27;SEC_418
1996;534;75 i +;41;21;62;SEC_534
1996;307;12-15;53;39;92;SEC_307
1996;421;03-11;25;33;58;SEC_421
1996;404;75 i +;57;25;82;SEC_404
1996;305;25-34;79;101;180;SEC_305
1996;407;03-11;23;45;68;SEC_407
1996;314;65-74;67;58;125;SEC_314
1996;130;00-02;6;4;10;SEC_130
1996;612;25-34;100;121;221;SEC_612
1996;312;03-11;62;35;97;SEC_312
1996;519;25-34;64;67;131;SEC_519
1996;120;18-24;97;94;191;SEC_120
1996;214;03-11;21;20;41;SEC_214
1996;606;65-74;61;46;107;SEC_606
1996;608;35-49;95;92;187;SEC_608
1996;218;75 i +;36;16;52;SEC_218
1996;602;50-64;96;89;185;SEC_602
1996;422;03-11;27;44;71;SEC_422
1996;110;03-11;52;49;101;SEC_110
1996;128;75 i +;32;18;50;SEC_128
1996;313;75 i +;53;30;83;SEC_313
1996;437;16-17;12;9;21;SEC_437
1996;405;50-64;139;97;236;SEC_405
1996;436;25-34;76;85;161;SEC_436
1996;308;03-11;44;47;91;SEC_308
1996;515;50-64;55;61;116;SEC_515
1996;231;25-34;95;87;182;SEC_231
1996;140;12-15;16;12;28;SEC_140
1996;510;50-64;126;117;243;SEC_510
1996;612;35-49;86;79;165;SEC_612
1996;244;00-02;6;2;8;SEC_244
1996;137;25-34;97;100;197;SEC_137
1996;114;00-02;16;16;32;SEC_114
1996;513;00-02;3;6;9;SEC_513
1996;440;12-15;23;17;40;SEC_440
1996;622;25-34;77;95;172;SEC_622
1996;124;50-64;77;81;158;SEC_124
1996;420;65-74;77;55;132;SEC_420
1996;135;03-11;67;65;132;SEC_135
1996;534;65-74;53;45;98;SEC_534
1996;538;18-24;71;75;146;SEC_538
1996;420;03-11;38;44;82;SEC_420
1996;322;50-64;103;104;207;SEC_322
1996;113;16-17;14;24;38;SEC_113
1996;116;50-64;148;166;314;SEC_116
1996;222;00-02;9;8;17;SEC_222
1996;632;16-17;24;19;43;SEC_632
1996;436;65-74;37;27;64;SEC_436
1996;240;18-24;39;32;71;SEC_240
1996;523;25-34;109;103;212;SEC_523
1996;415;50-64;61;70;131;SEC_415
1996;210;12-15;6;13;19;SEC_210
1996;128;25-34;81;97;178;SEC_128
1996;514;12-15;16;19;35;SEC_514
1996;209;25-34;88;89;177;SEC_209
1996;412;12-15;57;47;104;SEC_412
1996;511;18-24;45;42;87;SEC_511
1996;503;12-15;29;35;64;SEC_503
1996;301;12-15;33;47;80;SEC_301
1996;127;25-34;70;64;134;SEC_127
1996;230;75 i +;39;14;53;SEC_230
1996;406;25-34;100;105;205;SEC_406
1996;106;16-17;41;37;78;SEC_106
1996;223;16-17;7;14;21;SEC_223
1996;425;03-11;30;29;59;SEC_425
1996;438;65-74;29;27;56;SEC_438
1996;324;03-11;43;36;79;SEC_324
1996;249;16-17;11;10;21;SEC_249
1996;224;03-11;19;20;39;SEC_224
1996;617;12-15;30;34;64;SEC_617
1996;205;16-17;18;14;32;SEC_205
1996;615;18-24;101;118;219;SEC_615
1996;627;16-17;31;28;59;SEC_627
1996;529;65-74;71;62;133;SEC_529
1996;426;00-02;5;11;16;SEC_426
1996;229;16-17;6;6;12;SEC_229
1996;610;16-17;22;20;42;SEC_610
1996;137;12-15;38;27;65;SEC_137
1996;301;65-74;91;77;168;SEC_301
1996;506;18-24;187;191;378;SEC_506
1996;136;50-64;100;87;187;SEC_136
1996;614;50-64;123;138;261;SEC_614
1996;213;35-49;99;92;191;SEC_213
1996;623;35-49;201;167;368;SEC_623
1996;311;03-11;44;35;79;SEC_311
1996;246;03-11;30;22;52;SEC_246
1996;432;18-24;80;93;173;SEC_432
1996;206;65-74;59;48;107;SEC_206
1996;537;50-64;150;138;288;SEC_537
1996;631;75 i +;26;17;43;SEC_631
1996;522;00-02;4;6;10;SEC_522
1996;121;03-11;28;20;48;SEC_121
1996;317;00-02;11;15;26;SEC_317
1996;410;75 i +;57;40;97;SEC_410
1996;418;12-15;24;21;45;SEC_418
1996;415;16-17;10;6;16;SEC_415
1996;243;35-49;116;120;236;SEC_243
1996;428;75 i +;29;19;48;SEC_428
1996;137;18-24;94;98;192;SEC_137
1996;619;16-17;25;29;54;SEC_619
1996;106;50-64;118;143;261;SEC_106
1996;123;35-49;119;114;233;SEC_123
1996;508;00-02;7;9;16;SEC_508
1996;101;03-11;56;70;126;SEC_101
1996;108;00-02;12;10;22;SEC_108
1996;511;65-74;55;46;101;SEC_511
1996;507;25-34;72;84;156;SEC_507
1996;115;75 i +;35;21;56;SEC_115
1996;138;65-74;25;25;50;SEC_138
1996;125;25-34;85;83;168;SEC_125
1996;221;50-64;119;125;244;SEC_221
1996;421;25-34;107;117;224;SEC_421
1996;220;16-17;11;6;17;SEC_220
1996;207;18-24;26;30;56;SEC_207
1996;212;18-24;75;74;149;SEC_212
1996;209;16-17;7;4;11;SEC_209
1996;320;35-49;81;59;140;SEC_320
1996;203;65-74;66;49;115;SEC_203
1996;602;65-74;23;24;47;SEC_602
1996;205;50-64;89;88;177;SEC_205
1996;504;12-15;20;14;34;SEC_504
1996;614;35-49;102;78;180;SEC_614
1996;431;65-74;86;78;164;SEC_431
1996;519;00-02;5;5;10;SEC_519
1996;240;25-34;48;59;107;SEC_240
1996;116;16-17;21;30;51;SEC_116
1996;508;65-74;40;34;74;SEC_508
1996;208;12-15;24;46;70;SEC_208
1996;247;00-02;7;10;17;SEC_247
1996;247;75 i +;57;33;90;SEC_247
1996;134;00-02;12;15;27;SEC_134
1996;310;16-17;12;14;26;SEC_310
1996;415;25-34;72;60;132;SEC_415
1996;506;35-49;261;218;479;SEC_506
1996;130;18-24;39;53;92;SEC_130
1996;107;75 i +;49;26;75;SEC_107
1996;112;12-15;41;30;71;SEC_112
1996;307;16-17;28;25;53;SEC_307
1996;626;35-49;107;111;218;SEC_626
1996;620;50-64;87;96;183;SEC_620
1996;133;18-24;61;60;121;SEC_133
1996;244;16-17;5;5;10;SEC_244
1996;431;16-17;25;18;43;SEC_431
1996;206;12-15;17;12;29;SEC_206
1996;603;18-24;56;62;118;SEC_603
1996;323;75 i +;36;12;48;SEC_323
1996;617;75 i +;19;18;37;SEC_617
1996;324;25-34;71;68;139;SEC_324
1996;214;00-02;1;12;13;SEC_214
1996;512;03-11;27;33;60;SEC_512
1996;413;03-11;23;25;48;SEC_413
1996;629;50-64;74;63;137;SEC_629
1996;616;12-15;60;41;101;SEC_616
1996;629;25-34;56;57;113;SEC_629
1996;505;00-02;15;11;26;SEC_505
1996;130;75 i +;66;24;90;SEC_130
1996;213;03-11;30;38;68;SEC_213
1996;425;16-17;10;6;16;SEC_425
1996;416;16-17;7;13;20;SEC_416
1996;304;00-02;12;13;25;SEC_304
1996;122;50-64;134;122;256;SEC_122
1996;122;12-15;13;8;21;SEC_122
1996;128;00-02;9;9;18;SEC_128
1996;133;65-74;53;47;100;SEC_133
1996;308;00-02;9;16;25;SEC_308
1996;234;12-15;15;17;32;SEC_234
1996;520;50-64;87;97;184;SEC_520
1996;433;25-34;108;110;218;SEC_433
1996;421;12-15;21;25;46;SEC_421
1996;536;18-24;53;55;108;SEC_536
1996;604;18-24;62;59;121;SEC_604
1996;205;25-34;54;59;113;SEC_205
1996;511;12-15;6;11;17;SEC_511
1996;310;25-34;70;69;139;SEC_310
1996;214;75 i +;35;18;53;SEC_214
1996;238;65-74;62;50;112;SEC_238
1996;509;00-02;7;14;21;SEC_509
1996;322;00-02;16;12;28;SEC_322
1996;505;25-34;114;123;237;SEC_505
1996;302;12-15;31;36;67;SEC_302
1996;321;50-64;162;190;352;SEC_321
1996;234;25-34;72;79;151;SEC_234
1996;418;25-34;96;107;203;SEC_418
1996;119;16-17;19;30;49;SEC_119
1996;239;50-64;131;102;233;SEC_239
1996;134;75 i +;61;26;87;SEC_134
1996;615;12-15;18;6;24;SEC_615
1996;243;00-02;23;17;40;SEC_243
1996;226;75 i +;71;34;105;SEC_226
1996;233;75 i +;73;33;106;SEC_233
1996;234;50-64;101;74;175;SEC_234
1996;102;50-64;195;201;396;SEC_102
1996;433;12-15;21;27;48;SEC_433
1996;129;16-17;13;13;26;SEC_129
1996;442;00-02;8;4;12;SEC_442
1996;125;03-11;45;41;86;SEC_125
1996;234;03-11;28;26;54;SEC_234
1996;630;50-64;79;93;172;SEC_630
1996;407;18-24;48;59;107;SEC_407
1996;403;12-15;33;23;56;SEC_403
1996;529;03-11;23;37;60;SEC_529
1996;401;18-24;59;75;134;SEC_401
1996;425;65-74;67;64;131;SEC_425
1996;627;03-11;40;62;102;SEC_627
1996;223;50-64;123;117;240;SEC_223
1996;215;50-64;92;72;164;SEC_215
1996;532;18-24;95;104;199;SEC_532
1996;242;65-74;81;84;165;SEC_242
1996;106;75 i +;34;23;57;SEC_106
1996;609;16-17;19;15;34;SEC_609
1996;416;25-34;68;72;140;SEC_416
1996;537;25-34;96;106;202;SEC_537
1996;117;65-74;62;45;107;SEC_117
1996;412;00-02;16;19;35;SEC_412
1996;125;75 i +;16;21;37;SEC_125
1996;219;12-15;12;31;43;SEC_219
1996;409;25-34;59;63;122;SEC_409
1996;512;18-24;54;56;110;SEC_512
1996;248;35-49;94;93;187;SEC_248
1996;124;35-49;130;102;232;SEC_124
1996;428;16-17;2;4;6;SEC_428
1996;516;12-15;16;5;21;SEC_516
1996;125;16-17;19;27;46;SEC_125
1996;408;35-49;88;90;178;SEC_408
1996;114;25-34;138;164;302;SEC_114
1996;126;75 i +;39;14;53;SEC_126
1996;230;18-24;44;31;75;SEC_230
1996;302;18-24;121;120;241;SEC_302
1996;425;35-49;81;74;155;SEC_425
1996;112;16-17;28;24;52;SEC_112
1996;531;03-11;34;30;64;SEC_531
1996;515;75 i +;24;11;35;SEC_515
1996;608;03-11;37;56;93;SEC_608
1996;627;50-64;81;108;189;SEC_627
1996;610;50-64;187;223;410;SEC_610
1996;516;25-34;62;66;128;SEC_516
1996;433;16-17;9;11;20;SEC_433
1996;435;75 i +;87;37;124;SEC_435
1996;618;16-17;11;7;18;SEC_618
1996;618;65-74;28;24;52;SEC_618
1996;220;25-34;77;61;138;SEC_220
1996;102;16-17;28;33;61;SEC_102
1996;402;03-11;19;19;38;SEC_402
1996;227;65-74;52;44;96;SEC_227
1996;531;65-74;55;47;102;SEC_531
1996;626;00-02;13;12;25;SEC_626
1996;621;25-34;117;115;232;SEC_621
1996;321;00-02;21;26;47;SEC_321
1996;325;03-11;44;54;98;SEC_325
1996;128;12-15;27;26;53;SEC_128
1996;305;03-11;89;63;152;SEC_305
1996;209;50-64;105;96;201;SEC_209
1996;523;00-02;6;16;22;SEC_523
1996;406;65-74;60;58;118;SEC_406
1996;126;12-15;23;17;40;SEC_126
1996;301;35-49;142;160;302;SEC_301
1996;505;03-11;38;39;77;SEC_505
1996;218;00-02;10;2;12;SEC_218
1996;506;65-74;65;65;130;SEC_506
1996;417;00-02;2;5;7;SEC_417
1996;221;03-11;36;43;79;SEC_221
1996;442;35-49;68;58;126;SEC_442
1996;213;50-64;83;84;167;SEC_213
1996;432;65-74;66;56;122;SEC_432
1996;428;50-64;53;43;96;SEC_428
1996;104;16-17;11;12;23;SEC_104
1996;301;00-02;12;20;32;SEC_301
1996;408;16-17;15;13;28;SEC_408
1996;107;00-02;14;13;27;SEC_107
1996;507;12-15;19;13;32;SEC_507
1996;306;16-17;21;26;47;SEC_306
1996;419;75 i +;34;18;52;SEC_419
1996;123;25-34;90;97;187;SEC_123
1996;630;65-74;28;19;47;SEC_630
1996;602;18-24;40;50;90;SEC_602
1996;602;00-02;7;6;13;SEC_602
1996;321;16-17;46;47;93;SEC_321
1996;231;65-74;85;66;151;SEC_231
1996;438;03-11;30;26;56;SEC_438
1996;304;65-74;101;66;167;SEC_304
1996;402;75 i +;41;24;65;SEC_402
1996;414;25-34;76;76;152;SEC_414
1996;437;12-15;15;20;35;SEC_437
1996;323;25-34;198;187;385;SEC_323
1996;509;03-11;25;23;48;SEC_509
1996;520;25-34;63;60;123;SEC_520
1996;538;35-49;91;97;188;SEC_538
1996;506;16-17;38;35;73;SEC_506
1996;313;25-34;148;156;304;SEC_313
1996;606;35-49;77;81;158;SEC_606
1996;212;50-64;132;129;261;SEC_212
1996;321;12-15;77;67;144;SEC_321
1996;610;25-34;108;129;237;SEC_610
1996;429;18-24;39;49;88;SEC_429
1996;107;25-34;134;158;292;SEC_107
1996;410;35-49;166;160;326;SEC_410
1996;534;35-49;84;78;162;SEC_534
1996;613;35-49;111;76;187;SEC_613
1996;213;65-74;55;50;105;SEC_213
1996;439;03-11;35;32;67;SEC_439
1996;413;35-49;53;48;101;SEC_413
1996;108;16-17;15;15;30;SEC_108
1996;207;03-11;19;18;37;SEC_207
1996;412;25-34;109;129;238;SEC_412
1996;625;00-02;7;12;19;SEC_625
1996;528;25-34;98;111;209;SEC_528
1996;603;12-15;12;13;25;SEC_603
1996;315;00-02;19;11;30;SEC_315
1996;524;50-64;139;123;262;SEC_524
1996;419;00-02;10;9;19;SEC_419
1996;212;65-74;79;60;139;SEC_212
1996;417;25-34;53;47;100;SEC_417
1996;438;35-49;66;65;131;SEC_438
1996;105;18-24;80;73;153;SEC_105
1996;409;50-64;84;83;167;SEC_409
1996;421;18-24;71;71;142;SEC_421
1996;117;03-11;91;88;179;SEC_117
1996;115;65-74;76;49;125;SEC_115
1996;608;18-24;75;109;184;SEC_608
1996;105;25-34;74;76;150;SEC_105
1996;108;18-24;74;66;140;SEC_108
1996;317;50-64;68;72;140;SEC_317
1996;407;75 i +;24;22;46;SEC_407
1996;631;65-74;35;35;70;SEC_631
1996;313;35-49;242;226;468;SEC_313
1996;238;12-15;13;12;25;SEC_238
1996;421;35-49;89;76;165;SEC_421
1996;526;35-49;63;61;124;SEC_526
1996;201;00-02;6;10;16;SEC_201
1996;420;18-24;74;73;147;SEC_420
1996;215;16-17;9;14;23;SEC_215
1996;626;18-24;89;118;207;SEC_626
1996;427;00-02;8;9;17;SEC_427
1996;129;00-02;13;7;20;SEC_129
1996;137;00-02;14;15;29;SEC_137
1996;209;00-02;7;11;18;SEC_209
1996;314;12-15;75;76;151;SEC_314
1996;302;75 i +;42;21;63;SEC_302
1996;508;16-17;7;7;14;SEC_508
1996;304;25-34;88;101;189;SEC_304
1996;315;50-64;104;116;220;SEC_315
1996;404;16-17;11;6;17;SEC_404
1996;245;03-11;30;28;58;SEC_245
1996;104;35-49;77;55;132;SEC_104
1996;532;75 i +;56;35;91;SEC_532
1996;105;12-15;25;34;59;SEC_105
1996;630;25-34;62;73;135;SEC_630
1996;418;03-11;39;38;77;SEC_418
1996;309;18-24;41;56;97;SEC_309
1996;304;50-64;112;107;219;SEC_304
1996;417;35-49;61;57;118;SEC_417
1996;230;65-74;64;50;114;SEC_230
1996;318;00-02;14;11;25;SEC_318
1996;504;25-34;92;107;199;SEC_504
1996;128;16-17;15;15;30;SEC_128
1996;609;03-11;31;41;72;SEC_609
1996;517;65-74;50;49;99;SEC_517
1996;101;16-17;18;25;43;SEC_101
1996;605;25-34;70;70;140;SEC_605
1996;312;16-17;13;3;16;SEC_312
1996;609;65-74;30;25;55;SEC_609
1996;621;00-02;20;16;36;SEC_621
1996;516;50-64;75;65;140;SEC_516
1996;411;35-49;100;93;193;SEC_411
1996;227;18-24;45;41;86;SEC_227
1996;117;16-17;34;42;76;SEC_117
1996;135;16-17;21;33;54;SEC_135
1996;612;65-74;52;39;91;SEC_612
1996;616;25-34;105;119;224;SEC_616
1996;131;00-02;20;14;34;SEC_131
1996;303;16-17;17;15;32;SEC_303
1996;630;00-02;3;9;12;SEC_630
1996;516;16-17;4;11;15;SEC_516
1996;413;65-74;37;34;71;SEC_413
1996;249;75 i +;52;25;77;SEC_249
1996;405;12-15;12;10;22;SEC_405
1996;427;03-11;20;30;50;SEC_427
1996;101;35-49;145;133;278;SEC_101
1996;237;12-15;27;19;46;SEC_237
1996;234;00-02;5;7;12;SEC_234
1996;532;25-34;101;106;207;SEC_532
1996;115;35-49;168;160;328;SEC_115
1996;402;16-17;7;7;14;SEC_402
1996;442;75 i +;25;18;43;SEC_442
1996;244;50-64;60;48;108;SEC_244
1996;427;65-74;62;60;122;SEC_427
1996;421;75 i +;47;32;79;SEC_421
1996;414;75 i +;35;21;56;SEC_414
1996;435;12-15;12;21;33;SEC_435
1996;128;50-64;100;104;204;SEC_128
1996;206;50-64;106;87;193;SEC_206
1996;318;03-11;47;59;106;SEC_318
1996;241;18-24;35;30;65;SEC_241
1996;139;35-49;99;103;202;SEC_139
1996;425;50-64;101;96;197;SEC_425
1996;441;18-24;113;141;254;SEC_441
1996;519;50-64;69;54;123;SEC_519
1996;246;00-02;21;8;29;SEC_246
1996;528;18-24;86;83;169;SEC_528
1996;515;35-49;50;39;89;SEC_515
1996;525;75 i +;32;23;55;SEC_525
1996;306;25-34;120;122;242;SEC_306
1996;506;03-11;86;106;192;SEC_506
1996;420;75 i +;66;40;106;SEC_420
1996;612;50-64;178;180;358;SEC_612
1996;212;25-34;118;116;234;SEC_212
1996;221;35-49;98;93;191;SEC_221
1996;118;65-74;43;29;72;SEC_118
1996;128;65-74;42;41;83;SEC_128
1996;132;16-17;37;53;90;SEC_132
1996;307;03-11;56;76;132;SEC_307
1996;138;16-17;14;20;34;SEC_138
1996;206;16-17;7;8;15;SEC_206
1996;131;25-34;110;120;230;SEC_131
1996;518;75 i +;49;27;76;SEC_518
1996;442;65-74;40;28;68;SEC_442
1996;402;18-24;49;47;96;SEC_402
1996;122;65-74;46;34;80;SEC_122
1996;510;18-24;86;70;156;SEC_510
1996;619;00-02;10;14;24;SEC_619
1996;525;00-02;9;5;14;SEC_525
1996;240;75 i +;40;12;52;SEC_240
1996;534;50-64;92;99;191;SEC_534
1996;123;65-74;76;63;139;SEC_123
1996;229;50-64;67;66;133;SEC_229
1996;208;35-49;177;157;334;SEC_208
1996;517;03-11;39;41;80;SEC_517
1996;408;12-15;19;25;44;SEC_408
1996;215;00-02;11;7;18;SEC_215
1996;301;18-24;138;151;289;SEC_301
1996;625;50-64;111;118;229;SEC_625
1996;209;12-15;9;13;22;SEC_209
1996;114;16-17;32;30;62;SEC_114
1996;241;35-49;51;58;109;SEC_241
1996;631;18-24;127;149;276;SEC_631
1996;403;50-64;163;153;316;SEC_403
1996;437;25-34;63;78;141;SEC_437
1996;120;12-15;39;44;83;SEC_120
1996;403;16-17;17;12;29;SEC_403
1996;126;35-49;110;87;197;SEC_126
1996;309;25-34;63;55;118;SEC_309
1996;538;25-34;102;96;198;SEC_538
1996;229;65-74;58;44;102;SEC_229
1996;426;18-24;57;61;118;SEC_426
1996;125;12-15;23;33;56;SEC_125
1996;418;35-49;96;107;203;SEC_418
1996;216;25-34;85;92;177;SEC_216
1996;136;03-11;55;47;102;SEC_136
1996;202;18-24;42;39;81;SEC_202
1996;211;50-64;104;79;183;SEC_211
1996;202;03-11;17;25;42;SEC_202
1996;509;65-74;24;27;51;SEC_509
1996;319;16-17;13;16;29;SEC_319
1996;528;50-64;137;139;276;SEC_528
1996;440;25-34;62;86;148;SEC_440
1996;426;25-34;83;94;177;SEC_426
1996;531;25-34;79;80;159;SEC_531
1996;602;35-49;32;32;64;SEC_602
1996;436;00-02;7;12;19;SEC_436
1996;524;12-15;19;29;48;SEC_524
1996;203;75 i +;48;27;75;SEC_203
1996;404;50-64;158;130;288;SEC_404
1996;240;35-49;60;52;112;SEC_240
1996;523;03-11;34;36;70;SEC_523
1996;222;03-11;39;38;77;SEC_222
1996;441;35-49;277;269;546;SEC_441
1996;432;12-15;28;38;66;SEC_432
1996;411;50-64;117;109;226;SEC_411
1996;138;00-02;8;10;18;SEC_138
1996;131;12-15;45;32;77;SEC_131
1996;228;16-17;6;6;12;SEC_228
1996;122;16-17;6;7;13;SEC_122
1996;309;12-15;16;16;32;SEC_309
1996;325;00-02;18;11;29;SEC_325
1996;623;75 i +;47;23;70;SEC_623
1996;245;25-34;62;70;132;SEC_245
1996;605;65-74;30;32;62;SEC_605
1996;224;00-02;7;9;16;SEC_224
1996;614;16-17;9;20;29;SEC_614
1996;226;12-15;22;21;43;SEC_226
1996;526;75 i +;23;16;39;SEC_526
1996;440;65-74;58;43;101;SEC_440
1996;537;75 i +;42;26;68;SEC_537
1996;217;75 i +;42;18;60;SEC_217
1996;126;25-34;89;104;193;SEC_126
1996;244;25-34;55;59;114;SEC_244
1996;127;16-17;7;17;24;SEC_127
1996;422;75 i +;54;32;86;SEC_422
1996;618;25-34;46;50;96;SEC_618
1996;532;00-02;14;9;23;SEC_532
1996;218;35-49;80;67;147;SEC_218
1996;517;75 i +;51;28;79;SEC_517
1996;517;16-17;11;14;25;SEC_517
1996;229;12-15;4;10;14;SEC_229
1996;116;18-24;143;130;273;SEC_116
1996;224;25-34;46;57;103;SEC_224
1996;613;00-02;14;8;22;SEC_613
1996;616;35-49;174;175;349;SEC_616
1996;527;03-11;41;30;71;SEC_527
1996;615;16-17;12;20;32;SEC_615
1996;516;75 i +;27;10;37;SEC_516
1996;513;75 i +;39;14;53;SEC_513
1996;531;50-64;91;95;186;SEC_531
1996;405;00-02;9;13;22;SEC_405
1996;320;75 i +;26;19;45;SEC_320
1996;515;65-74;34;24;58;SEC_515
1996;404;12-15;28;26;54;SEC_404
1996;219;35-49;103;89;192;SEC_219
1996;109;25-34;95;95;190;SEC_109
1996;104;65-74;74;48;122;SEC_104
1996;128;03-11;34;37;71;SEC_128
1996;317;18-24;40;50;90;SEC_317
1996;203;25-34;55;58;113;SEC_203
1996;224;65-74;42;32;74;SEC_224
1996;246;50-64;95;87;182;SEC_246
1996;208;03-11;49;44;93;SEC_208
1996;216;35-49;129;111;240;SEC_216
1996;533;65-74;44;51;95;SEC_533
1996;432;16-17;26;17;43;SEC_432
1996;234;65-74;78;58;136;SEC_234
1996;434;75 i +;51;33;84;SEC_434
1996;429;65-74;39;34;73;SEC_429
1996;431;18-24;91;88;179;SEC_431
1996;136;00-02;16;10;26;SEC_136
1996;211;03-11;35;41;76;SEC_211
1996;308;25-34;96;102;198;SEC_308
1996;409;65-74;32;29;61;SEC_409
1996;238;16-17;4;9;13;SEC_238
1996;103;50-64;75;64;139;SEC_103
1996;503;50-64;68;73;141;SEC_503
1996;622;35-49;123;114;237;SEC_622
1996;603;50-64;78;76;154;SEC_603
1996;416;50-64;92;92;184;SEC_416
1996;407;16-17;13;14;27;SEC_407
1996;316;65-74;35;32;67;SEC_316
1996;627;65-74;30;21;51;SEC_627
1996;132;03-11;89;84;173;SEC_132
1996;106;12-15;73;63;136;SEC_106
1996;203;00-02;4;3;7;SEC_203
1996;235;18-24;82;63;145;SEC_235
1996;417;18-24;38;53;91;SEC_417
1996;213;25-34;56;82;138;SEC_213
1996;137;75 i +;33;12;45;SEC_137
1996;606;12-15;28;24;52;SEC_606
1996;507;65-74;41;35;76;SEC_507
1996;118;25-34;128;133;261;SEC_118
1996;113;03-11;67;60;127;SEC_113
1996;240;65-74;62;46;108;SEC_240
1996;208;75 i +;106;63;169;SEC_208
1996;534;16-17;11;17;28;SEC_534
1996;237;03-11;33;31;64;SEC_237
1996;422;50-64;91;88;179;SEC_422
1996;248;12-15;14;24;38;SEC_248
1996;138;03-11;30;56;86;SEC_138
1996;208;16-17;23;19;42;SEC_208
1996;220;03-11;17;25;42;SEC_220
1996;515;25-34;58;51;109;SEC_515
1996;623;50-64;174;196;370;SEC_623
1996;619;25-34;110;141;251;SEC_619
1996;410;16-17;25;24;49;SEC_410
1996;417;03-11;28;26;54;SEC_417
1996;117;35-49;285;262;547;SEC_117
1996;522;35-49;67;53;120;SEC_522
1996;219;65-74;86;64;150;SEC_219
1996;618;50-64;67;78;145;SEC_618
1996;605;50-64;129;117;246;SEC_605
1996;441;03-11;123;109;232;SEC_441
1996;318;18-24;36;60;96;SEC_318
1996;630;03-11;40;36;76;SEC_630
1996;221;16-17;14;18;32;SEC_221
1996;404;18-24;72;71;143;SEC_404
1996;204;65-74;53;36;89;SEC_204
1996;629;35-49;60;56;116;SEC_629
1996;230;50-64;83;79;162;SEC_230
1996;140;65-74;64;59;123;SEC_140
1996;622;00-02;9;20;29;SEC_622
1996;217;25-34;50;52;102;SEC_217
1996;314;16-17;37;39;76;SEC_314
1996;226;03-11;31;34;65;SEC_226
1996;524;25-34;107;110;217;SEC_524
1996;207;65-74;67;45;112;SEC_207
1996;438;50-64;110;112;222;SEC_438
1996;248;65-74;76;54;130;SEC_248
1996;225;00-02;2;4;6;SEC_225
1996;241;65-74;67;51;118;SEC_241
1996;220;18-24;39;40;79;SEC_220
1996;128;35-49;107;93;200;SEC_128
1996;513;65-74;41;30;71;SEC_513
1996;323;12-15;96;106;202;SEC_323
1996;302;50-64;130;147;277;SEC_302
1996;106;00-02;15;15;30;SEC_106
1996;226;35-49;103;89;192;SEC_226
1996;120;35-49;225;224;449;SEC_120
1996;107;12-15;42;49;91;SEC_107
1996;214;25-34;60;69;129;SEC_214
1996;247;03-11;34;44;78;SEC_247
1996;203;35-49;53;58;111;SEC_203
1996;437;00-02;12;6;18;SEC_437
1996;225;16-17;4;14;18;SEC_225
1996;132;00-02;21;25;46;SEC_132
1996;243;18-24;62;60;122;SEC_243
1996;229;25-34;55;52;107;SEC_229
1996;514;50-64;88;73;161;SEC_514
1996;241;25-34;60;52;112;SEC_241
1996;605;12-15;10;12;22;SEC_605
1996;501;50-64;97;133;230;SEC_501
1996;109;18-24;57;44;101;SEC_109
1996;243;75 i +;83;38;121;SEC_243
1996;508;75 i +;19;14;33;SEC_508
1996;431;75 i +;60;35;95;SEC_431
1996;108;35-49;153;136;289;SEC_108
1996;106;03-11;81;86;167;SEC_106
1996;624;00-02;10;10;20;SEC_624
1996;237;25-34;101;122;223;SEC_237
1996;505;65-74;48;44;92;SEC_505
1996;323;03-11;119;118;237;SEC_323
1996;133;35-49;99;87;186;SEC_133
1996;316;00-02;14;19;33;SEC_316
1996;522;65-74;43;36;79;SEC_522
1996;412;03-11;62;57;119;SEC_412
1996;511;00-02;5;11;16;SEC_511
1996;217;35-49;53;54;107;SEC_217
1996;514;18-24;46;42;88;SEC_514
1996;214;50-64;77;65;142;SEC_214
1996;205;12-15;19;19;38;SEC_205
1996;414;50-64;97;106;203;SEC_414
1996;103;65-74;40;37;77;SEC_103
1996;407;35-49;79;73;152;SEC_407
1996;222;75 i +;31;20;51;SEC_222
1996;103;12-15;25;18;43;SEC_103
1996;107;50-64;185;196;381;SEC_107
1996;612;03-11;37;40;77;SEC_612
1996;111;35-49;118;91;209;SEC_111
1996;526;65-74;41;26;67;SEC_526
1996;108;03-11;49;43;92;SEC_108
1996;325;65-74;122;95;217;SEC_325
1996;429;50-64;68;47;115;SEC_429
1996;239;25-34;86;89;175;SEC_239
1996;207;50-64;69;54;123;SEC_207
1996;228;18-24;37;40;77;SEC_228
1996;237;35-49;107;107;214;SEC_237
1996;108;25-34;92;96;188;SEC_108
1996;521;03-11;38;36;74;SEC_521
1996;217;00-02;4;7;11;SEC_217
1996;235;16-17;12;15;27;SEC_235
1996;527;25-34;76;90;166;SEC_527
1996;518;00-02;10;13;23;SEC_518
1996;232;25-34;70;71;141;SEC_232
1996;434;12-15;12;14;26;SEC_434
1996;124;25-34;51;62;113;SEC_124
1996;231;00-02;8;12;20;SEC_231
1996;106;65-74;48;37;85;SEC_106
1996;137;03-11;60;65;125;SEC_137
1996;626;12-15;20;21;41;SEC_626
1996;305;16-17;24;14;38;SEC_305
1996;118;16-17;39;43;82;SEC_118
1996;622;65-74;36;26;62;SEC_622
1996;204;75 i +;27;16;43;SEC_204
1996;535;75 i +;31;21;52;SEC_535
1996;613;16-17;14;17;31;SEC_613
1996;622;50-64;68;67;135;SEC_622
1996;227;75 i +;41;18;59;SEC_227
1996;210;18-24;52;60;112;SEC_210
1996;512;35-49;63;61;124;SEC_512
1996;629;00-02;3;9;12;SEC_629
1996;519;18-24;31;35;66;SEC_519
1996;503;75 i +;17;9;26;SEC_503
1996;114;50-64;201;203;404;SEC_114
1996;118;75 i +;21;16;37;SEC_118
1996;439;35-49;47;59;106;SEC_439
1996;311;12-15;15;29;44;SEC_311
1996;124;03-11;40;35;75;SEC_124
1996;113;65-74;40;31;71;SEC_113
1996;502;50-64;154;159;313;SEC_502
1996;421;65-74;60;60;120;SEC_421
1996;512;16-17;5;10;15;SEC_512
1996;631;12-15;24;26;50;SEC_631
1996;241;50-64;73;64;137;SEC_241
1996;213;18-24;58;64;122;SEC_213
1996;231;18-24;58;57;115;SEC_231
1996;302;00-02;15;21;36;SEC_302
1996;606;03-11;50;48;98;SEC_606
1996;306;03-11;51;73;124;SEC_306
1996;608;00-02;14;11;25;SEC_608
1996;520;18-24;71;64;135;SEC_520
1996;538;00-02;5;11;16;SEC_538
1996;623;18-24;140;164;304;SEC_623
1996;201;75 i +;33;11;44;SEC_201
1996;239;35-49;90;78;168;SEC_239
1996;136;75 i +;43;23;66;SEC_136
1996;609;75 i +;31;14;45;SEC_609
1996;120;03-11;82;91;173;SEC_120
1996;304;12-15;16;12;28;SEC_304
1996;619;18-24;108;95;203;SEC_619
1996;631;00-02;12;7;19;SEC_631
1996;417;16-17;13;7;20;SEC_417
1996;202;25-34;56;89;145;SEC_202
1996;301;16-17;25;30;55;SEC_301
1996;307;00-02;10;11;21;SEC_307
1996;507;35-49;91;81;172;SEC_507
1996;415;12-15;18;14;32;SEC_415
1996;110;35-49;181;146;327;SEC_110
1996;230;35-49;41;48;89;SEC_230
1996;248;50-64;95;96;191;SEC_248
1996;236;03-11;29;28;57;SEC_236
1996;245;50-64;103;84;187;SEC_245
1996;612;00-02;6;13;19;SEC_612
1996;411;00-02;9;6;15;SEC_411
1996;504;00-02;7;7;14;SEC_504
1996;109;16-17;17;20;37;SEC_109
1996;509;25-34;67;72;139;SEC_509
1996;522;16-17;5;8;13;SEC_522
1996;235;50-64;158;140;298;SEC_235
1996;628;25-34;77;81;158;SEC_628
1996;236;25-34;72;85;157;SEC_236
1996;224;50-64;58;44;102;SEC_224
1996;615;35-49;94;59;153;SEC_615
1996;422;65-74;93;69;162;SEC_422
1996;235;65-74;118;83;201;SEC_235
1996;215;12-15;15;13;28;SEC_215
1996;426;35-49;80;85;165;SEC_426
1996;248;75 i +;63;42;105;SEC_248
1996;413;75 i +;31;14;45;SEC_413
1996;442;18-24;42;43;85;SEC_442
1996;111;25-34;77;88;165;SEC_111
1996;115;12-15;42;39;81;SEC_115
1996;419;18-24;43;56;99;SEC_419
1996;119;75 i +;36;28;64;SEC_119
1996;604;35-49;69;63;132;SEC_604
1996;218;03-11;21;30;51;SEC_218
1996;303;12-15;28;27;55;SEC_303
1996;236;65-74;90;68;158;SEC_236
1996;118;18-24;146;157;303;SEC_118
1996;429;25-34;34;41;75;SEC_429
1996;617;00-02;12;16;28;SEC_617
1996;111;18-24;63;97;160;SEC_111
1996;303;35-49;127;107;234;SEC_303
1996;242;00-02;9;6;15;SEC_242
1996;320;25-34;67;84;151;SEC_320
1996;225;25-34;28;25;53;SEC_225
1996;431;03-11;47;51;98;SEC_431
1996;508;25-34;43;59;102;SEC_508
1996;107;65-74;70;57;127;SEC_107
1996;316;12-15;125;130;255;SEC_316
1996;533;00-02;8;7;15;SEC_533
1996;420;25-34;100;112;212;SEC_420
1996;537;35-49;119;104;223;SEC_537
1996;118;12-15;62;68;130;SEC_118
1996;324;12-15;19;11;30;SEC_324
1996;113;18-24;77;64;141;SEC_113
1996;245;18-24;41;64;105;SEC_245
1996;430;12-15;11;20;31;SEC_430
1996;401;50-64;126;114;240;SEC_401
1996;126;16-17;13;16;29;SEC_126
1996;319;75 i +;30;15;45;SEC_319
1996;538;16-17;14;12;26;SEC_538
1996;316;18-24;145;146;291;SEC_316
1996;234;35-49;77;68;145;SEC_234
1996;227;03-11;13;13;26;SEC_227
1996;506;75 i +;49;23;72;SEC_506
1996;401;65-74;95;81;176;SEC_401
1996;616;03-11;55;77;132;SEC_616
1996;509;35-49;63;66;129;SEC_509
1996;525;18-24;55;49;104;SEC_525
1996;134;18-24;83;80;163;SEC_134
1996;105;16-17;34;24;58;SEC_105
1996;120;75 i +;31;23;54;SEC_120
1996;232;35-49;89;66;155;SEC_232
1996;418;65-74;72;53;125;SEC_418
1996;405;75 i +;31;20;51;SEC_405
1996;424;12-15;8;15;23;SEC_424
1996;514;35-49;63;73;136;SEC_514
1996;129;75 i +;35;14;49;SEC_129
1996;513;35-49;50;59;109;SEC_513
1996;210;25-34;56;62;118;SEC_210
1996;201;18-24;33;46;79;SEC_201
1996;607;35-49;82;86;168;SEC_607
1996;602;03-11;18;14;32;SEC_602
1996;402;65-74;47;47;94;SEC_402
1996;611;65-74;78;61;139;SEC_611
1996;535;35-49;145;135;280;SEC_535
1996;406;75 i +;43;33;76;SEC_406
1996;507;50-64;79;101;180;SEC_507
1996;225;18-24;27;26;53;SEC_225
1996;129;35-49;102;103;205;SEC_129
1996;505;75 i +;41;24;65;SEC_505
1996;320;50-64;124;128;252;SEC_320
1996;602;12-15;15;13;28;SEC_602
1996;628;16-17;19;27;46;SEC_628
1996;522;03-11;19;25;44;SEC_522
1996;410;25-34;114;120;234;SEC_410
1996;140;00-02;5;5;10;SEC_140
1996;632;00-02;21;21;42;SEC_632
1996;106;18-24;128;158;286;SEC_106
1996;102;12-15;35;24;59;SEC_102
1996;242;12-15;15;18;33;SEC_242
1996;229;00-02;6;8;14;SEC_229
1996;520;35-49;93;77;170;SEC_520
1996;123;75 i +;56;33;89;SEC_123
1996;514;00-02;11;10;21;SEC_514
1996;212;16-17;11;20;31;SEC_212
1996;228;65-74;46;34;80;SEC_228
1996;632;35-49;107;99;206;SEC_632
1996;608;65-74;39;36;75;SEC_608
1996;312;65-74;35;33;68;SEC_312
1996;517;25-34;108;110;218;SEC_517
1996;519;65-74;34;37;71;SEC_519
1996;618;03-11;16;19;35;SEC_618
1996;139;50-64;75;75;150;SEC_139
1996;304;18-24;54;71;125;SEC_304
1996;429;75 i +;30;17;47;SEC_429
1996;615;50-64;143;162;305;SEC_615
1996;121;65-74;91;80;171;SEC_121
1996;534;03-11;23;30;53;SEC_534
1996;239;65-74;93;71;164;SEC_239
1996;423;75 i +;39;18;57;SEC_423
1996;121;18-24;30;34;64;SEC_121
1996;619;75 i +;35;18;53;SEC_619
1996;310;50-64;67;71;138;SEC_310
1996;232;50-64;108;89;197;SEC_232
1996;318;12-15;28;25;53;SEC_318
1996;212;12-15;23;22;45;SEC_212
1996;209;65-74;78;64;142;SEC_209
1996;416;18-24;38;44;82;SEC_416
1996;124;65-74;36;31;67;SEC_124
1996;112;00-02;23;6;29;SEC_112
1996;214;35-49;46;50;96;SEC_214
1996;227;25-34;48;46;94;SEC_227
1996;403;35-49;112;89;201;SEC_403
1996;322;35-49;135;126;261;SEC_322
1996;519;03-11;19;25;44;SEC_519
1996;605;16-17;7;13;20;SEC_605
1996;437;35-49;74;77;151;SEC_437
1996;625;18-24;108;114;222;SEC_625
1996;205;00-02;4;7;11;SEC_205
1996;115;00-02;10;21;31;SEC_115
1996;524;65-74;65;52;117;SEC_524
1996;604;12-15;14;18;32;SEC_604
1996;303;00-02;12;12;24;SEC_303
1996;325;12-15;33;24;57;SEC_325
1996;416;12-15;15;11;26;SEC_416
1996;239;12-15;16;13;29;SEC_239
1996;606;25-34;118;124;242;SEC_606
1996;412;50-64;186;174;360;SEC_412
1996;229;03-11;14;26;40;SEC_229
1996;510;03-11;35;41;76;SEC_510
1996;512;00-02;11;8;19;SEC_512
1996;432;75 i +;26;17;43;SEC_432
1996;218;16-17;10;13;23;SEC_218
1996;107;16-17;38;31;69;SEC_107
1996;208;18-24;80;100;180;SEC_208
1996;620;00-02;3;4;7;SEC_620
1996;611;16-17;16;19;35;SEC_611
1996;308;75 i +;53;36;89;SEC_308
1996;530;16-17;9;16;25;SEC_530
1996;428;03-11;21;14;35;SEC_428
1996;507;00-02;6;9;15;SEC_507
1996;307;18-24;111;108;219;SEC_307
1996;243;65-74;92;90;182;SEC_243
1996;532;65-74;91;82;173;SEC_532
1996;107;18-24;129;144;273;SEC_107
1996;125;00-02;7;12;19;SEC_125
1996;618;75 i +;21;12;33;SEC_618
1996;516;00-02;8;10;18;SEC_516
1996;101;75 i +;18;5;23;SEC_101
1996;104;50-64;81;78;159;SEC_104
1996;322;12-15;36;23;59;SEC_322
1996;242;35-49;87;89;176;SEC_242
1996;230;25-34;76;84;160;SEC_230
1996;221;12-15;18;21;39;SEC_221
1996;518;18-24;67;66;133;SEC_518
1996;120;25-34;110;109;219;SEC_120
1996;310;12-15;26;29;55;SEC_310
1996;624;35-49;153;104;257;SEC_624
1996;201;03-11;20;18;38;SEC_201
1996;231;16-17;12;10;22;SEC_231
1996;205;65-74;53;38;91;SEC_205
1996;245;12-15;20;13;33;SEC_245
1996;240;50-64;72;79;151;SEC_240
1996;119;25-34;99;99;198;SEC_119
1996;411;03-11;31;22;53;SEC_411
1996;527;65-74;63;39;102;SEC_527
1996;423;03-11;28;34;62;SEC_423
1996;201;50-64;89;80;169;SEC_201
1996;131;35-49;203;182;385;SEC_131
1996;213;12-15;21;24;45;SEC_213
1996;204;18-24;26;22;48;SEC_204
1996;210;00-02;10;4;14;SEC_210
1996;423;00-02;8;6;14;SEC_423
1996;508;03-11;21;21;42;SEC_508
1996;434;25-34;35;34;69;SEC_434
1996;132;12-15;54;74;128;SEC_132
1996;424;75 i +;17;12;29;SEC_424
1996;129;25-34;93;88;181;SEC_129
1996;201;65-74;40;38;78;SEC_201
1996;419;12-15;14;13;27;SEC_419
1996;206;35-49;69;66;135;SEC_206
1996;412;35-49;197;198;395;SEC_412
1996;244;12-15;9;10;19;SEC_244
1996;113;35-49;178;171;349;SEC_113
1996;324;50-64;71;73;144;SEC_324
1996;414;65-74;68;55;123;SEC_414
1996;216;03-11;26;34;60;SEC_216
1996;601;50-64;184;186;370;SEC_601
1996;313;50-64;165;150;315;SEC_313
1996;245;16-17;10;14;24;SEC_245
1996;620;16-17;16;15;31;SEC_620
1996;632;50-64;105;99;204;SEC_632
1996;214;16-17;9;5;14;SEC_214
1996;434;00-02;4;5;9;SEC_434
1996;527;50-64;105;98;203;SEC_527
1996;219;03-11;48;37;85;SEC_219
1996;616;50-64;123;130;253;SEC_616
1996;403;25-34;77;100;177;SEC_403
1996;216;75 i +;42;29;71;SEC_216
1996;604;50-64;91;77;168;SEC_604
1996;206;00-02;5;6;11;SEC_206
1996;402;00-02;3;2;5;SEC_402
1996;434;18-24;23;22;45;SEC_434
1996;524;75 i +;45;28;73;SEC_524
1996;139;03-11;20;39;59;SEC_139
1996;102;35-49;161;153;314;SEC_102
1996;122;25-34;80;88;168;SEC_122
1996;212;00-02;7;12;19;SEC_212
1996;508;35-49;49;52;101;SEC_508
1996;130;50-64;122;103;225;SEC_130
1996;424;65-74;26;26;52;SEC_424
1996;120;16-17;12;25;37;SEC_120
1996;627;25-34;60;78;138;SEC_627
1996;245;75 i +;61;29;90;SEC_245
1996;536;12-15;13;15;28;SEC_536
1996;410;65-74;103;102;205;SEC_410
1996;419;35-49;52;68;120;SEC_419
1996;526;25-34;58;56;114;SEC_526
1996;532;35-49;129;99;228;SEC_532
1996;319;50-64;61;62;123;SEC_319
1996;209;75 i +;71;34;105;SEC_209
1996;101;00-02;24;18;42;SEC_101
1996;420;16-17;10;16;26;SEC_420
1996;608;16-17;16;17;33;SEC_608
1996;532;50-64;149;159;308;SEC_532
1996;132;50-64;168;202;370;SEC_132
1996;402;35-49;74;69;143;SEC_402
1996;320;18-24;77;92;169;SEC_320
1996;501;65-74;19;21;40;SEC_501
1996;208;25-34;115;141;256;SEC_208
1996;123;00-02;6;21;27;SEC_123
1996;310;03-11;50;49;99;SEC_310
1996;404;00-02;9;15;24;SEC_404
1996;538;65-74;73;70;143;SEC_538
1996;438;75 i +;32;14;46;SEC_438
1996;240;12-15;16;14;30;SEC_240
1996;523;12-15;34;26;60;SEC_523
1996;211;75 i +;60;35;95;SEC_211
1996;533;50-64;102;91;193;SEC_533
1996;439;18-24;49;47;96;SEC_439
1996;417;12-15;11;16;27;SEC_417
1996;503;00-02;4;15;19;SEC_503
1996;236;16-17;12;4;16;SEC_236
1996;233;35-49;53;53;106;SEC_233
1996;630;16-17;20;34;54;SEC_630
1996;306;65-74;101;76;177;SEC_306
1996;601;35-49;149;148;297;SEC_601
1996;604;00-02;14;14;28;SEC_604
1996;603;16-17;9;12;21;SEC_603
1996;611;50-64;226;232;458;SEC_611
1996;406;12-15;33;35;68;SEC_406
1996;421;00-02;9;11;20;SEC_421
1996;501;35-49;168;133;301;SEC_501
1996;613;12-15;16;19;35;SEC_613
1996;407;00-02;7;12;19;SEC_407
1996;324;18-24;35;63;98;SEC_324
1996;607;00-02;11;4;15;SEC_607
1996;433;18-24;53;64;117;SEC_433
1996;112;50-64;125;112;237;SEC_112
1996;218;65-74;44;32;76;SEC_218
1996;221;25-34;97;93;190;SEC_221
1996;607;12-15;18;21;39;SEC_607
1996;604;75 i +;19;11;30;SEC_604
1996;526;03-11;22;31;53;SEC_526
1996;516;18-24;46;33;79;SEC_516
1996;140;50-64;131;116;247;SEC_140
1996;309;00-02;7;9;16;SEC_309
1996;426;75 i +;53;27;80;SEC_426
1996;313;65-74;61;65;126;SEC_313
1996;233;12-15;8;7;15;SEC_233
1996;121;75 i +;38;20;58;SEC_121
1996;229;75 i +;40;15;55;SEC_229
1996;314;75 i +;55;18;73;SEC_314
1996;140;03-11;19;19;38;SEC_140
1996;217;18-24;19;26;45;SEC_217
1996;425;75 i +;44;22;66;SEC_425
1996;624;75 i +;23;11;34;SEC_624
1996;416;00-02;12;6;18;SEC_416
1996;628;50-64;127;147;274;SEC_628
1996;523;65-74;89;79;168;SEC_523
1996;438;18-24;66;49;115;SEC_438
1996;433;00-02;17;12;29;SEC_433
1996;612;18-24;101;116;217;SEC_612
1996;506;12-15;58;58;116;SEC_506
1996;531;18-24;50;58;108;SEC_531
1996;435;18-24;60;56;116;SEC_435
1996;405;16-17;10;8;18;SEC_405
1996;240;00-02;3;7;10;SEC_240
1996;624;03-11;36;43;79;SEC_624
1996;232;03-11;33;27;60;SEC_232
1996;528;16-17;10;21;31;SEC_528
1996;605;18-24;53;70;123;SEC_605
1996;212;35-49;110;110;220;SEC_212
1996;311;75 i +;73;37;110;SEC_311
1996;220;50-64;82;77;159;SEC_220
1996;209;03-11;23;35;58;SEC_209
1996;406;16-17;22;21;43;SEC_406
1996;202;35-49;63;51;114;SEC_202
1996;324;65-74;57;35;92;SEC_324
1996;414;00-02;8;11;19;SEC_414
1996;225;65-74;59;39;98;SEC_225
