AnyPadro;Seccio;GrupEdat;Dones;Homes;Total;IdSeccio
1995;111;35-49;119;102;221;SEC_111
1995;105;18-24;76;78;154;SEC_105
1995;629;18-24;49;61;110;SEC_629
1995;102;12-15;38;36;74;SEC_102
1995;244;18-24;31;24;55;SEC_244
1995;426;16-17;17;18;35;SEC_426
1995;408;25-34;82;93;175;SEC_408
1995;503;65-74;23;19;42;SEC_503
1995;314;03-11;123;164;287;SEC_314
1995;136;18-24;52;70;122;SEC_136
1995;315;18-24;93;78;171;SEC_315
1995;221;35-49;98;103;201;SEC_221
1995;246;50-64;110;102;212;SEC_246
1995;304;65-74;100;72;172;SEC_304
1995;133;00-02;6;10;16;SEC_133
1995;421;18-24;83;74;157;SEC_421
1995;625;35-49;240;230;470;SEC_625
1995;523;16-17;13;18;31;SEC_523
1995;218;25-34;57;55;112;SEC_218
1995;320;18-24;95;106;201;SEC_320
1995;424;16-17;9;11;20;SEC_424
1995;325;25-34;143;134;277;SEC_325
1995;515;75 i +;23;13;36;SEC_515
1995;318;50-64;53;51;104;SEC_318
1995;112;16-17;24;21;45;SEC_112
1995;240;75 i +;41;16;57;SEC_240
1995;246;35-49;86;83;169;SEC_246
1995;225;18-24;28;26;54;SEC_225
1995;207;65-74;74;48;122;SEC_207
1995;120;65-74;63;54;117;SEC_120
1995;627;03-11;46;71;117;SEC_627
1995;133;18-24;67;73;140;SEC_133
1995;612;12-15;26;24;50;SEC_612
1995;405;18-24;54;56;110;SEC_405
1995;513;03-11;23;24;47;SEC_513
1995;440;50-64;148;170;318;SEC_440
1995;139;18-24;65;71;136;SEC_139
1995;136;16-17;18;17;35;SEC_136
1995;242;03-11;32;29;61;SEC_242
1995;217;00-02;4;6;10;SEC_217
1995;205;18-24;43;45;88;SEC_205
1995;249;00-02;8;9;17;SEC_249
1995;615;00-02;0;5;5;SEC_615
1995;316;25-34;87;64;151;SEC_316
1995;415;12-15;21;16;37;SEC_415
1995;628;12-15;34;45;79;SEC_628
1995;313;25-34;149;150;299;SEC_313
1995;431;65-74;82;76;158;SEC_431
1995;238;18-24;33;42;75;SEC_238
1995;420;18-24;78;72;150;SEC_420
1995;119;25-34;96;106;202;SEC_119
1995;605;65-74;30;29;59;SEC_605
1995;220;00-02;3;4;7;SEC_220
1995;535;12-15;29;42;71;SEC_535
1995;136;00-02;15;8;23;SEC_136
1995;132;75 i +;61;23;84;SEC_132
1995;604;12-15;15;22;37;SEC_604
1995;419;25-34;75;79;154;SEC_419
1995;535;16-17;20;26;46;SEC_535
1995;439;50-64;117;118;235;SEC_439
1995;129;00-02;17;5;22;SEC_129
1995;118;16-17;51;46;97;SEC_118
1995;501;03-11;32;42;74;SEC_501
1995;129;50-64;108;120;228;SEC_129
1995;204;50-64;58;55;113;SEC_204
1995;220;35-49;70;61;131;SEC_220
1995;525;00-02;12;2;14;SEC_525
1995;414;25-34;74;72;146;SEC_414
1995;534;35-49;83;84;167;SEC_534
1995;119;65-74;63;54;117;SEC_119
1995;230;03-11;22;26;48;SEC_230
1995;317;12-15;12;20;32;SEC_317
1995;612;75 i +;28;10;38;SEC_612
1995;414;12-15;15;24;39;SEC_414
1995;418;12-15;21;26;47;SEC_418
1995;428;18-24;29;26;55;SEC_428
1995;306;25-34;120;130;250;SEC_306
1995;421;35-49;95;81;176;SEC_421
1995;623;75 i +;45;23;68;SEC_623
1995;301;50-64;219;214;433;SEC_301
1995;223;00-02;16;10;26;SEC_223
1995;613;35-49;130;79;209;SEC_613
1995;429;65-74;45;36;81;SEC_429
1995;511;65-74;52;46;98;SEC_511
1995;424;18-24;36;55;91;SEC_424
1995;601;12-15;49;57;106;SEC_601
1995;135;75 i +;36;18;54;SEC_135
1995;308;50-64;142;134;276;SEC_308
1995;139;03-11;23;47;70;SEC_139
1995;313;03-11;91;90;181;SEC_313
1995;439;75 i +;40;21;61;SEC_439
1995;518;18-24;67;82;149;SEC_518
1995;615;03-11;25;22;47;SEC_615
1995;215;65-74;66;55;121;SEC_215
1995;535;00-02;7;12;19;SEC_535
1995;230;50-64;87;86;173;SEC_230
1995;415;03-11;22;21;43;SEC_415
1995;436;00-02;6;8;14;SEC_436
1995;119;16-17;35;41;76;SEC_119
1995;515;18-24;37;41;78;SEC_515
1995;404;12-15;27;26;53;SEC_404
1995;124;35-49;123;105;228;SEC_124
1995;407;35-49;73;70;143;SEC_407
1995;325;75 i +;88;48;136;SEC_325
1995;404;65-74;56;48;104;SEC_404
1995;417;25-34;54;53;107;SEC_417
1995;522;25-34;59;63;122;SEC_522
1995;407;25-34;88;111;199;SEC_407
1995;210;18-24;50;59;109;SEC_210
1995;532;03-11;41;41;82;SEC_532
1995;129;12-15;27;25;52;SEC_129
1995;514;00-02;7;6;13;SEC_514
1995;419;50-64;77;74;151;SEC_419
1995;423;12-15;27;16;43;SEC_423
1995;201;35-49;56;46;102;SEC_201
1995;440;18-24;118;102;220;SEC_440
1995;628;16-17;22;34;56;SEC_628
1995;109;18-24;51;59;110;SEC_109
1995;311;35-49;130;109;239;SEC_311
1995;606;50-64;140;130;270;SEC_606
1995;408;50-64;102;91;193;SEC_408
1995;321;00-02;21;19;40;SEC_321
1995;506;65-74;62;58;120;SEC_506
1995;240;65-74;56;46;102;SEC_240
1995;415;18-24;32;32;64;SEC_415
1995;117;75 i +;47;18;65;SEC_117
1995;311;75 i +;62;35;97;SEC_311
1995;428;03-11;20;12;32;SEC_428
1995;401;12-15;33;28;61;SEC_401
1995;616;50-64;120;126;246;SEC_616
1995;121;03-11;27;22;49;SEC_121
1995;619;25-34;118;134;252;SEC_619
1995;321;12-15;77;64;141;SEC_321
1995;307;25-34;97;73;170;SEC_307
1995;111;65-74;38;35;73;SEC_111
1995;536;03-11;26;26;52;SEC_536
1995;124;00-02;4;10;14;SEC_124
1995;241;50-64;77;66;143;SEC_241
1995;223;25-34;101;96;197;SEC_223
1995;403;50-64;163;165;328;SEC_403
1995;246;03-11;29;27;56;SEC_246
1995;519;00-02;6;4;10;SEC_519
1995;107;18-24;125;154;279;SEC_107
1995;138;65-74;19;20;39;SEC_138
1995;628;50-64;129;145;274;SEC_628
1995;631;18-24;134;144;278;SEC_631
1995;608;18-24;86;114;200;SEC_608
1995;435;75 i +;79;32;111;SEC_435
1995;237;16-17;13;15;28;SEC_237
1995;309;18-24;40;50;90;SEC_309
1995;323;35-49;417;418;835;SEC_323
1995;101;00-02;17;21;38;SEC_101
1995;532;00-02;12;10;22;SEC_532
1995;537;50-64;149;135;284;SEC_537
1995;137;00-02;15;11;26;SEC_137
1995;529;50-64;143;150;293;SEC_529
1995;412;75 i +;47;20;67;SEC_412
1995;225;50-64;58;50;108;SEC_225
1995;440;75 i +;46;32;78;SEC_440
1995;440;16-17;24;18;42;SEC_440
1995;610;18-24;149;150;299;SEC_610
1995;242;35-49;92;90;182;SEC_242
1995;533;03-11;35;29;64;SEC_533
1995;518;35-49;80;89;169;SEC_518
1995;225;25-34;30;27;57;SEC_225
1995;101;65-74;33;31;64;SEC_101
1995;512;00-02;11;6;17;SEC_512
1995;125;65-74;58;40;98;SEC_125
1995;621;65-74;36;25;61;SEC_621
1995;121;16-17;6;6;12;SEC_121
1995;515;65-74;39;21;60;SEC_515
1995;516;50-64;76;73;149;SEC_516
1995;139;16-17;16;17;33;SEC_139
1995;325;50-64;203;169;372;SEC_325
1995;226;12-15;27;24;51;SEC_226
1995;401;00-02;12;9;21;SEC_401
1995;121;18-24;38;34;72;SEC_121
1995;511;18-24;50;48;98;SEC_511
1995;537;03-11;41;49;90;SEC_537
1995;325;18-24;128;140;268;SEC_325
1995;529;35-49;82;70;152;SEC_529
1995;506;12-15;65;65;130;SEC_506
1995;419;12-15;13;21;34;SEC_419
1995;520;25-34;70;68;138;SEC_520
1995;222;18-24;39;71;110;SEC_222
1995;607;18-24;77;80;157;SEC_607
1995;205;12-15;26;24;50;SEC_205
1995;244;25-34;56;58;114;SEC_244
1995;428;35-49;36;43;79;SEC_428
1995;406;50-64;140;135;275;SEC_406
1995;431;75 i +;59;35;94;SEC_431
1995;103;65-74;42;36;78;SEC_103
1995;532;18-24;110;109;219;SEC_532
1995;522;65-74;40;35;75;SEC_522
1995;626;50-64;133;123;256;SEC_626
1995;517;00-02;12;13;25;SEC_517
1995;312;12-15;17;26;43;SEC_312
1995;245;18-24;46;67;113;SEC_245
1995;615;75 i +;25;10;35;SEC_615
1995;521;65-74;46;44;90;SEC_521
1995;411;25-34;79;79;158;SEC_411
1995;224;25-34;53;61;114;SEC_224
1995;105;12-15;39;40;79;SEC_105
1995;312;35-49;132;109;241;SEC_312
1995;224;12-15;8;9;17;SEC_224
1995;222;12-15;24;21;45;SEC_222
1995;414;35-49;84;77;161;SEC_414
1995;436;65-74;32;32;64;SEC_436
1995;527;50-64;111;100;211;SEC_527
1995;134;50-64;98;103;201;SEC_134
1995;409;16-17;9;13;22;SEC_409
1995;502;18-24;99;129;228;SEC_502
1995;420;25-34;108;115;223;SEC_420
1995;608;50-64;116;94;210;SEC_608
1995;624;12-15;32;33;65;SEC_624
1995;534;25-34;79;80;159;SEC_534
1995;413;25-34;45;60;105;SEC_413
1995;503;12-15;29;36;65;SEC_503
1995;315;65-74;54;51;105;SEC_315
1995;111;03-11;50;34;84;SEC_111
1995;516;12-15;18;11;29;SEC_516
1995;312;00-02;13;12;25;SEC_312
1995;536;18-24;57;58;115;SEC_536
1995;408;16-17;11;20;31;SEC_408
1995;121;50-64;101;78;179;SEC_121
1995;109;00-02;11;14;25;SEC_109
1995;206;16-17;6;10;16;SEC_206
1995;421;50-64;158;146;304;SEC_421
1995;226;16-17;14;7;21;SEC_226
1995;522;16-17;7;9;16;SEC_522
1995;126;16-17;25;23;48;SEC_126
1995;511;12-15;7;8;15;SEC_511
1995;109;50-64;101;99;200;SEC_109
1995;133;65-74;50;44;94;SEC_133
1995;134;18-24;91;82;173;SEC_134
1995;418;25-34;84;96;180;SEC_418
1995;537;65-74;78;65;143;SEC_537
1995;628;25-34;76;81;157;SEC_628
1995;221;65-74;51;60;111;SEC_221
1995;249;75 i +;50;25;75;SEC_249
1995;420;50-64;141;129;270;SEC_420
1995;629;75 i +;25;9;34;SEC_629
1995;502;16-17;23;28;51;SEC_502
1995;610;50-64;179;222;401;SEC_610
1995;534;16-17;9;18;27;SEC_534
1995;403;16-17;16;15;31;SEC_403
1995;509;65-74;26;26;52;SEC_509
1995;115;03-11;48;73;121;SEC_115
1995;303;25-34;153;168;321;SEC_303
1995;423;75 i +;38;22;60;SEC_423
1995;537;12-15;32;30;62;SEC_537
1995;411;16-17;22;17;39;SEC_411
1995;317;25-34;68;76;144;SEC_317
1995;429;00-02;2;6;8;SEC_429
1995;234;25-34;84;89;173;SEC_234
1995;244;35-49;53;59;112;SEC_244
1995;512;25-34;80;85;165;SEC_512
1995;118;50-64;106;125;231;SEC_118
1995;309;50-64;55;58;113;SEC_309
1995;103;00-02;4;8;12;SEC_103
1995;442;18-24;46;46;92;SEC_442
1995;505;16-17;34;15;49;SEC_505
1995;517;50-64;134;118;252;SEC_517
1995;247;65-74;80;66;146;SEC_247
1995;433;35-49;80;83;163;SEC_433
1995;630;75 i +;25;7;32;SEC_630
1995;223;65-74;66;52;118;SEC_223
1995;428;00-02;5;4;9;SEC_428
1995;106;18-24;127;131;258;SEC_106
1995;127;18-24;26;32;58;SEC_127
1995;222;50-64;81;90;171;SEC_222
1995;402;12-15;10;14;24;SEC_402
1995;519;65-74;29;36;65;SEC_519
1995;515;50-64;56;61;117;SEC_515
1995;430;03-11;24;37;61;SEC_430
1995;408;12-15;19;25;44;SEC_408
1995;310;12-15;28;28;56;SEC_310
1995;437;12-15;14;14;28;SEC_437
1995;226;75 i +;73;32;105;SEC_226
1995;124;16-17;17;11;28;SEC_124
1995;433;18-24;56;67;123;SEC_433
1995;617;03-11;55;53;108;SEC_617
1995;611;03-11;61;45;106;SEC_611
1995;125;16-17;20;39;59;SEC_125
1995;614;03-11;23;39;62;SEC_614
1995;225;03-11;18;28;46;SEC_225
1995;413;50-64;62;56;118;SEC_413
1995;521;35-49;163;123;286;SEC_521
1995;530;12-15;19;28;47;SEC_530
1995;222;35-49;75;70;145;SEC_222
1995;109;35-49;148;143;291;SEC_109
1995;241;75 i +;41;22;63;SEC_241
1995;230;25-34;81;88;169;SEC_230
1995;625;75 i +;12;6;18;SEC_625
1995;106;03-11;98;96;194;SEC_106
1995;529;16-17;9;8;17;SEC_529
1995;209;16-17;8;10;18;SEC_209
1995;623;03-11;57;60;117;SEC_623
1995;518;75 i +;49;21;70;SEC_518
1995;630;03-11;40;39;79;SEC_630
1995;624;75 i +;23;14;37;SEC_624
1995;438;65-74;29;26;55;SEC_438
1995;423;00-02;9;5;14;SEC_423
1995;308;65-74;72;60;132;SEC_308
1995;111;25-34;85;92;177;SEC_111
1995;440;12-15;22;19;41;SEC_440
1995;403;75 i +;40;19;59;SEC_403
1995;138;35-49;117;120;237;SEC_138
1995;526;50-64;58;77;135;SEC_526
1995;515;35-49;51;46;97;SEC_515
1995;601;25-34;97;125;222;SEC_601
1995;249;18-24;55;59;114;SEC_249
1995;135;03-11;75;72;147;SEC_135
1995;520;00-02;10;5;15;SEC_520
1995;427;65-74;57;55;112;SEC_427
1995;619;75 i +;39;18;57;SEC_619
1995;609;25-34;65;81;146;SEC_609
1995;304;75 i +;67;37;104;SEC_304
1995;316;03-11;174;179;353;SEC_316
1995;416;25-34;63;70;133;SEC_416
1995;210;12-15;15;15;30;SEC_210
1995;133;50-64;86;86;172;SEC_133
1995;115;35-49;174;171;345;SEC_115
1995;214;75 i +;35;17;52;SEC_214
1995;421;25-34;101;115;216;SEC_421
1995;404;75 i +;62;27;89;SEC_404
1995;516;75 i +;31;12;43;SEC_516
1995;304;50-64;114;112;226;SEC_304
1995;507;50-64;77;99;176;SEC_507
1995;215;18-24;47;47;94;SEC_215
1995;235;12-15;17;20;37;SEC_235
1995;604;50-64;87;81;168;SEC_604
1995;538;12-15;18;23;41;SEC_538
1995;316;75 i +;28;13;41;SEC_316
1995;632;50-64;115;105;220;SEC_632
1995;239;16-17;14;13;27;SEC_239
1995;624;16-17;30;34;64;SEC_624
1995;133;16-17;13;18;31;SEC_133
1995;108;00-02;11;13;24;SEC_108
1995;234;35-49;70;68;138;SEC_234
1995;106;12-15;74;66;140;SEC_106
1995;208;50-64;230;204;434;SEC_208
1995;112;03-11;58;66;124;SEC_112
1995;132;18-24;129;151;280;SEC_132
1995;221;12-15;21;21;42;SEC_221
1995;104;25-34;58;86;144;SEC_104
1995;131;03-11;64;66;130;SEC_131
1995;101;18-24;59;62;121;SEC_101
1995;241;65-74;62;48;110;SEC_241
1995;311;03-11;42;45;87;SEC_311
1995;309;16-17;11;11;22;SEC_309
1995;131;12-15;57;43;100;SEC_131
1995;520;03-11;32;37;69;SEC_520
1995;613;25-34;109;123;232;SEC_613
1995;318;25-34;80;59;139;SEC_318
1995;525;12-15;14;31;45;SEC_525
1995;434;16-17;9;10;19;SEC_434
1995;433;65-74;55;36;91;SEC_433
1995;611;00-02;16;13;29;SEC_611
1995;426;25-34;88;91;179;SEC_426
1995;501;12-15;47;48;95;SEC_501
1995;116;03-11;63;52;115;SEC_116
1995;130;25-34;78;96;174;SEC_130
1995;227;25-34;50;43;93;SEC_227
1995;521;16-17;28;34;62;SEC_521
1995;619;16-17;25;30;55;SEC_619
1995;202;35-49;61;61;122;SEC_202
1995;305;50-64;98;119;217;SEC_305
1995;119;35-49;203;171;374;SEC_119
1995;606;35-49;74;79;153;SEC_606
1995;302;35-49;209;192;401;SEC_302
1995;140;16-17;16;20;36;SEC_140
1995;127;03-11;55;40;95;SEC_127
1995;236;03-11;34;28;62;SEC_236
1995;404;18-24;79;72;151;SEC_404
1995;318;65-74;21;17;38;SEC_318
1995;214;65-74;42;35;77;SEC_214
1995;521;50-64;121;170;291;SEC_521
1995;526;00-02;12;8;20;SEC_526
1995;322;65-74;54;57;111;SEC_322
1995;303;35-49;128;119;247;SEC_303
1995;624;03-11;38;46;84;SEC_624
1995;238;00-02;3;10;13;SEC_238
1995;624;25-34;62;100;162;SEC_624
1995;109;75 i +;53;22;75;SEC_109
1995;130;75 i +;60;26;86;SEC_130
1995;531;18-24;55;57;112;SEC_531
1995;606;18-24;69;65;134;SEC_606
1995;201;25-34;50;55;105;SEC_201
1995;520;75 i +;38;20;58;SEC_520
1995;211;00-02;7;14;21;SEC_211
1995;133;75 i +;42;27;69;SEC_133
1995;431;50-64;145;129;274;SEC_431
1995;217;75 i +;46;14;60;SEC_217
1995;204;75 i +;27;16;43;SEC_204
1995;245;03-11;28;29;57;SEC_245
1995;309;75 i +;23;10;33;SEC_309
1995;442;35-49;74;56;130;SEC_442
1995;239;25-34;91;90;181;SEC_239
1995;537;25-34;102;103;205;SEC_537
1995;431;35-49;124;140;264;SEC_431
1995;524;18-24;92;74;166;SEC_524
1995;433;16-17;10;14;24;SEC_433
1995;202;16-17;12;10;22;SEC_202
1995;246;16-17;8;14;22;SEC_246
1995;103;75 i +;39;23;62;SEC_103
1995;414;18-24;54;59;113;SEC_414
1995;321;50-64;152;177;329;SEC_321
1995;320;12-15;17;12;29;SEC_320
1995;516;65-74;31;21;52;SEC_516
1995;506;35-49;269;239;508;SEC_506
1995;605;18-24;62;87;149;SEC_605
1995;613;50-64;190;233;423;SEC_613
1995;117;18-24;114;144;258;SEC_117
1995;209;18-24;47;46;93;SEC_209
1995;308;75 i +;55;33;88;SEC_308
1995;135;18-24;68;90;158;SEC_135
1995;127;65-74;39;29;68;SEC_127
1995;241;16-17;5;5;10;SEC_241
1995;619;12-15;53;44;97;SEC_619
1995;204;25-34;40;44;84;SEC_204
1995;433;00-02;16;10;26;SEC_433
1995;232;03-11;27;34;61;SEC_232
1995;107;50-64;185;196;381;SEC_107
1995;522;50-64;78;81;159;SEC_522
1995;513;65-74;37;32;69;SEC_513
1995;622;16-17;28;19;47;SEC_622
1995;301;75 i +;60;25;85;SEC_301
1995;631;35-49;150;108;258;SEC_631
1995;322;00-02;15;10;25;SEC_322
1995;319;25-34;67;65;132;SEC_319
1995;135;65-74;61;49;110;SEC_135
1995;308;03-11;55;51;106;SEC_308
1995;602;00-02;5;4;9;SEC_602
1995;102;18-24;140;162;302;SEC_102
1995;308;35-49;165;155;320;SEC_308
1995;506;18-24;189;185;374;SEC_506
1995;319;03-11;31;37;68;SEC_319
1995;230;35-49;44;52;96;SEC_230
1995;220;75 i +;39;19;58;SEC_220
1995;506;16-17;44;42;86;SEC_506
1995;403;65-74;49;45;94;SEC_403
1995;504;50-64;159;155;314;SEC_504
1995;414;75 i +;33;18;51;SEC_414
1995;232;16-17;11;15;26;SEC_232
1995;301;35-49;143;150;293;SEC_301
1995;102;65-74;79;56;135;SEC_102
1995;611;65-74;78;53;131;SEC_611
1995;608;75 i +;24;10;34;SEC_608
1995;209;03-11;26;37;63;SEC_209
1995;606;12-15;37;22;59;SEC_606
1995;630;16-17;20;32;52;SEC_630
1995;324;25-34;69;71;140;SEC_324
1995;601;00-02;14;12;26;SEC_601
1995;223;35-49;91;96;187;SEC_223
1995;202;25-34;53;82;135;SEC_202
1995;214;00-02;5;8;13;SEC_214
1995;626;12-15;19;25;44;SEC_626
1995;307;75 i +;37;19;56;SEC_307
1995;121;00-02;9;5;14;SEC_121
1995;139;00-02;9;13;22;SEC_139
1995;120;03-11;91;94;185;SEC_120
1995;302;16-17;34;32;66;SEC_302
1995;437;16-17;12;12;24;SEC_437
1995;323;18-24;168;184;352;SEC_323
1995;527;16-17;11;11;22;SEC_527
1995;118;00-02;17;25;42;SEC_118
1995;426;12-15;14;19;33;SEC_426
1995;307;12-15;59;46;105;SEC_307
1995;516;25-34;62;68;130;SEC_516
1995;223;12-15;16;20;36;SEC_223
1995;626;65-74;40;47;87;SEC_626
1995;245;00-02;4;3;7;SEC_245
1995;304;03-11;25;43;68;SEC_304
1995;502;65-74;82;70;152;SEC_502
1995;615;25-34;74;82;156;SEC_615
1995;129;16-17;22;15;37;SEC_129
1995;430;12-15;17;16;33;SEC_430
1995;239;18-24;54;59;113;SEC_239
1995;417;50-64;66;62;128;SEC_417
1995;129;18-24;101;98;199;SEC_129
1995;628;03-11;39;34;73;SEC_628
1995;609;18-24;107;103;210;SEC_609
1995;536;12-15;16;20;36;SEC_536
1995;607;25-34;106;121;227;SEC_607
1995;237;25-34;106;123;229;SEC_237
1995;310;35-49;106;121;227;SEC_310
1995;504;00-02;5;6;11;SEC_504
1995;426;00-02;7;12;19;SEC_426
1995;218;50-64;74;69;143;SEC_218
1995;526;18-24;44;46;90;SEC_526
1995;413;18-24;29;34;63;SEC_413
1995;241;00-02;2;2;4;SEC_241
1995;122;75 i +;33;18;51;SEC_122
1995;410;18-24;134;118;252;SEC_410
1995;536;16-17;11;8;19;SEC_536
1995;528;03-11;40;29;69;SEC_528
1995;409;00-02;5;5;10;SEC_409
1995;224;75 i +;33;16;49;SEC_224
1995;224;03-11;18;21;39;SEC_224
1995;319;50-64;62;66;128;SEC_319
1995;625;00-02;9;16;25;SEC_625
1995;313;75 i +;51;28;79;SEC_313
1995;120;25-34;120;102;222;SEC_120
1995;432;65-74;71;57;128;SEC_432
1995;533;16-17;5;13;18;SEC_533
1995;131;75 i +;30;11;41;SEC_131
1995;505;00-02;16;7;23;SEC_505
1995;308;12-15;36;34;70;SEC_308
1995;436;50-64;79;63;142;SEC_436
1995;632;03-11;51;61;112;SEC_632
1995;426;35-49;81;87;168;SEC_426
1995;320;16-17;7;21;28;SEC_320
1995;612;03-11;35;43;78;SEC_612
1995;510;00-02;4;12;16;SEC_510
1995;401;18-24;69;69;138;SEC_401
1995;601;75 i +;60;22;82;SEC_601
1995;533;25-34;81;106;187;SEC_533
1995;514;50-64;94;73;167;SEC_514
1995;517;12-15;23;24;47;SEC_517
1995;243;12-15;23;17;40;SEC_243
1995;429;25-34;36;42;78;SEC_429
1995;422;65-74;92;71;163;SEC_422
1995;621;03-11;57;74;131;SEC_621
1995;324;18-24;34;58;92;SEC_324
1995;225;12-15;10;14;24;SEC_225
1995;128;35-49;117;106;223;SEC_128
1995;314;16-17;42;45;87;SEC_314
1995;622;12-15;36;33;69;SEC_622
1995;608;35-49;98;98;196;SEC_608
1995;114;03-11;61;51;112;SEC_114
1995;512;50-64;114;119;233;SEC_512
1995;402;50-64;99;104;203;SEC_402
1995;536;25-34;79;91;170;SEC_536
1995;222;65-74;57;38;95;SEC_222
1995;632;65-74;37;35;72;SEC_632
1995;602;35-49;33;33;66;SEC_602
1995;232;35-49;95;71;166;SEC_232
1995;603;25-34;60;69;129;SEC_603
1995;528;65-74;61;54;115;SEC_528
1995;215;12-15;15;19;34;SEC_215
1995;421;65-74;55;52;107;SEC_421
1995;621;16-17;43;39;82;SEC_621
1995;109;65-74;40;45;85;SEC_109
1995;614;65-74;45;32;77;SEC_614
1995;623;12-15;47;65;112;SEC_623
1995;528;50-64;138;140;278;SEC_528
1995;423;65-74;55;40;95;SEC_423
1995;204;18-24;27;23;50;SEC_204
1995;136;12-15;38;39;77;SEC_136
1995;206;00-02;6;9;15;SEC_206
1995;431;00-02;10;11;21;SEC_431
1995;321;16-17;40;48;88;SEC_321
1995;411;75 i +;32;19;51;SEC_411
1995;310;50-64;70;67;137;SEC_310
1995;217;18-24;20;24;44;SEC_217
1995;501;16-17;31;31;62;SEC_501
1995;249;35-49;83;84;167;SEC_249
1995;234;16-17;9;7;16;SEC_234
1995;501;25-34;66;68;134;SEC_501
1995;532;12-15;24;28;52;SEC_532
1995;407;03-11;23;31;54;SEC_407
1995;315;12-15;37;50;87;SEC_315
1995;128;18-24;87;79;166;SEC_128
1995;621;35-49;248;231;479;SEC_621
1995;623;50-64;163;187;350;SEC_623
1995;622;18-24;73;80;153;SEC_622
1995;229;12-15;5;11;16;SEC_229
1995;604;25-34;74;79;153;SEC_604
1995;204;65-74;53;36;89;SEC_204
1995;312;65-74;40;30;70;SEC_312
1995;123;50-64;108;113;221;SEC_123
1995;534;00-02;7;11;18;SEC_534
1995;215;50-64;85;72;157;SEC_215
1995;410;25-34;104;125;229;SEC_410
1995;314;00-02;26;27;53;SEC_314
1995;120;00-02;19;10;29;SEC_120
1995;426;18-24;48;58;106;SEC_426
1995;307;50-64;143;137;280;SEC_307
1995;129;65-74;44;33;77;SEC_129
1995;115;16-17;19;22;41;SEC_115
1995;203;00-02;7;5;12;SEC_203
1995;133;25-34;70;70;140;SEC_133
1995;224;35-49;47;47;94;SEC_224
1995;630;00-02;9;4;13;SEC_630
1995;513;75 i +;41;13;54;SEC_513
1995;233;03-11;15;17;32;SEC_233
1995;524;75 i +;43;26;69;SEC_524
1995;303;03-11;43;40;83;SEC_303
1995;613;03-11;38;40;78;SEC_613
1995;626;75 i +;21;18;39;SEC_626
1995;535;18-24;100;116;216;SEC_535
1995;417;16-17;8;15;23;SEC_417
1995;129;03-11;47;46;93;SEC_129
1995;402;35-49;79;71;150;SEC_402
1995;536;00-02;5;10;15;SEC_536
1995;242;18-24;55;53;108;SEC_242
1995;527;03-11;39;39;78;SEC_527
1995;403;12-15;38;29;67;SEC_403
1995;248;25-34;81;102;183;SEC_248
1995;127;16-17;8;7;15;SEC_127
1995;211;50-64;117;92;209;SEC_211
1995;131;35-49;210;193;403;SEC_131
1995;610;12-15;37;25;62;SEC_610
1995;216;03-11;33;40;73;SEC_216
1995;222;75 i +;34;23;57;SEC_222
1995;538;18-24;79;80;159;SEC_538
1995;520;12-15;15;22;37;SEC_520
1995;436;75 i +;31;13;44;SEC_436
1995;414;65-74;69;53;122;SEC_414
1995;228;35-49;39;44;83;SEC_228
1995;616;65-74;37;29;66;SEC_616
1995;209;65-74;83;67;150;SEC_209
1995;317;50-64;69;70;139;SEC_317
1995;606;03-11;46;46;92;SEC_606
1995;527;25-34;79;92;171;SEC_527
1995;123;35-49;128;124;252;SEC_123
1995;432;50-64;124;142;266;SEC_432
1995;416;18-24;35;54;89;SEC_416
1995;628;18-24;125;130;255;SEC_628
1995;125;50-64;98;119;217;SEC_125
1995;305;35-49;198;178;376;SEC_305
1995;625;16-17;34;43;77;SEC_625
1995;412;18-24;100;96;196;SEC_412
1995;248;12-15;17;29;46;SEC_248
1995;442;25-34;54;47;101;SEC_442
1995;209;12-15;10;16;26;SEC_209
1995;215;16-17;8;10;18;SEC_215
1995;504;12-15;20;21;41;SEC_504
1995;224;50-64;63;51;114;SEC_224
1995;232;12-15;17;18;35;SEC_232
1995;440;35-49;109;90;199;SEC_440
1995;111;12-15;19;19;38;SEC_111
1995;409;03-11;30;23;53;SEC_409
1995;249;65-74;68;54;122;SEC_249
1995;439;18-24;60;50;110;SEC_439
1995;615;35-49;111;66;177;SEC_615
1995;432;16-17;24;21;45;SEC_432
1995;404;00-02;13;15;28;SEC_404
1995;247;50-64;118;119;237;SEC_247
1995;122;00-02;12;6;18;SEC_122
1995;309;12-15;18;21;39;SEC_309
1995;505;50-64;178;221;399;SEC_505
1995;432;12-15;34;42;76;SEC_432
1995;520;65-74;47;46;93;SEC_520
1995;503;18-24;60;59;119;SEC_503
1995;321;65-74;85;64;149;SEC_321
1995;129;25-34;89;88;177;SEC_129
1995;522;35-49;73;61;134;SEC_522
1995;245;65-74;74;54;128;SEC_245
1995;134;65-74;63;41;104;SEC_134
1995;134;75 i +;55;25;80;SEC_134
1995;134;16-17;11;24;35;SEC_134
1995;105;25-34;86;73;159;SEC_105
1995;313;65-74;63;64;127;SEC_313
1995;514;03-11;40;25;65;SEC_514
1995;420;16-17;15;20;35;SEC_420
1995;513;50-64;99;94;193;SEC_513
1995;103;18-24;50;35;85;SEC_103
1995;520;35-49;93;87;180;SEC_520
1995;233;75 i +;78;30;108;SEC_233
1995;121;12-15;8;10;18;SEC_121
1995;208;65-74;138;105;243;SEC_208
1995;602;75 i +;13;11;24;SEC_602
1995;108;18-24;69;66;135;SEC_108
1995;412;35-49;204;195;399;SEC_412
1995;127;12-15;22;24;46;SEC_127
1995;315;25-34;135;128;263;SEC_315
1995;133;35-49;109;94;203;SEC_133
1995;535;25-34;50;58;108;SEC_535
1995;406;12-15;40;34;74;SEC_406
1995;321;18-24;150;136;286;SEC_321
1995;106;35-49;314;280;594;SEC_106
1995;510;35-49;94;89;183;SEC_510
1995;608;65-74;36;32;68;SEC_608
1995;418;65-74;71;51;122;SEC_418
1995;219;50-64;124;114;238;SEC_219
1995;140;18-24;74;73;147;SEC_140
1995;231;25-34;78;90;168;SEC_231
1995;625;50-64;104;113;217;SEC_625
1995;417;75 i +;17;11;28;SEC_417
1995;118;03-11;91;95;186;SEC_118
1995;408;03-11;41;32;73;SEC_408
1995;113;00-02;12;14;26;SEC_113
1995;232;65-74;71;65;136;SEC_232
1995;227;12-15;11;13;24;SEC_227
1995;517;03-11;38;36;74;SEC_517
1995;115;65-74;77;50;127;SEC_115
1995;317;65-74;57;49;106;SEC_317
1995;220;18-24;49;48;97;SEC_220
1995;239;65-74;94;69;163;SEC_239
1995;205;75 i +;29;17;46;SEC_205
1995;616;18-24;168;175;343;SEC_616
1995;119;12-15;42;45;87;SEC_119
1995;610;03-11;44;49;93;SEC_610
1995;525;35-49;77;78;155;SEC_525
1995;508;35-49;44;52;96;SEC_508
1995;434;25-34;41;36;77;SEC_434
1995;134;00-02;15;10;25;SEC_134
1995;242;50-64;133;109;242;SEC_242
1995;601;65-74;42;36;78;SEC_601
1995;433;12-15;22;22;44;SEC_433
1995;218;18-24;38;44;82;SEC_218
1995;429;18-24;36;49;85;SEC_429
1995;429;50-64;66;45;111;SEC_429
1995;232;18-24;55;44;99;SEC_232
1995;504;65-74;60;54;114;SEC_504
1995;101;25-34;100;98;198;SEC_101
1995;113;16-17;22;27;49;SEC_113
1995;621;75 i +;20;11;31;SEC_621
1995;508;50-64;69;64;133;SEC_508
1995;229;35-49;44;43;87;SEC_229
1995;537;18-24;89;90;179;SEC_537
1995;417;35-49;65;63;128;SEC_417
1995;523;00-02;7;12;19;SEC_523
1995;211;25-34;118;118;236;SEC_211
1995;226;18-24;67;56;123;SEC_226
1995;207;50-64;73;60;133;SEC_207
1995;605;00-02;3;10;13;SEC_605
1995;236;16-17;9;3;12;SEC_236
1995;320;03-11;20;18;38;SEC_320
1995;128;16-17;20;16;36;SEC_128
1995;103;35-49;75;68;143;SEC_103
1995;322;12-15;36;29;65;SEC_322
1995;303;12-15;28;29;57;SEC_303
1995;245;16-17;8;18;26;SEC_245
1995;234;00-02;8;9;17;SEC_234
1995;421;12-15;32;24;56;SEC_421
1995;205;03-11;28;39;67;SEC_205
1995;103;12-15;22;22;44;SEC_103
1995;502;25-34;112;125;237;SEC_502
1995;308;00-02;7;13;20;SEC_308
1995;140;65-74;53;51;104;SEC_140
1995;221;18-24;80;65;145;SEC_221
1995;323;12-15;109;115;224;SEC_323
1995;616;12-15;71;58;129;SEC_616
1995;127;75 i +;28;14;42;SEC_127
1995;423;18-24;59;69;128;SEC_423
1995;622;75 i +;32;14;46;SEC_622
1995;237;18-24;61;86;147;SEC_237
1995;118;25-34;131;131;262;SEC_118
1995;518;65-74;48;52;100;SEC_518
1995;311;00-02;6;17;23;SEC_311
1995;533;12-15;15;17;32;SEC_533
1995;625;12-15;76;72;148;SEC_625
1995;624;65-74;28;29;57;SEC_624
1995;314;12-15;84;74;158;SEC_314
1995;411;35-49;99;97;196;SEC_411
1995;618;25-34;44;43;87;SEC_618
1995;219;03-11;43;36;79;SEC_219
1995;240;00-02;4;10;14;SEC_240
1995;234;65-74;86;56;142;SEC_234
1995;415;00-02;7;6;13;SEC_415
1995;437;00-02;12;11;23;SEC_437
1995;625;25-34;85;87;172;SEC_625
1995;410;03-11;40;51;91;SEC_410
1995;249;03-11;22;30;52;SEC_249
1995;124;50-64;79;79;158;SEC_124
1995;125;03-11;51;41;92;SEC_125
1995;209;35-49;84;87;171;SEC_209
1995;103;16-17;8;11;19;SEC_103
1995;213;00-02;7;6;13;SEC_213
1995;214;35-49;48;54;102;SEC_214
1995;107;00-02;16;13;29;SEC_107
1995;438;12-15;13;19;32;SEC_438
1995;122;16-17;8;12;20;SEC_122
1995;229;25-34;57;48;105;SEC_229
1995;620;35-49;73;62;135;SEC_620
1995;538;25-34;100;91;191;SEC_538
1995;607;75 i +;26;9;35;SEC_607
1995;212;65-74;76;62;138;SEC_212
1995;244;03-11;18;13;31;SEC_244
1995;514;25-34;66;69;135;SEC_514
1995;323;03-11;129;137;266;SEC_323
1995;235;16-17;13;19;32;SEC_235
1995;412;03-11;67;63;130;SEC_412
1995;135;25-34;121;124;245;SEC_135
1995;503;35-49;131;136;267;SEC_503
1995;132;00-02;20;20;40;SEC_132
1995;526;25-34;65;74;139;SEC_526
1995;239;75 i +;64;27;91;SEC_239
1995;632;25-34;93;117;210;SEC_632
1995;306;03-11;52;75;127;SEC_306
1995;419;18-24;48;56;104;SEC_419
1995;305;75 i +;64;38;102;SEC_305
1995;217;65-74;48;34;82;SEC_217
1995;605;25-34;71;68;139;SEC_605
1995;619;18-24;102;100;202;SEC_619
1995;133;03-11;29;31;60;SEC_133
1995;503;16-17;24;23;47;SEC_503
1995;236;50-64;123;123;246;SEC_236
1995;132;03-11;100;100;200;SEC_132
1995;439;25-34;113;109;222;SEC_439
1995;527;35-49;84;93;177;SEC_527
1995;441;18-24;108;138;246;SEC_441
1995;128;12-15;31;26;57;SEC_128
1995;324;16-17;12;20;32;SEC_324
1995;212;16-17;11;26;37;SEC_212
1995;313;35-49;243;226;469;SEC_313
1995;507;65-74;42;29;71;SEC_507
1995;108;50-64;115;109;224;SEC_108
1995;138;75 i +;16;11;27;SEC_138
1995;622;65-74;38;27;65;SEC_622
1995;602;12-15;17;10;27;SEC_602
1995;203;35-49;50;52;102;SEC_203
1995;227;35-49;60;53;113;SEC_227
1995;518;25-34;96;103;199;SEC_518
1995;247;18-24;68;60;128;SEC_247
1995;534;65-74;56;41;97;SEC_534
1995;231;18-24;65;58;123;SEC_231
1995;317;75 i +;43;16;59;SEC_317
1995;302;00-02;17;20;37;SEC_302
1995;209;25-34;77;93;170;SEC_209
1995;123;65-74;78;61;139;SEC_123
1995;247;12-15;21;17;38;SEC_247
1995;202;03-11;23;26;49;SEC_202
1995;205;65-74;53;37;90;SEC_205
1995;618;35-49;78;59;137;SEC_618
1995;418;75 i +;53;38;91;SEC_418
1995;135;12-15;37;53;90;SEC_135
1995;128;75 i +;33;16;49;SEC_128
1995;603;35-49;64;54;118;SEC_603
1995;401;50-64;136;125;261;SEC_401
1995;243;25-34;143;143;286;SEC_243
1995;411;12-15;33;17;50;SEC_411
1995;127;25-34;76;71;147;SEC_127
1995;113;75 i +;34;14;48;SEC_113
1995;501;35-49;179;149;328;SEC_501
1995;410;12-15;45;39;84;SEC_410
1995;112;50-64;123;107;230;SEC_112
1995;130;12-15;17;15;32;SEC_130
1995;503;25-34;78;60;138;SEC_503
1995;525;65-74;39;38;77;SEC_525
1995;438;75 i +;29;15;44;SEC_438
1995;416;03-11;18;19;37;SEC_416
1995;611;75 i +;35;21;56;SEC_611
1995;520;18-24;67;64;131;SEC_520
1995;533;00-02;6;6;12;SEC_533
1995;231;65-74;86;66;152;SEC_231
1995;114;50-64;191;205;396;SEC_114
1995;248;16-17;13;14;27;SEC_248
1995;210;35-49;86;92;178;SEC_210
1995;228;75 i +;29;17;46;SEC_228
1995;427;35-49;65;69;134;SEC_427
1995;609;16-17;22;16;38;SEC_609
1995;523;25-34;109;100;209;SEC_523
1995;123;16-17;14;21;35;SEC_123
1995;203;16-17;6;5;11;SEC_203
1995;309;03-11;23;33;56;SEC_309
1995;519;35-49;33;30;63;SEC_519
1995;222;16-17;10;11;21;SEC_222
1995;514;12-15;14;20;34;SEC_514
1995;608;25-34;87;95;182;SEC_608
1995;413;03-11;19;21;40;SEC_413
1995;538;65-74;74;65;139;SEC_538
1995;439;35-49;57;64;121;SEC_439
1995;131;65-74;52;49;101;SEC_131
1995;223;50-64;129;128;257;SEC_223
1995;102;75 i +;62;24;86;SEC_102
1995;531;35-49;77;76;153;SEC_531
1995;538;35-49;95;102;197;SEC_538
1995;213;12-15;19;28;47;SEC_213
1995;425;50-64;103;97;200;SEC_425
1995;136;35-49;153;149;302;SEC_136
1995;233;18-24;36;44;80;SEC_233
1995;110;25-34;89;89;178;SEC_110
1995;420;65-74;74;55;129;SEC_420
1995;631;65-74;34;37;71;SEC_631
1995;508;16-17;13;11;24;SEC_508
1995;201;65-74;41;36;77;SEC_201
1995;204;00-02;6;5;11;SEC_204
1995;315;75 i +;50;22;72;SEC_315
1995;203;65-74;66;51;117;SEC_203
1995;139;65-74;29;23;52;SEC_139
1995;429;16-17;14;8;22;SEC_429
1995;632;75 i +;23;9;32;SEC_632
1995;627;16-17;36;26;62;SEC_627
1995;607;03-11;31;37;68;SEC_607
1995;607;00-02;12;9;21;SEC_607
1995;204;16-17;5;5;10;SEC_204
1995;222;03-11;29;37;66;SEC_222
1995;432;25-34;91;93;184;SEC_432
1995;303;16-17;22;25;47;SEC_303
1995;208;12-15;28;42;70;SEC_208
1995;120;75 i +;29;21;50;SEC_120
1995;246;12-15;24;10;34;SEC_246
1995;217;03-11;22;22;44;SEC_217
1995;224;65-74;42;30;72;SEC_224
1995;126;50-64;144;161;305;SEC_126
1995;614;18-24;93;100;193;SEC_614
1995;611;16-17;16;19;35;SEC_611
1995;307;16-17;33;34;67;SEC_307
1995;537;16-17;20;25;45;SEC_537
1995;120;35-49;220;235;455;SEC_120
1995;513;35-49;56;59;115;SEC_513
1995;523;75 i +;76;28;104;SEC_523
1995;105;65-74;50;42;92;SEC_105
1995;116;75 i +;47;15;62;SEC_116
1995;535;50-64;117;147;264;SEC_535
1995;611;35-49;131;100;231;SEC_611
1995;309;00-02;11;5;16;SEC_309
1995;439;03-11;34;42;76;SEC_439
1995;609;75 i +;31;13;44;SEC_609
1995;302;75 i +;39;20;59;SEC_302
1995;122;03-11;28;12;40;SEC_122
1995;230;75 i +;33;14;47;SEC_230
1995;511;75 i +;32;8;40;SEC_511
1995;230;00-02;7;7;14;SEC_230
1995;113;18-24;81;80;161;SEC_113
1995;231;35-49;82;65;147;SEC_231
1995;246;65-74;79;75;154;SEC_246
1995;216;75 i +;36;26;62;SEC_216
1995;312;03-11;63;36;99;SEC_312
1995;530;35-49;102;102;204;SEC_530
1995;403;00-02;3;7;10;SEC_403
1995;421;03-11;23;41;64;SEC_421
1995;619;35-49;168;150;318;SEC_619
1995;136;50-64;102;91;193;SEC_136
1995;208;25-34;117;145;262;SEC_208
1995;118;18-24;134;150;284;SEC_118
1995;415;75 i +;36;18;54;SEC_415
1995;413;65-74;41;37;78;SEC_413
1995;135;50-64;122;132;254;SEC_135
1995;615;65-74;31;22;53;SEC_615
1995;102;25-34;126;157;283;SEC_102
1995;522;12-15;20;22;42;SEC_522
1995;530;18-24;78;83;161;SEC_530
1995;132;65-74;65;56;121;SEC_132
1995;523;12-15;35;35;70;SEC_523
1995;527;75 i +;44;25;69;SEC_527
1995;137;16-17;30;18;48;SEC_137
1995;318;75 i +;10;9;19;SEC_318
1995;247;35-49;94;112;206;SEC_247
1995;518;03-11;33;42;75;SEC_518
1995;623;00-02;17;21;38;SEC_623
1995;511;25-34;51;77;128;SEC_511
1995;414;16-17;13;14;27;SEC_414
1995;509;18-24;47;66;113;SEC_509
1995;609;03-11;32;41;73;SEC_609
1995;416;50-64;97;97;194;SEC_416
1995;228;03-11;10;15;25;SEC_228
1995;630;25-34;59;73;132;SEC_630
1995;131;16-17;27;38;65;SEC_131
1995;512;65-74;46;35;81;SEC_512
1995;132;25-34;171;187;358;SEC_132
1995;527;00-02;7;8;15;SEC_527
1995;317;03-11;31;33;64;SEC_317
1995;239;50-64;130;119;249;SEC_239
1995;127;35-49;91;102;193;SEC_127
1995;409;50-64;84;88;172;SEC_409
1995;202;00-02;6;6;12;SEC_202
1995;235;65-74;112;78;190;SEC_235
1995;435;03-11;41;52;93;SEC_435
1995;442;12-15;11;13;24;SEC_442
1995;109;16-17;24;13;37;SEC_109
1995;117;65-74;53;42;95;SEC_117
1995;621;50-64;123;148;271;SEC_621
1995;225;35-49;54;44;98;SEC_225
1995;438;35-49;65;73;138;SEC_438
1995;322;18-24;87;70;157;SEC_322
1995;427;12-15;17;13;30;SEC_427
1995;221;03-11;32;47;79;SEC_221
1995;238;25-34;56;51;107;SEC_238
1995;529;75 i +;53;31;84;SEC_529
1995;116;16-17;23;29;52;SEC_116
1995;432;18-24;71;88;159;SEC_432
1995;613;18-24;187;163;350;SEC_613
1995;631;75 i +;26;15;41;SEC_631
1995;239;12-15;22;12;34;SEC_239
1995;402;00-02;4;2;6;SEC_402
1995;127;00-02;13;14;27;SEC_127
1995;438;16-17;7;11;18;SEC_438
1995;524;03-11;37;48;85;SEC_524
1995;632;00-02;14;18;32;SEC_632
1995;614;25-34;85;83;168;SEC_614
1995;521;12-15;35;36;71;SEC_521
1995;220;25-34;79;74;153;SEC_220
1995;247;16-17;20;17;37;SEC_247
1995;248;50-64;102;104;206;SEC_248
1995;441;50-64;164;165;329;SEC_441
1995;417;03-11;26;28;54;SEC_417
1995;622;00-02;11;20;31;SEC_622
1995;435;50-64;96;85;181;SEC_435
1995;406;03-11;56;51;107;SEC_406
1995;504;25-34;91;105;196;SEC_504
1995;303;18-24;145;141;286;SEC_303
1995;425;03-11;26;24;50;SEC_425
1995;629;25-34;63;57;120;SEC_629
1995;411;65-74;77;70;147;SEC_411
1995;232;50-64;106;94;200;SEC_232
1995;303;75 i +;64;38;102;SEC_303
1995;110;65-74;48;34;82;SEC_110
1995;136;75 i +;42;23;65;SEC_136
1995;441;00-02;22;8;30;SEC_441
1995;302;03-11;60;44;104;SEC_302
1995;233;16-17;3;7;10;SEC_233
1995;415;25-34;63;57;120;SEC_415
1995;117;35-49;283;265;548;SEC_117
1995;406;75 i +;46;32;78;SEC_406
1995;626;00-02;8;11;19;SEC_626
1995;606;65-74;57;43;100;SEC_606
1995;201;00-02;5;7;12;SEC_201
1995;140;35-49;85;80;165;SEC_140
1995;312;25-34;121;127;248;SEC_312
1995;319;12-15;27;30;57;SEC_319
1995;322;16-17;20;19;39;SEC_322
1995;425;75 i +;45;20;65;SEC_425
1995;126;65-74;53;39;92;SEC_126
1995;119;75 i +;30;24;54;SEC_119
1995;138;25-34;66;58;124;SEC_138
1995;624;35-49;165;127;292;SEC_624
1995;207;75 i +;40;17;57;SEC_207
1995;613;65-74;45;44;89;SEC_613
1995;627;65-74;34;20;54;SEC_627
1995;129;35-49;107;111;218;SEC_129
1995;215;25-34;79;84;163;SEC_215
1995;132;16-17;37;52;89;SEC_132
1995;238;16-17;3;6;9;SEC_238
1995;233;00-02;8;2;10;SEC_233
1995;424;12-15;8;22;30;SEC_424
1995;319;00-02;6;10;16;SEC_319
1995;524;25-34;108;108;216;SEC_524
1995;325;03-11;49;51;100;SEC_325
1995;231;50-64;116;111;227;SEC_231
1995;210;25-34;59;73;132;SEC_210
1995;402;75 i +;42;23;65;SEC_402
1995;535;35-49;155;144;299;SEC_535
1995;403;35-49;118;96;214;SEC_403
1995;612;50-64;169;188;357;SEC_612
1995;401;75 i +;29;13;42;SEC_401
1995;441;65-74;101;86;187;SEC_441
1995;125;00-02;7;10;17;SEC_125
1995;101;35-49;132;136;268;SEC_101
1995;120;18-24;91;92;183;SEC_120
1995;210;65-74;90;77;167;SEC_210
1995;241;12-15;11;7;18;SEC_241
1995;233;65-74;51;39;90;SEC_233
1995;421;00-02;9;8;17;SEC_421
1995;107;16-17;36;37;73;SEC_107
1995;409;75 i +;19;9;28;SEC_409
1995;602;16-17;6;5;11;SEC_602
1995;412;12-15;52;56;108;SEC_412
1995;114;16-17;33;32;65;SEC_114
1995;105;35-49;173;159;332;SEC_105
1995;422;00-02;6;7;13;SEC_422
1995;407;65-74;79;72;151;SEC_407
1995;210;00-02;8;5;13;SEC_210
1995;225;65-74;56;38;94;SEC_225
1995;241;03-11;23;13;36;SEC_241
1995;101;03-11;66;66;132;SEC_101
1995;432;75 i +;27;15;42;SEC_432
1995;430;00-02;12;10;22;SEC_430
1995;434;18-24;26;21;47;SEC_434
1995;111;75 i +;34;20;54;SEC_111
1995;213;18-24;49;65;114;SEC_213
1995;311;50-64;146;146;292;SEC_311
1995;620;25-34;45;48;93;SEC_620
1995;441;75 i +;45;28;73;SEC_441
1995;227;65-74;53;42;95;SEC_227
1995;430;18-24;53;57;110;SEC_430
1995;110;12-15;33;34;67;SEC_110
1995;419;35-49;56;63;119;SEC_419
1995;230;65-74;66;45;111;SEC_230
1995;626;35-49;118;117;235;SEC_626
1995;529;00-02;5;12;17;SEC_529
1995;404;35-49;110;114;224;SEC_404
1995;517;35-49;83;83;166;SEC_517
1995;619;00-02;15;13;28;SEC_619
1995;415;50-64;60;72;132;SEC_415
1995;116;65-74;65;60;125;SEC_116
1995;223;16-17;10;17;27;SEC_223
1995;430;16-17;10;10;20;SEC_430
1995;116;50-64;146;161;307;SEC_116
1995;441;25-34;118;116;234;SEC_441
1995;319;16-17;12;23;35;SEC_319
1995;310;18-24;36;62;98;SEC_310
1995;417;12-15;16;14;30;SEC_417
1995;241;35-49;37;43;80;SEC_241
1995;218;35-49;82;77;159;SEC_218
1995;318;03-11;49;58;107;SEC_318
1995;429;75 i +;31;19;50;SEC_429
1995;110;18-24;119;112;231;SEC_110
1995;436;03-11;31;34;65;SEC_436
1995;220;65-74;71;49;120;SEC_220
1995;221;50-64;126;124;250;SEC_221
1995;422;12-15;26;16;42;SEC_422
1995;506;00-02;15;25;40;SEC_506
1995;432;03-11;44;53;97;SEC_432
1995;216;12-15;30;24;54;SEC_216
1995;228;18-24;46;39;85;SEC_228
1995;610;75 i +;35;21;56;SEC_610
1995;305;16-17;20;15;35;SEC_305
1995;530;65-74;91;68;159;SEC_530
1995;428;65-74;33;37;70;SEC_428
1995;218;16-17;6;10;16;SEC_218
1995;435;00-02;8;9;17;SEC_435
1995;130;35-49;63;66;129;SEC_130
1995;113;03-11;80;81;161;SEC_113
1995;319;65-74;34;29;63;SEC_319
1995;107;35-49;193;200;393;SEC_107
1995;614;12-15;24;26;50;SEC_614
1995;511;03-11;11;20;31;SEC_511
1995;412;16-17;34;37;71;SEC_412
1995;231;00-02;7;12;19;SEC_231
1995;406;25-34;97;106;203;SEC_406
1995;431;03-11;53;59;112;SEC_431
1995;113;25-34;82;79;161;SEC_113
1995;320;50-64;113;130;243;SEC_320
1995;614;16-17;16;23;39;SEC_614
1995;519;25-34;60;62;122;SEC_519
1995;249;12-15;13;19;32;SEC_249
1995;424;35-49;59;51;110;SEC_424
1995;610;25-34;90;130;220;SEC_610
1995;403;03-11;40;39;79;SEC_403
1995;425;25-34;72;80;152;SEC_425
1995;617;35-49;110;110;220;SEC_617
1995;403;25-34;91;100;191;SEC_403
1995;608;03-11;44;62;106;SEC_608
1995;210;16-17;12;7;19;SEC_210
1995;529;03-11;24;38;62;SEC_529
1995;440;03-11;21;25;46;SEC_440
1995;310;25-34;68;55;123;SEC_310
1995;239;03-11;18;29;47;SEC_239
1995;505;25-34;97;109;206;SEC_505
1995;531;50-64;96;104;200;SEC_531
1995;418;50-64;127;115;242;SEC_418
1995;202;50-64;82;76;158;SEC_202
1995;514;18-24;49;42;91;SEC_514
1995;501;18-24;122;143;265;SEC_501
1995;133;12-15;25;25;50;SEC_133
1995;403;18-24;75;85;160;SEC_403
1995;416;65-74;51;42;93;SEC_416
1995;515;25-34;62;52;114;SEC_515
1995;533;35-49;62;64;126;SEC_533
1995;618;75 i +;23;10;33;SEC_618
1995;418;00-02;14;7;21;SEC_418
1995;114;65-74;59;45;104;SEC_114
1995;237;00-02;11;8;19;SEC_237
1995;217;25-34;54;49;103;SEC_217
1995;137;50-64;98;115;213;SEC_137
1995;412;50-64;180;180;360;SEC_412
1995;438;50-64;110;112;222;SEC_438
1995;423;03-11;27;36;63;SEC_423
1995;216;25-34;87;83;170;SEC_216
1995;205;35-49;91;88;179;SEC_205
1995;311;18-24;90;91;181;SEC_311
1995;612;00-02;11;11;22;SEC_612
1995;534;75 i +;42;21;63;SEC_534
1995;125;25-34;89;77;166;SEC_125
1995;531;75 i +;41;23;64;SEC_531
1995;611;25-34;152;188;340;SEC_611
1995;442;65-74;40;32;72;SEC_442
1995;221;25-34;95;97;192;SEC_221
1995;229;03-11;15;23;38;SEC_229
1995;228;16-17;5;9;14;SEC_228
1995;219;75 i +;60;31;91;SEC_219
1995;117;50-64;135;151;286;SEC_117
1995;313;18-24;104;117;221;SEC_313
1995;324;12-15;19;14;33;SEC_324
1995;441;03-11;130;118;248;SEC_441
1995;423;16-17;8;13;21;SEC_423
1995;620;75 i +;16;1;17;SEC_620
1995;237;75 i +;63;31;94;SEC_237
1995;616;35-49;174;180;354;SEC_616
1995;621;12-15;58;72;130;SEC_621
1995;442;50-64;59;65;124;SEC_442
1995;428;50-64;57;45;102;SEC_428
1995;124;25-34;60;58;118;SEC_124
1995;235;25-34;131;121;252;SEC_235
1995;628;35-49;144;107;251;SEC_628
1995;312;75 i +;22;10;32;SEC_312
1995;227;03-11;14;12;26;SEC_227
1995;211;35-49;77;91;168;SEC_211
1995;532;16-17;15;22;37;SEC_532
1995;138;50-64;77;71;148;SEC_138
1995;220;50-64;90;80;170;SEC_220
1995;402;18-24;56;53;109;SEC_402
1995;211;03-11;33;40;73;SEC_211
1995;517;16-17;12;18;30;SEC_517
1995;140;75 i +;34;20;54;SEC_140
1995;609;00-02;8;11;19;SEC_609
1995;129;75 i +;35;15;50;SEC_129
1995;408;00-02;5;5;10;SEC_408
1995;224;18-24;28;31;59;SEC_224
1995;518;50-64;145;135;280;SEC_518
1995;140;50-64;132;120;252;SEC_140
1995;304;18-24;58;71;129;SEC_304
1995;606;16-17;11;19;30;SEC_606
1995;427;18-24;51;48;99;SEC_427
1995;243;75 i +;77;38;115;SEC_243
1995;504;35-49;113;114;227;SEC_504
1995;428;25-34;52;54;106;SEC_428
1995;208;16-17;25;19;44;SEC_208
1995;525;25-34;68;78;146;SEC_525
1995;617;25-34;108;120;228;SEC_617
1995;612;25-34;88;102;190;SEC_612
1995;134;03-11;62;72;134;SEC_134
1995;610;00-02;7;11;18;SEC_610
1995;206;25-34;67;67;134;SEC_206
1995;306;18-24;83;68;151;SEC_306
1995;311;65-74;91;81;172;SEC_311
1995;226;25-34;69;83;152;SEC_226
1995;439;16-17;7;7;14;SEC_439
1995;240;18-24;44;32;76;SEC_240
1995;228;65-74;49;32;81;SEC_228
1995;240;03-11;16;26;42;SEC_240
1995;306;16-17;18;33;51;SEC_306
1995;623;25-34;115;106;221;SEC_623
1995;623;18-24;137;168;305;SEC_623
1995;301;03-11;55;72;127;SEC_301
1995;102;16-17;32;32;64;SEC_102
1995;434;03-11;28;20;48;SEC_434
1995;139;75 i +;24;7;31;SEC_139
1995;132;50-64;163;185;348;SEC_132
1995;425;65-74;64;64;128;SEC_425
1995;305;18-24;64;79;143;SEC_305
1995;530;00-02;8;12;20;SEC_530
1995;101;16-17;15;22;37;SEC_101
1995;126;03-11;31;32;63;SEC_126
1995;521;25-34;68;77;145;SEC_521
1995;130;50-64;141;113;254;SEC_130
1995;508;03-11;28;20;48;SEC_508
1995;212;75 i +;57;30;87;SEC_212
1995;214;16-17;11;10;21;SEC_214
1995;516;00-02;8;7;15;SEC_516
1995;602;25-34;71;75;146;SEC_602
1995;507;00-02;5;8;13;SEC_507
1995;302;12-15;44;45;89;SEC_302
1995;438;00-02;5;8;13;SEC_438
1995;314;35-49;333;346;679;SEC_314
1995;304;25-34;82;113;195;SEC_304
1995;139;50-64;77;75;152;SEC_139
1995;519;12-15;9;18;27;SEC_519
1995;534;50-64;98;105;203;SEC_534
1995;233;25-34;75;77;152;SEC_233
1995;523;18-24;83;79;162;SEC_523
1995;212;00-02;9;12;21;SEC_212
1995;512;75 i +;34;16;50;SEC_512
1995;229;16-17;8;7;15;SEC_229
1995;237;03-11;35;26;61;SEC_237
1995;102;35-49;186;164;350;SEC_102
1995;232;00-02;8;7;15;SEC_232
1995;526;03-11;23;32;55;SEC_526
1995;537;35-49;126;114;240;SEC_537
1995;439;00-02;14;4;18;SEC_439
1995;530;16-17;17;18;35;SEC_530
1995;321;75 i +;64;37;101;SEC_321
1995;531;65-74;53;40;93;SEC_531
1995;605;03-11;18;14;32;SEC_605
1995;218;03-11;23;37;60;SEC_218
1995;442;16-17;10;13;23;SEC_442
1995;312;18-24;86;86;172;SEC_312
1995;312;50-64;121;147;268;SEC_312
1995;622;03-11;53;47;100;SEC_622
1995;325;12-15;47;34;81;SEC_325
1995;510;65-74;62;36;98;SEC_510
1995;234;50-64;103;77;180;SEC_234
1995;608;16-17;18;30;48;SEC_608
1995;618;18-24;60;75;135;SEC_618
1995;314;65-74;67;55;122;SEC_314
1995;114;75 i +;52;18;70;SEC_114
1995;307;65-74;70;59;129;SEC_307
1995;128;65-74;42;42;84;SEC_128
1995;626;25-34;104;119;223;SEC_626
1995;201;75 i +;30;13;43;SEC_201
1995;624;18-24;125;154;279;SEC_624
1995;532;25-34;113;106;219;SEC_532
1995;304;16-17;16;11;27;SEC_304
1995;323;25-34;215;181;396;SEC_323
1995;538;50-64;158;141;299;SEC_538
1995;242;65-74;77;83;160;SEC_242
1995;246;25-34;84;92;176;SEC_246
1995;310;75 i +;23;12;35;SEC_310
1995;529;65-74;71;63;134;SEC_529
1995;314;75 i +;48;16;64;SEC_314
1995;219;16-17;6;11;17;SEC_219
1995;211;65-74;114;88;202;SEC_211
1995;632;18-24;114;118;232;SEC_632
1995;420;35-49;90;105;195;SEC_420
1995;137;25-34;104;96;200;SEC_137
1995;201;16-17;7;13;20;SEC_201
1995;407;16-17;13;12;25;SEC_407
1995;306;35-49;182;179;361;SEC_306
1995;618;00-02;4;5;9;SEC_618
1995;515;03-11;30;22;52;SEC_515
1995;603;00-02;7;7;14;SEC_603
1995;413;16-17;6;8;14;SEC_413
1995;414;50-64;99;97;196;SEC_414
1995;207;00-02;8;4;12;SEC_207
1995;632;12-15;33;43;76;SEC_632
1995;219;25-34;92;99;191;SEC_219
1995;221;00-02;12;10;22;SEC_221
1995;234;12-15;17;17;34;SEC_234
1995;533;18-24;58;50;108;SEC_533
1995;241;18-24;28;29;57;SEC_241
1995;602;65-74;24;23;47;SEC_602
1995;420;75 i +;70;38;108;SEC_420
1995;435;18-24;54;59;113;SEC_435
1995;227;50-64;67;62;129;SEC_227
1995;245;75 i +;59;26;85;SEC_245
1995;613;00-02;15;11;26;SEC_613
1995;315;16-17;30;29;59;SEC_315
1995;438;25-34;74;83;157;SEC_438
1995;502;00-02;12;9;21;SEC_502
1995;201;50-64;95;85;180;SEC_201
1995;424;65-74;24;23;47;SEC_424
1995;247;25-34;101;103;204;SEC_247
1995;122;25-34;90;96;186;SEC_122
1995;240;25-34;47;60;107;SEC_240
1995;607;16-17;12;18;30;SEC_607
1995;316;35-49;485;448;933;SEC_316
1995;137;03-11;62;67;129;SEC_137
1995;121;35-49;51;53;104;SEC_121
1995;317;35-49;62;77;139;SEC_317
1995;422;25-34;76;83;159;SEC_422
1995;132;12-15;62;83;145;SEC_132
1995;527;18-24;59;48;107;SEC_527
1995;434;50-64;60;57;117;SEC_434
1995;608;12-15;30;25;55;SEC_608
1995;242;16-17;8;16;24;SEC_242
1995;613;16-17;15;18;33;SEC_613
1995;123;75 i +;63;29;92;SEC_123
1995;205;00-02;7;3;10;SEC_205
1995;123;25-34;100;108;208;SEC_123
1995;621;25-34;116;107;223;SEC_621
1995;211;18-24;48;62;110;SEC_211
1995;245;12-15;27;19;46;SEC_245
1995;604;00-02;9;13;22;SEC_604
1995;603;75 i +;13;9;22;SEC_603
1995;434;00-02;2;8;10;SEC_434
1995;118;35-49;275;267;542;SEC_118
1995;531;00-02;7;7;14;SEC_531
1995;422;18-24;50;52;102;SEC_422
1995;206;18-24;45;57;102;SEC_206
1995;245;35-49;89;90;179;SEC_245
1995;437;18-24;56;58;114;SEC_437
1995;402;03-11;23;24;47;SEC_402
1995;212;25-34;118;123;241;SEC_212
1995;140;25-34;78;87;165;SEC_140
1995;609;35-49;111;66;177;SEC_609
1995;436;35-49;57;79;136;SEC_436
1995;121;25-34;87;110;197;SEC_121
1995;213;50-64;94;92;186;SEC_213
1995;303;00-02;9;10;19;SEC_303
1995;309;25-34;66;55;121;SEC_309
1995;113;50-64;92;91;183;SEC_113
1995;411;00-02;10;9;19;SEC_411
1995;513;00-02;2;7;9;SEC_513
1995;138;16-17;15;24;39;SEC_138
1995;214;12-15;13;18;31;SEC_214
1995;116;12-15;51;43;94;SEC_116
1995;127;50-64;61;58;119;SEC_127
1995;140;12-15;17;21;38;SEC_140
1995;405;12-15;9;16;25;SEC_405
1995;623;16-17;33;33;66;SEC_623
1995;217;12-15;8;9;17;SEC_217
1995;221;75 i +;42;20;62;SEC_221
1995;126;18-24;125;116;241;SEC_126
1995;421;16-17;13;27;40;SEC_421
1995;107;03-11;70;76;146;SEC_107
1995;217;16-17;5;6;11;SEC_217
1995;110;03-11;55;50;105;SEC_110
1995;238;50-64;75;69;144;SEC_238
1995;510;16-17;15;15;30;SEC_510
1995;302;25-34;121;131;252;SEC_302
1995;130;65-74;71;64;135;SEC_130
1995;116;18-24;152;140;292;SEC_116
1995;217;50-64;53;53;106;SEC_217
1995;607;50-64;161;155;316;SEC_607
1995;323;75 i +;38;9;47;SEC_323
1995;602;03-11;18;16;34;SEC_602
1995;323;65-74;52;39;91;SEC_323
1995;623;35-49;218;180;398;SEC_623
1995;310;00-02;7;9;16;SEC_310
1995;630;35-49;140;126;266;SEC_630
1995;507;16-17;14;20;34;SEC_507
1995;207;18-24;37;33;70;SEC_207
1995;533;50-64;119;107;226;SEC_533
1995;405;03-11;20;24;44;SEC_405
1995;435;12-15;15;24;39;SEC_435
1995;409;25-34;62;65;127;SEC_409
1995;227;00-02;6;8;14;SEC_227
1995;612;18-24;118;127;245;SEC_612
1995;308;25-34;105;102;207;SEC_308
1995;612;35-49;101;80;181;SEC_612
1995;627;00-02;7;10;17;SEC_627
1995;614;00-02;9;12;21;SEC_614
1995;423;25-34;82;88;170;SEC_423
1995;130;00-02;6;4;10;SEC_130
1995;117;12-15;62;73;135;SEC_117
1995;238;03-11;18;28;46;SEC_238
1995;628;00-02;10;9;19;SEC_628
1995;410;75 i +;56;33;89;SEC_410
1995;607;35-49;83;83;166;SEC_607
1995;520;50-64;88;96;184;SEC_520
1995;525;16-17;20;11;31;SEC_525
1995;321;03-11;97;115;212;SEC_321
1995;622;25-34;94;85;179;SEC_622
1995;314;50-64;122;139;261;SEC_314
1995;237;12-15;26;21;47;SEC_237
1995;207;12-15;15;19;34;SEC_207
1995;435;65-74;114;89;203;SEC_435
1995;231;12-15;14;17;31;SEC_231
1995;520;16-17;14;16;30;SEC_520
1995;441;35-49;280;281;561;SEC_441
1995;425;16-17;8;13;21;SEC_425
1995;319;35-49;106;100;206;SEC_319
1995;307;00-02;15;15;30;SEC_307
1995;423;50-64;132;130;262;SEC_423
1995;427;16-17;8;15;23;SEC_427
1995;124;12-15;27;31;58;SEC_124
1995;427;50-64;105;70;175;SEC_427
1995;522;75 i +;26;24;50;SEC_522
1995;112;18-24;107;99;206;SEC_112
1995;202;12-15;13;16;29;SEC_202
1995;228;12-15;12;6;18;SEC_228
1995;216;18-24;82;100;182;SEC_216
1995;315;50-64;109;105;214;SEC_315
1995;522;00-02;6;7;13;SEC_522
1995;316;16-17;52;62;114;SEC_316
1995;507;18-24;58;69;127;SEC_507
1995;440;00-02;8;5;13;SEC_440
1995;317;18-24;40;59;99;SEC_317
1995;534;18-24;75;77;152;SEC_534
1995;242;00-02;6;6;12;SEC_242
1995;135;35-49;186;178;364;SEC_135
1995;506;25-34;144;164;308;SEC_506
1995;524;65-74;70;53;123;SEC_524
1995;601;03-11;52;56;108;SEC_601
1995;505;03-11;46;40;86;SEC_505
1995;627;50-64;69;103;172;SEC_627
1995;130;16-17;15;8;23;SEC_130
1995;139;35-49;101;105;206;SEC_139
1995;511;00-02;3;12;15;SEC_511
1995;106;25-34;122;141;263;SEC_106
1995;135;00-02;18;16;34;SEC_135
1995;228;50-64;73;77;150;SEC_228
1995;617;75 i +;19;16;35;SEC_617
1995;425;35-49;85;76;161;SEC_425
1995;319;75 i +;38;16;54;SEC_319
1995;438;18-24;69;61;130;SEC_438
1995;245;50-64;108;91;199;SEC_245
1995;413;75 i +;29;13;42;SEC_413
1995;114;12-15;58;53;111;SEC_114
1995;244;00-02;6;4;10;SEC_244
1995;628;75 i +;27;11;38;SEC_628
1995;236;18-24;66;64;130;SEC_236
1995;611;50-64;214;250;464;SEC_611
1995;206;35-49;73;70;143;SEC_206
1995;618;65-74;26;24;50;SEC_618
1995;621;18-24;160;202;362;SEC_621
1995;105;16-17;27;20;47;SEC_105
1995;209;75 i +;68;35;103;SEC_209
1995;202;65-74;41;31;72;SEC_202
1995;244;12-15;11;9;20;SEC_244
1995;624;50-64;133;150;283;SEC_624
1995;405;50-64;142;121;263;SEC_405
1995;505;75 i +;41;24;65;SEC_505
1995;318;35-49;136;144;280;SEC_318
1995;140;00-02;6;5;11;SEC_140
1995;528;75 i +;30;19;49;SEC_528
1995;212;50-64;138;129;267;SEC_212
1995;503;50-64;67;69;136;SEC_503
1995;515;00-02;5;8;13;SEC_515
1995;405;00-02;9;10;19;SEC_405
1995;222;00-02;13;9;22;SEC_222
1995;404;25-34;114;132;246;SEC_404
1995;430;25-34;75;81;156;SEC_430
1995;222;25-34;68;64;132;SEC_222
1995;117;16-17;44;43;87;SEC_117
1995;405;16-17;9;10;19;SEC_405
1995;120;12-15;37;44;81;SEC_120
1995;231;75 i +;75;31;106;SEC_231
1995;436;25-34;75;84;159;SEC_436
1995;123;03-11;53;42;95;SEC_123
1995;243;16-17;16;14;30;SEC_243
1995;114;25-34;142;175;317;SEC_114
1995;538;16-17;18;14;32;SEC_538
1995;116;25-34;125;129;254;SEC_116
1995;442;00-02;5;2;7;SEC_442
1995;136;03-11;59;57;116;SEC_136
1995;121;75 i +;30;22;52;SEC_121
1995;245;25-34;56;67;123;SEC_245
1995;104;00-02;10;7;17;SEC_104
1995;313;50-64;159;154;313;SEC_313
1995;424;25-34;37;49;86;SEC_424
1995;512;35-49;60;68;128;SEC_512
1995;531;25-34;85;86;171;SEC_531
1995;530;03-11;42;51;93;SEC_530
1995;213;75 i +;22;10;32;SEC_213
1995;410;00-02;12;13;25;SEC_410
1995;104;75 i +;61;29;90;SEC_104
1995;316;18-24;137;131;268;SEC_316
1995;517;65-74;45;48;93;SEC_517
1995;225;00-02;1;4;5;SEC_225
1995;614;35-49;118;86;204;SEC_614
1995;240;12-15;16;12;28;SEC_240
1995;606;25-34;122;128;250;SEC_606
1995;213;25-34;60;77;137;SEC_213
1995;125;35-49;163;150;313;SEC_125
1995;620;65-74;9;13;22;SEC_620
1995;138;00-02;5;16;21;SEC_138
1995;424;75 i +;14;9;23;SEC_424
1995;629;50-64;73;65;138;SEC_629
1995;601;18-24;103;127;230;SEC_601
1995;416;16-17;5;15;20;SEC_416
1995;230;16-17;7;9;16;SEC_230
1995;434;12-15;12;13;25;SEC_434
1995;631;12-15;35;30;65;SEC_631
1995;201;12-15;14;10;24;SEC_201
1995;537;75 i +;40;28;68;SEC_537
1995;236;65-74;85;69;154;SEC_236
1995;501;50-64;88;122;210;SEC_501
1995;615;12-15;17;15;32;SEC_615
1995;219;00-02;12;6;18;SEC_219
1995;422;75 i +;58;30;88;SEC_422
1995;605;50-64;125;121;246;SEC_605
1995;318;12-15;30;27;57;SEC_318
1995;528;16-17;6;20;26;SEC_528
1995;605;16-17;11;13;24;SEC_605
1995;528;18-24;89;81;170;SEC_528
1995;422;50-64;97;92;189;SEC_422
1995;310;03-11;52;51;103;SEC_310
1995;310;16-17;14;15;29;SEC_310
1995;533;65-74;35;45;80;SEC_533
1995;119;00-02;7;11;18;SEC_119
1995;509;75 i +;39;18;57;SEC_509
1995;202;18-24;41;41;82;SEC_202
1995;211;75 i +;59;36;95;SEC_211
1995;108;35-49;147;140;287;SEC_108
1995;436;16-17;10;10;20;SEC_436
1995;617;16-17;24;27;51;SEC_617
1995;242;25-34;73;83;156;SEC_242
1995;609;50-64;107;146;253;SEC_609
1995;124;18-24;67;51;118;SEC_124
1995;401;35-49;122;115;237;SEC_401
1995;243;03-11;49;42;91;SEC_243
1995;231;16-17;13;17;30;SEC_231
1995;118;12-15;73;70;143;SEC_118
1995;426;50-64;84;81;165;SEC_426
1995;437;75 i +;19;7;26;SEC_437
1995;406;35-49;150;157;307;SEC_406
1995;425;12-15;22;13;35;SEC_425
1995;518;00-02;14;9;23;SEC_518
1995;247;75 i +;63;30;93;SEC_247
1995;201;03-11;15;20;35;SEC_201
1995;324;00-02;8;8;16;SEC_324
1995;406;18-24;83;88;171;SEC_406
1995;206;12-15;21;14;35;SEC_206
1995;617;50-64;135;124;259;SEC_617
1995;244;75 i +;38;22;60;SEC_244
1995;138;12-15;22;28;50;SEC_138
1995;114;35-49;202;182;384;SEC_114
1995;249;50-64;119;107;226;SEC_249
1995;630;50-64;81;87;168;SEC_630
1995;535;75 i +;29;18;47;SEC_535
1995;629;16-17;9;12;21;SEC_629
1995;603;16-17;13;11;24;SEC_603
1995;510;50-64;125;121;246;SEC_510
1995;422;35-49;83;109;192;SEC_422
1995;427;25-34;74;76;150;SEC_427
1995;232;25-34;73;84;157;SEC_232
1995;612;16-17;18;29;47;SEC_612
1995;214;18-24;34;41;75;SEC_214
1995;321;35-49;316;299;615;SEC_321
1995;212;18-24;82;89;171;SEC_212
1995;210;75 i +;46;30;76;SEC_210
1995;109;03-11;52;50;102;SEC_109
1995;501;00-02;8;7;15;SEC_501
1995;627;35-49;197;167;364;SEC_627
1995;437;50-64;98;91;189;SEC_437
1995;238;75 i +;48;23;71;SEC_238
1995;117;00-02;22;23;45;SEC_117
1995;305;25-34;87;98;185;SEC_305
1995;103;50-64;77;73;150;SEC_103
1995;206;75 i +;53;29;82;SEC_206
1995;509;03-11;28;25;53;SEC_509
1995;437;65-74;39;42;81;SEC_437
1995;514;35-49;61;70;131;SEC_514
1995;525;50-64;97;85;182;SEC_525
1995;324;75 i +;48;16;64;SEC_324
1995;410;50-64;225;196;421;SEC_410
1995;510;75 i +;28;20;48;SEC_510
1995;611;12-15;27;31;58;SEC_611
1995;437;35-49;73;67;140;SEC_437
1995;415;35-49;65;63;128;SEC_415
1995;418;03-11;38;41;79;SEC_418
1995;227;75 i +;40;21;61;SEC_227
1995;113;12-15;48;49;97;SEC_113
1995;514;65-74;37;34;71;SEC_514
1995;604;03-11;31;34;65;SEC_604
1995;103;25-34;59;71;130;SEC_103
1995;526;12-15;18;18;36;SEC_526
1995;215;03-11;26;25;51;SEC_215
1995;508;25-34;46;65;111;SEC_508
1995;226;35-49;96;94;190;SEC_226
1995;603;18-24;60;61;121;SEC_603
1995;322;25-34;89;108;197;SEC_322
1995;323;00-02;32;37;69;SEC_323
1995;203;12-15;10;13;23;SEC_203
1995;302;18-24;111;119;230;SEC_302
1995;510;18-24;82;72;154;SEC_510
1995;243;00-02;19;20;39;SEC_243
1995;213;65-74;54;48;102;SEC_213
1995;526;35-49;65;65;130;SEC_526
1995;307;35-49;234;222;456;SEC_307
1995;513;16-17;5;10;15;SEC_513
1995;137;12-15;40;28;68;SEC_137
1995;104;03-11;23;23;46;SEC_104
1995;110;16-17;29;34;63;SEC_110
1995;241;25-34;54;51;105;SEC_241
1995;212;35-49;116;114;230;SEC_212
1995;438;03-11;33;27;60;SEC_438
1995;412;65-74;73;80;153;SEC_412
1995;405;35-49;51;56;107;SEC_405
1995;235;18-24;82;68;150;SEC_235
1995;624;00-02;9;9;18;SEC_624
1995;538;03-11;25;41;66;SEC_538
1995;320;35-49;95;62;157;SEC_320
1995;214;50-64;83;66;149;SEC_214
1995;429;12-15;16;24;40;SEC_429
1995;511;50-64;81;75;156;SEC_511
1995;101;12-15;33;36;69;SEC_101
1995;613;75 i +;35;20;55;SEC_613
1995;502;03-11;51;47;98;SEC_502
1995;517;18-24;71;81;152;SEC_517
1995;108;12-15;24;27;51;SEC_108
1995;211;16-17;6;13;19;SEC_211
1995;507;03-11;47;39;86;SEC_507
1995;247;00-02;13;12;25;SEC_247
1995;225;75 i +;20;22;42;SEC_225
1995;128;50-64;94;98;192;SEC_128
1995;201;18-24;36;50;86;SEC_201
1995;106;65-74;46;37;83;SEC_106
1995;416;12-15;18;9;27;SEC_416
1995;114;18-24;123;130;253;SEC_114
1995;507;12-15;21;17;38;SEC_507
1995;242;12-15;17;16;33;SEC_242
1995;235;03-11;33;35;68;SEC_235
1995;413;12-15;8;13;21;SEC_413
1995;223;75 i +;55;21;76;SEC_223
1995;504;75 i +;50;31;81;SEC_504
1995;519;50-64;76;62;138;SEC_519
1995;620;50-64;91;96;187;SEC_620
1995;511;35-49;47;47;94;SEC_511
1995;305;00-02;18;9;27;SEC_305
1995;123;18-24;73;58;131;SEC_123
1995;501;75 i +;21;9;30;SEC_501
1995;314;25-34;202;172;374;SEC_314
1995;503;75 i +;19;7;26;SEC_503
1995;528;25-34;94;111;205;SEC_528
1995;533;75 i +;46;23;69;SEC_533
1995;505;18-24;158;163;321;SEC_505
1995;318;00-02;13;12;25;SEC_318
1995;248;18-24;52;57;109;SEC_248
1995;503;00-02;8;18;26;SEC_503
1995;407;00-02;9;11;20;SEC_407
1995;414;03-11;27;43;70;SEC_414
1995;430;50-64;100;109;209;SEC_430
1995;306;65-74;99;76;175;SEC_306
1995;117;03-11;92;94;186;SEC_117
1995;110;35-49;184;154;338;SEC_110
1995;108;65-74;94;75;169;SEC_108
1995;220;12-15;16;15;31;SEC_220
1995;514;16-17;6;11;17;SEC_514
1995;619;50-64;160;167;327;SEC_619
1995;603;65-74;24;25;49;SEC_603
1995;424;03-11;25;17;42;SEC_424
1995;212;03-11;41;57;98;SEC_212
1995;212;12-15;24;23;47;SEC_212
1995;301;00-02;10;16;26;SEC_301
1995;103;03-11;27;23;50;SEC_103
1995;625;65-74;16;21;37;SEC_625
1995;416;00-02;7;5;12;SEC_416
1995;106;16-17;46;61;107;SEC_106
1995;631;16-17;21;24;45;SEC_631
1995;426;65-74;56;45;101;SEC_426
1995;208;03-11;52;54;106;SEC_208
1995;521;00-02;5;6;11;SEC_521
1995;113;35-49;193;187;380;SEC_113
1995;603;03-11;19;28;47;SEC_603
1995;615;50-64;130;160;290;SEC_615
1995;601;50-64;173;184;357;SEC_601
1995;207;35-49;81;64;145;SEC_207
1995;204;12-15;8;9;17;SEC_204
1995;223;18-24;63;63;126;SEC_223
1995;248;00-02;12;6;18;SEC_248
1995;115;25-34;120;106;226;SEC_115
1995;442;75 i +;22;16;38;SEC_442
1995;139;12-15;28;19;47;SEC_139
1995;119;03-11;58;64;122;SEC_119
1995;536;35-49;81;68;149;SEC_536
1995;614;50-64;116;135;251;SEC_614
1995;112;12-15;52;43;95;SEC_112
1995;431;18-24;98;85;183;SEC_431
1995;535;65-74;37;28;65;SEC_535
1995;425;00-02;7;7;14;SEC_425
1995;229;18-24;36;34;70;SEC_229
1995;418;18-24;70;68;138;SEC_418
1995;116;00-02;17;13;30;SEC_116
1995;528;12-15;23;30;53;SEC_528
1995;440;25-34;70;86;156;SEC_440
1995;134;25-34;107;95;202;SEC_134
1995;402;25-34;51;82;133;SEC_402
1995;512;12-15;11;16;27;SEC_512
1995;428;12-15;7;7;14;SEC_428
1995;137;75 i +;31;12;43;SEC_137
1995;617;00-02;7;9;16;SEC_617
1995;109;12-15;26;45;71;SEC_109
1995;603;12-15;15;20;35;SEC_603
1995;525;03-11;31;35;66;SEC_525
1995;529;12-15;19;23;42;SEC_529
1995;617;65-74;42;45;87;SEC_617
1995;110;50-64;125;145;270;SEC_110
1995;607;12-15;17;24;41;SEC_607
1995;532;50-64;159;171;330;SEC_532
1995;507;75 i +;33;21;54;SEC_507
1995;423;35-49;76;69;145;SEC_423
1995;405;65-74;60;50;110;SEC_405
1995;620;00-02;1;4;5;SEC_620
1995;419;03-11;28;25;53;SEC_419
1995;230;12-15;9;7;16;SEC_230
1995;224;00-02;4;6;10;SEC_224
1995;619;03-11;55;69;124;SEC_619
1995;430;75 i +;48;16;64;SEC_430
1995;231;03-11;24;14;38;SEC_231
1995;513;12-15;16;10;26;SEC_513
1995;435;25-34;69;85;154;SEC_435
1995;617;12-15;30;33;63;SEC_617
1995;223;03-11;29;45;74;SEC_223
1995;507;35-49;92;88;180;SEC_507
1995;516;03-11;23;12;35;SEC_516
1995;238;12-15;13;18;31;SEC_238
1995;621;00-02;23;23;46;SEC_621
1995;626;18-24;99;146;245;SEC_626
1995;111;50-64;112;107;219;SEC_111
1995;243;50-64;151;144;295;SEC_243
1995;430;35-49;64;75;139;SEC_430
1995;604;65-74;33;27;60;SEC_604
1995;623;65-74;48;29;77;SEC_623
1995;235;00-02;14;9;23;SEC_235
1995;240;35-49;60;48;108;SEC_240
1995;511;16-17;7;6;13;SEC_511
1995;313;12-15;77;53;130;SEC_313
1995;605;75 i +;22;11;33;SEC_605
1995;118;75 i +;14;16;30;SEC_118
1995;412;00-02;19;19;38;SEC_412
1995;219;18-24;59;62;121;SEC_219
1995;530;75 i +;57;32;89;SEC_530
1995;108;75 i +;75;37;112;SEC_108
1995;622;50-64;67;68;135;SEC_622
1995;408;65-74;41;36;77;SEC_408
1995;631;50-64;133;153;286;SEC_631
1995;429;03-11;21;27;48;SEC_429
1995;128;25-34;76;90;166;SEC_128
1995;208;00-02;11;11;22;SEC_208
1995;407;18-24;53;70;123;SEC_407
1995;425;18-24;65;54;119;SEC_425
1995;207;16-17;5;13;18;SEC_207
1995;311;16-17;15;19;34;SEC_311
1995;504;16-17;14;24;38;SEC_504
1995;524;50-64;139;125;264;SEC_524
1995;626;03-11;43;42;85;SEC_626
1995;513;25-34;63;72;135;SEC_513
1995;512;03-11;28;33;61;SEC_512
1995;137;35-49;194;160;354;SEC_137
1995;415;65-74;53;38;91;SEC_415
1995;316;12-15;110;129;239;SEC_316
1995;616;00-02;13;14;27;SEC_616
1995;412;25-34;119;141;260;SEC_412
1995;528;00-02;10;14;24;SEC_528
1995;441;16-17;49;32;81;SEC_441
1995;112;25-34;120;128;248;SEC_112
1995;529;18-24;57;75;132;SEC_529
1995;620;12-15;21;18;39;SEC_620
1995;135;16-17;32;38;70;SEC_135
1995;411;03-11;34;19;53;SEC_411
1995;301;25-34;160;143;303;SEC_301
1995;436;18-24;58;47;105;SEC_436
1995;519;16-17;3;8;11;SEC_519
1995;126;00-02;9;6;15;SEC_126
1995;441;12-15;62;67;129;SEC_441
1995;610;16-17;19;24;43;SEC_610
1995;432;35-49;159;141;300;SEC_432
1995;510;12-15;20;25;45;SEC_510
1995;530;50-64;168;153;321;SEC_530
1995;246;75 i +;58;27;85;SEC_246
1995;610;65-74;58;44;102;SEC_610
1995;401;65-74;85;81;166;SEC_401
1995;215;75 i +;70;35;105;SEC_215
1995;214;03-11;19;18;37;SEC_214
1995;203;03-11;12;24;36;SEC_203
1995;427;03-11;21;31;52;SEC_427
1995;605;12-15;13;17;30;SEC_605
1995;128;03-11;37;43;80;SEC_128
1995;627;12-15;52;54;106;SEC_627
1995;620;16-17;15;15;30;SEC_620
1995;512;18-24;62;64;126;SEC_512
1995;106;00-02;13;19;32;SEC_106
1995;610;35-49;149;83;232;SEC_610
1995;609;65-74;32;27;59;SEC_609
1995;230;18-24;48;34;82;SEC_230
1995;409;65-74;28;25;53;SEC_409
1995;104;16-17;5;8;13;SEC_104
1995;416;75 i +;23;10;33;SEC_416
1995;313;00-02;16;14;30;SEC_313
1995;629;03-11;26;21;47;SEC_629
1995;221;16-17;14;22;36;SEC_221
1995;203;18-24;32;34;66;SEC_203
1995;243;18-24;65;70;135;SEC_243
1995;115;00-02;10;17;27;SEC_115
1995;233;35-49;49;56;105;SEC_233
1995;320;75 i +;23;17;40;SEC_320
1995;506;03-11;83;107;190;SEC_506
1995;246;00-02;15;5;20;SEC_246
1995;205;16-17;14;11;25;SEC_205
1995;112;00-02;24;14;38;SEC_112
1995;235;35-49;103;93;196;SEC_235
1995;120;50-64;100;110;210;SEC_120
1995;110;75 i +;41;20;61;SEC_110
1995;104;18-24;48;51;99;SEC_104
1995;104;50-64;91;80;171;SEC_104
1995;523;65-74;78;80;158;SEC_523
1995;616;16-17;51;56;107;SEC_616
1995;206;50-64;107;94;201;SEC_206
1995;305;65-74;85;55;140;SEC_305
1995;618;50-64;68;80;148;SEC_618
1995;104;12-15;13;13;26;SEC_104
1995;306;00-02;16;13;29;SEC_306
1995;532;65-74;84;74;158;SEC_532
1995;522;03-11;32;23;55;SEC_522
1995;204;03-11;13;20;33;SEC_204
1995;431;12-15;36;42;78;SEC_431
1995;244;50-64;63;47;110;SEC_244
1995;418;16-17;17;10;27;SEC_418
1995;406;00-02;15;15;30;SEC_406
1995;116;35-49;193;172;365;SEC_116
1995;213;03-11;33;41;74;SEC_213
1995;632;35-49;107;105;212;SEC_632
1995;601;35-49;164;155;319;SEC_601
1995;236;00-02;9;3;12;SEC_236
1995;420;12-15;18;23;41;SEC_420
1995;244;65-74;47;49;96;SEC_244
1995;604;16-17;14;12;26;SEC_604
1995;407;75 i +;26;18;44;SEC_407
1995;105;00-02;17;11;28;SEC_105
1995;233;12-15;11;8;19;SEC_233
1995;618;03-11;19;26;45;SEC_618
1995;226;00-02;10;6;16;SEC_226
1995;138;18-24;58;58;116;SEC_138
1995;518;16-17;19;12;31;SEC_518
1995;515;16-17;6;10;16;SEC_515
1995;508;00-02;6;10;16;SEC_508
1995;236;35-49;95;84;179;SEC_236
1995;530;25-34;121;127;248;SEC_530
1995;607;65-74;55;47;102;SEC_607
1995;429;35-49;77;80;157;SEC_429
1995;104;35-49;81;67;148;SEC_104
1995;316;00-02;14;18;32;SEC_316
1995;437;03-11;29;34;63;SEC_437
1995;226;50-64;109;90;199;SEC_226
1995;248;03-11;36;35;71;SEC_248
1995;107;12-15;57;54;111;SEC_107
1995;306;50-64;134;112;246;SEC_306
1995;301;18-24;130;128;258;SEC_301
1995;131;25-34;107;125;232;SEC_131
1995;140;03-11;24;23;47;SEC_140
1995;301;16-17;36;26;62;SEC_301
1995;249;16-17;11;17;28;SEC_249
1995;225;16-17;3;10;13;SEC_225
1995;625;18-24;103;105;208;SEC_625
1995;323;50-64;141;155;296;SEC_323
1995;239;00-02;8;13;21;SEC_239
1995;246;18-24;59;51;110;SEC_246
1995;118;65-74;50;31;81;SEC_118
1995;615;16-17;26;20;46;SEC_615
1995;238;65-74;61;48;109;SEC_238
1995;235;75 i +;62;35;97;SEC_235
1995;410;35-49;169;159;328;SEC_410
1995;228;00-02;9;5;14;SEC_228
1995;618;12-15;13;15;28;SEC_618
1995;625;03-11;82;80;162;SEC_625
1995;206;65-74;58;45;103;SEC_206
1995;420;00-02;17;11;28;SEC_420
1995;125;12-15;26;38;64;SEC_125
1995;325;65-74;110;95;205;SEC_325
1995;519;03-11;21;25;46;SEC_519
1995;411;50-64;122;118;240;SEC_411
1995;516;35-49;46;57;103;SEC_516
1995;117;25-34;131;132;263;SEC_117
1995;320;65-74;45;23;68;SEC_320
1995;315;00-02;13;12;25;SEC_315
1995;119;50-64;126;151;277;SEC_119
1995;524;35-49;95;97;192;SEC_524
1995;234;03-11;25;30;55;SEC_234
1995;202;75 i +;31;20;51;SEC_202
1995;404;03-11;52;43;95;SEC_404
1995;204;35-49;48;41;89;SEC_204
1995;608;00-02;14;7;21;SEC_608
1995;631;00-02;9;8;17;SEC_631
1995;512;16-17;9;6;15;SEC_512
1995;217;35-49;48;57;105;SEC_217
1995;435;16-17;13;12;25;SEC_435
1995;130;03-11;30;26;56;SEC_130
1995;531;16-17;9;13;22;SEC_531
1995;307;03-11;61;77;138;SEC_307
1995;203;75 i +;45;22;67;SEC_203
1995;415;16-17;6;10;16;SEC_415
1995;324;50-64;70;73;143;SEC_324
1995;113;65-74;43;34;77;SEC_113
1995;516;16-17;6;10;16;SEC_516
1995;233;50-64;96;79;175;SEC_233
1995;320;25-34;56;68;124;SEC_320
1995;422;03-11;29;45;74;SEC_422
1995;227;16-17;8;9;17;SEC_227
1995;518;12-15;18;26;44;SEC_518
1995;128;00-02;13;8;21;SEC_128
1995;243;35-49;115;113;228;SEC_243
1995;510;03-11;40;39;79;SEC_510
1995;405;75 i +;25;20;45;SEC_405
1995;122;35-49;56;40;96;SEC_122
1995;247;03-11;36;49;85;SEC_247
1995;209;50-64;105;101;206;SEC_209
1995;211;12-15;17;17;34;SEC_211
1995;234;18-24;38;45;83;SEC_234
1995;410;16-17;30;26;56;SEC_410
1995;619;65-74;56;53;109;SEC_619
1995;134;35-49;157;156;313;SEC_134
1995;219;65-74;92;59;151;SEC_219
1995;124;03-11;47;38;85;SEC_124
1995;207;03-11;21;20;41;SEC_207
1995;629;12-15;18;16;34;SEC_629
1995;442;03-11;22;20;42;SEC_442
1995;236;25-34;77;94;171;SEC_236
1995;531;12-15;8;16;24;SEC_531
1995;509;00-02;7;13;20;SEC_509
1995;125;18-24;105;106;211;SEC_125
1995;308;18-24;102;94;196;SEC_308
1995;215;00-02;11;10;21;SEC_215
1995;524;12-15;24;26;50;SEC_524
1995;114;00-02;22;16;38;SEC_114
1995;422;16-17;9;15;24;SEC_422
1995;139;25-34;73;73;146;SEC_139
1995;132;35-49;255;244;499;SEC_132
1995;439;12-15;14;19;33;SEC_439
1995;218;65-74;41;29;70;SEC_218
1995;507;25-34;71;80;151;SEC_507
1995;227;18-24;48;43;91;SEC_227
1995;508;75 i +;20;13;33;SEC_508
1995;630;12-15;40;42;82;SEC_630
1995;112;65-74;51;42;93;SEC_112
1995;216;65-74;75;63;138;SEC_216
1995;409;35-49;71;69;140;SEC_409
1995;604;18-24;64;72;136;SEC_604
1995;106;75 i +;22;20;42;SEC_106
1995;630;65-74;22;22;44;SEC_630
1995;433;03-11;45;40;85;SEC_433
1995;126;35-49;130;97;227;SEC_126
1995;523;03-11;39;39;78;SEC_523
1995;312;16-17;10;17;27;SEC_312
1995;601;16-17;28;40;68;SEC_601
1995;510;25-34;85;113;198;SEC_510
1995;509;16-17;12;9;21;SEC_509
1995;524;16-17;14;20;34;SEC_524
1995;419;16-17;8;14;22;SEC_419
1995;302;65-74;48;47;95;SEC_302
1995;538;75 i +;48;24;72;SEC_538
1995;517;25-34;110;125;235;SEC_517
1995;232;75 i +;74;30;104;SEC_232
1995;324;65-74;55;40;95;SEC_324
1995;408;18-24;46;47;93;SEC_408
1995;535;03-11;58;51;109;SEC_535
1995;626;16-17;21;15;36;SEC_626
1995;604;75 i +;20;10;30;SEC_604
1995;616;03-11;72;84;156;SEC_616
1995;115;50-64;100;109;209;SEC_115
1995;102;00-02;16;12;28;SEC_102
1995;427;00-02;8;9;17;SEC_427
1995;612;65-74;50;33;83;SEC_612
1995;417;00-02;5;6;11;SEC_417
1995;137;65-74;41;38;79;SEC_137
1995;308;16-17;28;21;49;SEC_308
1995;506;50-64;172;203;375;SEC_506
1995;440;65-74;58;46;104;SEC_440
1995;431;25-34;126;125;251;SEC_431
1995;509;35-49;65;69;134;SEC_509
1995;216;35-49;134;116;250;SEC_216
1995;134;12-15;27;32;59;SEC_134
1995;115;75 i +;32;21;53;SEC_115
1995;209;00-02;2;7;9;SEC_209
1995;307;18-24;105;101;206;SEC_307
1995;305;12-15;41;36;77;SEC_305
1995;313;16-17;50;32;82;SEC_313
1995;437;25-34;64;96;160;SEC_437
1995;322;35-49;130;122;252;SEC_322
1995;408;75 i +;25;18;43;SEC_408
1995;504;18-24;103;125;228;SEC_504
1995;536;65-74;66;63;129;SEC_536
1995;614;75 i +;42;19;61;SEC_614
1995;537;00-02;17;8;25;SEC_537
1995;240;50-64;80;85;165;SEC_240
1995;105;75 i +;42;22;64;SEC_105
1995;303;65-74;84;84;168;SEC_303
1995;317;00-02;5;8;13;SEC_317
1995;301;12-15;31;50;81;SEC_301
1995;413;35-49;48;45;93;SEC_413
1995;208;18-24;91;104;195;SEC_208
1995;627;25-34;62;81;143;SEC_627
1995;519;18-24;42;40;82;SEC_519
1995;102;03-11;58;57;115;SEC_102
1995;401;16-17;13;23;36;SEC_401
1995;248;65-74;79;56;135;SEC_248
1995;414;00-02;4;12;16;SEC_414
1995;613;12-15;23;22;45;SEC_613
1995;628;65-74;37;31;68;SEC_628
1995;536;75 i +;30;31;61;SEC_536
1995;509;25-34;64;72;136;SEC_509
1995;525;75 i +;31;18;49;SEC_525
1995;136;25-34;87;102;189;SEC_136
1995;115;18-24;68;130;198;SEC_115
1995;219;35-49;102;93;195;SEC_219
1995;426;03-11;32;35;67;SEC_426
1995;310;65-74;36;33;69;SEC_310
1995;111;00-02;7;7;14;SEC_111
1995;618;16-17;15;8;23;SEC_618
1995;419;75 i +;36;21;57;SEC_419
1995;420;03-11;41;44;85;SEC_420
1995;506;75 i +;49;26;75;SEC_506
1995;314;18-24;119;137;256;SEC_314
1995;108;16-17;20;20;40;SEC_108
1995;324;35-49;90;77;167;SEC_324
1995;526;65-74;43;31;74;SEC_526
1995;126;12-15;27;25;52;SEC_126
1995;410;65-74;93;104;197;SEC_410
1995;529;25-34;104;107;211;SEC_529
1995;432;00-02;9;12;21;SEC_432
1995;136;65-74;56;53;109;SEC_136
1995;611;18-24;148;144;292;SEC_611
1995;105;03-11;48;66;114;SEC_105
1995;401;25-34;71;99;170;SEC_401
1995;121;65-74;85;72;157;SEC_121
1995;514;75 i +;36;17;53;SEC_514
1995;517;75 i +;50;30;80;SEC_517
1995;508;12-15;14;9;23;SEC_508
1995;439;65-74;61;44;105;SEC_439
1995;629;65-74;29;27;56;SEC_629
1995;502;75 i +;47;21;68;SEC_502
1995;508;18-24;47;29;76;SEC_508
1995;516;18-24;45;39;84;SEC_516
1995;239;35-49;88;80;168;SEC_239
1995;524;00-02;13;17;30;SEC_524
1995;229;65-74;59;45;104;SEC_229
1995;424;00-02;5;3;8;SEC_424
1995;205;50-64;88;93;181;SEC_205
1995;508;65-74;40;34;74;SEC_508
1995;404;16-17;16;13;29;SEC_404
1995;325;35-49;189;175;364;SEC_325
1995;402;65-74;48;40;88;SEC_402
1995;124;65-74;34;31;65;SEC_124
1995;315;03-11;65;78;143;SEC_315
1995;430;65-74;57;47;104;SEC_430
1995;407;50-64;126;120;246;SEC_407
1995;107;25-34;134;156;290;SEC_107
1995;237;35-49;113;112;225;SEC_237
1995;301;65-74;82;65;147;SEC_301
1995;505;12-15;39;33;72;SEC_505
1995;323;16-17;69;69;138;SEC_323
1995;218;00-02;7;2;9;SEC_218
1995;102;50-64;192;194;386;SEC_102
1995;523;50-64;173;156;329;SEC_523
1995;229;00-02;2;7;9;SEC_229
1995;602;50-64;97;92;189;SEC_602
1995;428;16-17;3;5;8;SEC_428
1995;521;18-24;132;129;261;SEC_521
1995;319;18-24;37;44;81;SEC_319
1995;203;50-64;79;70;149;SEC_203
1995;631;03-11;48;34;82;SEC_631
1995;316;65-74;33;29;62;SEC_316
1995;509;12-15;19;14;33;SEC_509
1995;431;16-17;17;14;31;SEC_431
1995;249;25-34;89;92;181;SEC_249
1995;325;00-02;18;16;34;SEC_325
1995;101;50-64;72;80;152;SEC_101
1995;237;65-74;83;61;144;SEC_237
1995;406;16-17;22;29;51;SEC_406
1995;124;75 i +;34;11;45;SEC_124
1995;311;25-34;127;131;258;SEC_311
1995;523;35-49;102;109;211;SEC_523
1995;120;16-17;19;30;49;SEC_120
1995;309;35-49;85;72;157;SEC_309
1995;210;50-64;106;91;197;SEC_210
1995;534;03-11;27;31;58;SEC_534
1995;316;50-64;103;130;233;SEC_316
1995;105;50-64;77;81;158;SEC_105
1995;317;16-17;9;13;22;SEC_317
1995;237;50-64;145;132;277;SEC_237
1995;122;18-24;58;67;125;SEC_122
1995;605;35-49;61;37;98;SEC_605
1995;502;35-49;154;156;310;SEC_502
1995;131;00-02;20;18;38;SEC_131
1995;302;50-64;124;133;257;SEC_302
1995;426;75 i +;54;26;80;SEC_426
1995;208;35-49;183;158;341;SEC_208
1995;130;18-24;46;58;104;SEC_130
1995;419;65-74;47;36;83;SEC_419
1995;123;12-15;33;31;64;SEC_123
1995;602;18-24;46;61;107;SEC_602
1995;131;50-64;119;134;253;SEC_131
1995;238;35-49;72;82;154;SEC_238
1995;502;50-64;148;160;308;SEC_502
1995;421;75 i +;46;36;82;SEC_421
1995;419;00-02;12;11;23;SEC_419
1995;526;16-17;2;13;15;SEC_526
1995;210;03-11;21;26;47;SEC_210
1995;405;25-34;76;102;178;SEC_405
1995;224;16-17;7;7;14;SEC_224
1995;325;16-17;27;22;49;SEC_325
1995;122;65-74;44;31;75;SEC_122
1995;226;03-11;29;29;58;SEC_226
1995;417;65-74;45;35;80;SEC_417
1995;532;35-49;132;107;239;SEC_532
1995;408;35-49;86;87;173;SEC_408
1995;428;75 i +;29;17;46;SEC_428
1995;434;35-49;54;63;117;SEC_434
1995;406;65-74;54;57;111;SEC_406
1995;138;03-11;32;56;88;SEC_138
1995;617;18-24;89;126;215;SEC_617
1995;322;03-11;42;46;88;SEC_322
1995;306;12-15;43;35;78;SEC_306
1995;536;50-64;114;105;219;SEC_536
1995;629;00-02;2;8;10;SEC_629
1995;108;03-11;55;44;99;SEC_108
1995;220;16-17;11;8;19;SEC_220
1995;501;65-74;19;18;37;SEC_501
1995;137;18-24;87;98;185;SEC_137
1995;631;25-34;92;93;185;SEC_631
1995;515;12-15;11;7;18;SEC_515
1995;407;12-15;19;23;42;SEC_407
1995;119;18-24;122;120;242;SEC_119
1995;125;75 i +;22;15;37;SEC_125
1995;629;35-49;60;58;118;SEC_629
1995;109;25-34;98;99;197;SEC_109
1995;229;50-64;75;67;142;SEC_229
1995;228;25-34;60;65;125;SEC_228
1995;434;75 i +;57;30;87;SEC_434
1995;603;50-64;74;79;153;SEC_603
1995;248;75 i +;66;42;108;SEC_248
1995;318;18-24;36;56;92;SEC_318
1995;322;75 i +;38;16;54;SEC_322
1995;107;65-74;77;55;132;SEC_107
1995;111;18-24;68;93;161;SEC_111
1995;502;12-15;46;30;76;SEC_502
1995;304;35-49;88;90;178;SEC_304
1995;305;03-11;78;65;143;SEC_305
1995;242;75 i +;59;35;94;SEC_242
1995;527;65-74;66;45;111;SEC_527
1995;436;12-15;12;18;30;SEC_436
1995;303;50-64;228;228;456;SEC_303
1995;320;00-02;6;9;15;SEC_320
1995;427;75 i +;52;34;86;SEC_427
1995;235;50-64;155;152;307;SEC_235
1995;526;75 i +;27;11;38;SEC_526
1995;112;35-49;198;201;399;SEC_112
1995;324;03-11;45;35;80;SEC_324
1995;532;75 i +;51;33;84;SEC_532
1995;528;35-49;101;79;180;SEC_528
1995;416;35-49;48;44;92;SEC_416
1995;632;16-17;29;26;55;SEC_632
1995;206;03-11;26;21;47;SEC_206
1995;123;00-02;8;22;30;SEC_123
1995;111;16-17;12;23;35;SEC_111
1995;112;75 i +;61;16;77;SEC_112
1995;620;18-24;77;58;135;SEC_620
1995;417;18-24;42;48;90;SEC_417
1995;236;75 i +;41;35;76;SEC_236
1995;321;25-34;142;150;292;SEC_321
1995;115;12-15;40;40;80;SEC_115
1995;213;16-17;23;17;40;SEC_213
1995;411;18-24;69;83;152;SEC_411
1995;218;12-15;17;17;34;SEC_218
1995;519;75 i +;18;11;29;SEC_519
1995;604;35-49;67;67;134;SEC_604
1995;505;35-49;158;109;267;SEC_505
1995;311;12-15;33;33;66;SEC_311
1995;435;35-49;81;92;173;SEC_435
1995;107;75 i +;44;26;70;SEC_107
1995;304;00-02;8;11;19;SEC_304
1995;521;03-11;35;39;74;SEC_521
1995;315;35-49;173;181;354;SEC_315
1995;243;65-74;99;87;186;SEC_243
1995;503;03-11;57;45;102;SEC_503
1995;122;12-15;14;12;26;SEC_122
1995;215;35-49;76;71;147;SEC_215
1995;110;00-02;10;14;24;SEC_110
1995;216;00-02;9;8;17;SEC_216
1995;122;50-64;136;135;271;SEC_122
1995;509;50-64;91;99;190;SEC_509
1995;234;75 i +;67;33;100;SEC_234
1995;401;03-11;56;47;103;SEC_401
1995;220;03-11;23;32;55;SEC_220
1995;218;75 i +;40;18;58;SEC_218
1995;106;50-64;116;125;241;SEC_106
1995;203;25-34;55;57;112;SEC_203
1995;219;12-15;12;30;42;SEC_219
1995;616;75 i +;21;15;36;SEC_616
1995;418;35-49;104;107;211;SEC_418
1995;627;18-24;93;100;193;SEC_627
1995;521;75 i +;30;13;43;SEC_521
1995;322;50-64;109;102;211;SEC_322
1995;104;65-74;69;49;118;SEC_104
1995;606;00-02;12;8;20;SEC_606
1995;213;35-49;99;99;198;SEC_213
1995;216;16-17;20;19;39;SEC_216
1995;205;25-34;69;62;131;SEC_205
1995;513;18-24;45;47;92;SEC_513
1995;424;50-64;71;71;142;SEC_424
1995;214;25-34;68;65;133;SEC_214
1995;413;00-02;10;9;19;SEC_413
1995;240;16-17;12;9;21;SEC_240
1995;434;65-74;68;47;115;SEC_434
1995;534;12-15;16;21;37;SEC_534
1995;409;12-15;24;20;44;SEC_409
1995;433;75 i +;36;21;57;SEC_433
1995;126;75 i +;36;15;51;SEC_126
1995;622;35-49;118;119;237;SEC_622
1995;402;16-17;11;13;24;SEC_402
1995;207;25-34;53;51;104;SEC_207
1995;620;03-11;28;25;53;SEC_620
1995;306;75 i +;57;32;89;SEC_306
1995;131;18-24;123;133;256;SEC_131
1995;505;65-74;45;40;85;SEC_505
1995;615;18-24;103;124;227;SEC_615
1995;208;75 i +;95;58;153;SEC_208
1995;606;75 i +;30;12;42;SEC_606
1995;504;03-11;33;43;76;SEC_504
1995;108;25-34;101;95;196;SEC_108
1995;216;50-64;150;123;273;SEC_216
1995;101;75 i +;16;6;22;SEC_101
1995;409;18-24;45;55;100;SEC_409
1995;404;50-64;160;142;302;SEC_404
1995;531;03-11;33;32;65;SEC_531
1995;630;18-24;80;76;156;SEC_630
1995;616;25-34;105;117;222;SEC_616
1995;248;35-49;97;85;182;SEC_248
1995;627;75 i +;17;13;30;SEC_627
1995;236;12-15;20;18;38;SEC_236
1995;226;65-74;89;71;160;SEC_226
1995;318;16-17;18;13;31;SEC_318
1995;522;18-24;47;50;97;SEC_522
1995;433;25-34;101;105;206;SEC_433
1995;433;50-64;94;99;193;SEC_433
1995;126;25-34;78;102;180;SEC_126
1995;229;75 i +;42;19;61;SEC_229
1995;244;16-17;7;6;13;SEC_244
1995;525;18-24;50;62;112;SEC_525
1995;538;00-02;2;9;11;SEC_538
1995;304;12-15;15;12;27;SEC_304
1995;309;65-74;29;23;52;SEC_309
1995;609;12-15;27;22;49;SEC_609
1995;527;12-15;15;19;34;SEC_527
