AnyPadro;Seccio;GrupEdat;Dones;Homes;Total;IdSeccio
2012;401;75 i +;93;44;137;SEC_401
2012;242;75 i +;94;64;158;SEC_242
2012;529;03-11;63;52;115;SEC_529
2012;233;75 i +;56;38;94;SEC_233
2012;623;12-15;19;27;46;SEC_623
2012;435;65-74;35;25;60;SEC_435
2012;102;75 i +;103;69;172;SEC_102
2012;317;75 i +;58;19;77;SEC_317
2012;425;65-74;44;43;87;SEC_425
2012;509;12-15;20;20;40;SEC_509
2012;131;50-64;165;143;308;SEC_131
2012;209;12-15;16;13;29;SEC_209
2012;526;16-17;3;5;8;SEC_526
2012;614;50-64;98;74;172;SEC_614
2012;505;35-49;133;137;270;SEC_505
2012;137;18-24;51;52;103;SEC_137
2012;508;12-15;7;8;15;SEC_508
2012;619;35-49;125;133;258;SEC_619
2012;227;03-11;29;19;48;SEC_227
2012;239;12-15;23;28;51;SEC_239
2012;437;00-02;17;15;32;SEC_437
2012;512;25-34;80;66;146;SEC_512
2012;532;65-74;82;64;146;SEC_532
2012;114;25-34;95;98;193;SEC_114
2012;246;16-17;19;13;32;SEC_246
2012;519;16-17;5;3;8;SEC_519
2012;628;16-17;15;6;21;SEC_628
2012;507;00-02;12;12;24;SEC_507
2012;533;00-02;17;23;40;SEC_533
2012;301;75 i +;136;95;231;SEC_301
2012;612;03-11;33;41;74;SEC_612
2012;119;00-02;13;13;26;SEC_119
2012;430;65-74;43;31;74;SEC_430
2012;621;25-34;92;109;201;SEC_621
2012;405;75 i +;86;63;149;SEC_405
2012;501;00-02;5;10;15;SEC_501
2012;419;25-34;68;76;144;SEC_419
2012;136;00-02;23;23;46;SEC_136
2012;605;50-64;50;37;87;SEC_605
2012;524;16-17;8;7;15;SEC_524
2012;624;12-15;12;14;26;SEC_624
2012;632;65-74;60;48;108;SEC_632
2012;505;25-34;68;61;129;SEC_505
2012;508;65-74;27;21;48;SEC_508
2012;111;00-02;10;5;15;SEC_111
2012;616;50-64;292;273;565;SEC_616
2012;531;12-15;12;21;33;SEC_531
2012;223;03-11;46;57;103;SEC_223
2012;216;03-11;47;44;91;SEC_216
2012;528;16-17;12;11;23;SEC_528
2012;247;75 i +;83;43;126;SEC_247
2012;614;00-02;8;17;25;SEC_614
2012;609;65-74;74;76;150;SEC_609
2012;205;00-02;13;9;22;SEC_205
2012;232;18-24;40;35;75;SEC_232
2012;514;50-64;52;56;108;SEC_514
2012;614;65-74;80;72;152;SEC_614
2012;411;65-74;72;59;131;SEC_411
2012;223;50-64;90;90;180;SEC_223
2012;324;35-49;155;168;323;SEC_324
2012;508;18-24;26;20;46;SEC_508
2012;410;50-64;152;128;280;SEC_410
2012;123;50-64;128;119;247;SEC_123
2012;437;18-24;32;44;76;SEC_437
2012;308;35-49;266;238;504;SEC_308
2012;537;12-15;13;23;36;SEC_537
2012;223;75 i +;63;46;109;SEC_223
2012;125;12-15;27;30;57;SEC_125
2012;506;35-49;166;183;349;SEC_506
2012;619;50-64;144;129;273;SEC_619
2012;503;25-34;47;58;105;SEC_503
2012;506;03-11;58;79;137;SEC_506
2012;313;35-49;235;216;451;SEC_313
2012;309;03-11;51;66;117;SEC_309
2012;521;03-11;31;39;70;SEC_521
2012;124;00-02;9;8;17;SEC_124
2012;401;25-34;70;89;159;SEC_401
2012;213;65-74;44;39;83;SEC_213
2012;515;03-11;26;26;52;SEC_515
2012;538;00-02;17;16;33;SEC_538
2012;129;18-24;40;45;85;SEC_129
2012;107;75 i +;104;51;155;SEC_107
2012;403;50-64;108;95;203;SEC_403
2012;101;25-34;104;80;184;SEC_101
2012;418;35-49;162;173;335;SEC_418
2012;134;03-11;53;63;116;SEC_134
2012;631;00-02;20;15;35;SEC_631
2012;227;18-24;13;18;31;SEC_227
2012;423;65-74;47;47;94;SEC_423
2012;514;25-34;60;57;117;SEC_514
2012;434;03-11;31;38;69;SEC_434
2012;120;00-02;23;20;43;SEC_120
2012;207;00-02;10;9;19;SEC_207
2012;228;75 i +;45;33;78;SEC_228
2012;416;00-02;9;18;27;SEC_416
2012;617;12-15;15;17;32;SEC_617
2012;117;25-34;145;148;293;SEC_117
2012;224;35-49;82;86;168;SEC_224
2012;221;35-49;122;137;259;SEC_221
2012;536;18-24;25;30;55;SEC_536
2012;513;50-64;64;53;117;SEC_513
2012;421;35-49;160;162;322;SEC_421
2012;537;18-24;59;53;112;SEC_537
2012;535;65-74;90;87;177;SEC_535
2012;130;35-49;133;139;272;SEC_130
2012;535;75 i +;49;47;96;SEC_535
2012;608;18-24;26;25;51;SEC_608
2012;437;16-17;6;5;11;SEC_437
2012;405;03-11;28;35;63;SEC_405
2012;302;12-15;8;18;26;SEC_302
2012;431;16-17;15;21;36;SEC_431
2012;317;12-15;30;22;52;SEC_317
2012;217;12-15;13;13;26;SEC_217
2012;325;25-34;104;127;231;SEC_325
2012;237;25-34;130;112;242;SEC_237
2012;420;25-34;117;120;237;SEC_420
2012;508;35-49;85;93;178;SEC_508
2012;102;25-34;83;79;162;SEC_102
2012;624;25-34;61;75;136;SEC_624
2012;416;50-64;61;61;122;SEC_416
2012;607;03-11;41;30;71;SEC_607
2012;227;16-17;8;7;15;SEC_227
2012;231;65-74;47;36;83;SEC_231
2012;137;25-34;111;100;211;SEC_137
2012;504;25-34;67;66;133;SEC_504
2012;424;65-74;34;23;57;SEC_424
2012;308;12-15;46;54;100;SEC_308
2012;437;65-74;47;27;74;SEC_437
2012;415;25-34;88;99;187;SEC_415
2012;129;12-15;17;27;44;SEC_129
2012;628;35-49;108;101;209;SEC_628
2012;502;16-17;10;10;20;SEC_502
2012;102;00-02;21;16;37;SEC_102
2012;430;03-11;51;59;110;SEC_430
2012;513;65-74;38;32;70;SEC_513
2012;224;65-74;15;13;28;SEC_224
2012;139;75 i +;36;27;63;SEC_139
2012;109;03-11;46;33;79;SEC_109
2012;629;35-49;53;80;133;SEC_629
2012;324;12-15;18;26;44;SEC_324
2012;208;65-74;110;80;190;SEC_208
2012;441;00-02;25;22;47;SEC_441
2012;321;65-74;111;122;233;SEC_321
2012;118;12-15;32;23;55;SEC_118
2012;604;50-64;63;57;120;SEC_604
2012;526;00-02;7;17;24;SEC_526
2012;219;16-17;13;13;26;SEC_219
2012;108;03-11;59;51;110;SEC_108
2012;313;75 i +;95;62;157;SEC_313
2012;501;75 i +;34;27;61;SEC_501
2012;514;16-17;8;7;15;SEC_514
2012;428;18-24;33;27;60;SEC_428
2012;320;65-74;64;65;129;SEC_320
2012;123;03-11;55;56;111;SEC_123
2012;127;16-17;5;5;10;SEC_127
2012;423;18-24;38;42;80;SEC_423
2012;243;12-15;21;29;50;SEC_243
2012;305;65-74;63;63;126;SEC_305
2012;531;25-34;91;84;175;SEC_531
2012;613;50-64;81;61;142;SEC_613
2012;428;75 i +;33;24;57;SEC_428
2012;516;00-02;11;15;26;SEC_516
2012;210;35-49;103;97;200;SEC_210
2012;102;12-15;28;27;55;SEC_102
2012;629;50-64;53;46;99;SEC_629
2012;603;35-49;83;79;162;SEC_603
2012;509;16-17;7;10;17;SEC_509
2012;214;35-49;133;154;287;SEC_214
2012;416;18-24;32;34;66;SEC_416
2012;139;12-15;14;20;34;SEC_139
2012;510;00-02;15;17;32;SEC_510
2012;217;18-24;35;19;54;SEC_217
2012;514;03-11;33;38;71;SEC_514
2012;230;25-34;95;90;185;SEC_230
2012;619;75 i +;92;69;161;SEC_619
2012;619;16-17;5;10;15;SEC_619
2012;611;16-17;8;18;26;SEC_611
2012;249;25-34;99;92;191;SEC_249
2012;237;16-17;18;9;27;SEC_237
2012;122;12-15;18;20;38;SEC_122
2012;221;03-11;31;38;69;SEC_221
2012;518;12-15;16;19;35;SEC_518
2012;218;65-74;39;41;80;SEC_218
2012;432;03-11;45;42;87;SEC_432
2012;426;75 i +;52;32;84;SEC_426
2012;401;12-15;21;32;53;SEC_401
2012;421;50-64;79;81;160;SEC_421
2012;519;12-15;13;19;32;SEC_519
2012;216;18-24;50;49;99;SEC_216
2012;511;75 i +;53;32;85;SEC_511
2012;308;65-74;98;90;188;SEC_308
2012;410;65-74;103;94;197;SEC_410
2012;240;00-02;10;14;24;SEC_240
2012;604;18-24;27;34;61;SEC_604
2012;106;03-11;67;52;119;SEC_106
2012;439;16-17;15;10;25;SEC_439
2012;101;50-64;147;144;291;SEC_101
2012;140;75 i +;61;42;103;SEC_140
2012;220;03-11;50;43;93;SEC_220
2012;209;50-64;96;86;182;SEC_209
2012;442;75 i +;31;20;51;SEC_442
2012;534;03-11;25;39;64;SEC_534
2012;603;25-34;44;42;86;SEC_603
2012;519;25-34;52;45;97;SEC_519
2012;109;75 i +;72;44;116;SEC_109
2012;619;25-34;61;87;148;SEC_619
2012;104;65-74;46;33;79;SEC_104
2012;429;35-49;54;64;118;SEC_429
2012;211;00-02;14;25;39;SEC_211
2012;611;12-15;23;30;53;SEC_611
2012;532;18-24;53;39;92;SEC_532
2012;406;00-02;18;10;28;SEC_406
2012;533;35-49;127;137;264;SEC_533
2012;128;50-64;88;70;158;SEC_128
2012;124;12-15;11;12;23;SEC_124
2012;603;16-17;8;8;16;SEC_603
2012;247;65-74;53;44;97;SEC_247
2012;240;50-64;58;51;109;SEC_240
2012;401;50-64;117;94;211;SEC_401
2012;105;18-24;45;57;102;SEC_105
2012;230;35-49;131;133;264;SEC_230
2012;618;35-49;73;71;144;SEC_618
2012;113;35-49;181;184;365;SEC_113
2012;524;65-74;54;38;92;SEC_524
2012;313;25-34;124;123;247;SEC_313
2012;523;03-11;50;49;99;SEC_523
2012;241;65-74;31;24;55;SEC_241
2012;421;03-11;53;49;102;SEC_421
2012;207;18-24;26;25;51;SEC_207
2012;224;12-15;11;8;19;SEC_224
2012;217;00-02;9;15;24;SEC_217
2012;205;03-11;31;37;68;SEC_205
2012;435;12-15;19;24;43;SEC_435
2012;422;18-24;43;49;92;SEC_422
2012;222;03-11;38;41;79;SEC_222
2012;114;18-24;39;28;67;SEC_114
2012;203;35-49;105;131;236;SEC_203
2012;201;75 i +;64;41;105;SEC_201
2012;324;03-11;62;46;108;SEC_324
2012;315;16-17;11;14;25;SEC_315
2012;533;12-15;15;7;22;SEC_533
2012;230;65-74;30;16;46;SEC_230
2012;111;18-24;31;26;57;SEC_111
2012;303;16-17;9;12;21;SEC_303
2012;433;65-74;33;29;62;SEC_433
2012;107;12-15;27;21;48;SEC_107
2012;233;12-15;11;26;37;SEC_233
2012;615;16-17;8;8;16;SEC_615
2012;313;18-24;64;52;116;SEC_313
2012;607;12-15;18;20;38;SEC_607
2012;311;18-24;47;48;95;SEC_311
2012;411;16-17;5;7;12;SEC_411
2012;530;25-34;148;149;297;SEC_530
2012;534;50-64;85;74;159;SEC_534
2012;528;35-49;181;156;337;SEC_528
2012;249;00-02;19;19;38;SEC_249
2012;529;75 i +;95;67;162;SEC_529
2012;501;03-11;37;47;84;SEC_501
2012;507;12-15;12;16;28;SEC_507
2012;325;18-24;53;50;103;SEC_325
2012;320;50-64;83;82;165;SEC_320
2012;229;03-11;33;35;68;SEC_229
2012;234;35-49;130;145;275;SEC_234
2012;603;65-74;59;47;106;SEC_603
2012;117;75 i +;75;47;122;SEC_117
2012;108;35-49;194;166;360;SEC_108
2012;214;50-64;52;48;100;SEC_214
2012;112;50-64;171;164;335;SEC_112
2012;140;25-34;69;87;156;SEC_140
2012;118;00-02;26;28;54;SEC_118
2012;302;50-64;157;118;275;SEC_302
2012;238;18-24;31;36;67;SEC_238
2012;202;03-11;31;33;64;SEC_202
2012;211;16-17;13;16;29;SEC_211
2012;226;35-49;174;167;341;SEC_226
2012;221;50-64;94;83;177;SEC_221
2012;438;16-17;9;6;15;SEC_438
2012;623;50-64;160;116;276;SEC_623
2012;307;16-17;5;3;8;SEC_307
2012;615;25-34;59;34;93;SEC_615
2012;311;16-17;13;16;29;SEC_311
2012;246;12-15;19;28;47;SEC_246
2012;320;75 i +;38;20;58;SEC_320
2012;403;18-24;40;40;80;SEC_403
2012;129;25-34;87;82;169;SEC_129
2012;532;25-34;125;115;240;SEC_532
2012;503;65-74;42;46;88;SEC_503
2012;105;50-64;152;107;259;SEC_105
2012;408;50-64;70;80;150;SEC_408
2012;247;03-11;64;69;133;SEC_247
2012;228;12-15;9;10;19;SEC_228
2012;519;50-64;43;33;76;SEC_519
2012;523;18-24;34;47;81;SEC_523
2012;529;25-34;97;99;196;SEC_529
2012;130;50-64;65;67;132;SEC_130
2012;441;35-49;206;219;425;SEC_441
2012;623;35-49;157;181;338;SEC_623
2012;430;16-17;8;11;19;SEC_430
2012;232;50-64;86;74;160;SEC_232
2012;535;35-49;85;99;184;SEC_535
2012;136;35-49;167;167;334;SEC_136
2012;212;25-34;122;132;254;SEC_212
2012;137;50-64;151;134;285;SEC_137
2012;246;75 i +;76;45;121;SEC_246
2012;621;50-64;173;131;304;SEC_621
2012;249;35-49;141;149;290;SEC_249
2012;240;12-15;10;10;20;SEC_240
2012;631;35-49;117;137;254;SEC_631
2012;305;35-49;183;177;360;SEC_305
2012;520;50-64;82;58;140;SEC_520
2012;620;16-17;3;5;8;SEC_620
2012;425;16-17;9;7;16;SEC_425
2012;626;12-15;20;17;37;SEC_626
2012;246;18-24;50;37;87;SEC_246
2012;606;03-11;51;46;97;SEC_606
2012;512;12-15;10;18;28;SEC_512
2012;513;35-49;103;83;186;SEC_513
2012;112;03-11;74;59;133;SEC_112
2012;520;12-15;14;16;30;SEC_520
2012;601;35-49;140;176;316;SEC_601
2012;116;35-49;163;170;333;SEC_116
2012;427;65-74;34;23;57;SEC_427
2012;501;25-34;60;54;114;SEC_501
2012;513;03-11;39;33;72;SEC_513
2012;516;03-11;32;34;66;SEC_516
2012;310;03-11;37;42;79;SEC_310
2012;302;25-34;109;116;225;SEC_302
2012;126;00-02;10;12;22;SEC_126
2012;210;65-74;57;47;104;SEC_210
2012;205;12-15;21;19;40;SEC_205
2012;312;35-49;224;257;481;SEC_312
2012;229;35-49;114;119;233;SEC_229
2012;510;25-34;65;80;145;SEC_510
2012;624;00-02;12;10;22;SEC_624
2012;534;16-17;4;6;10;SEC_534
2012;104;25-34;57;53;110;SEC_104
2012;608;25-34;41;52;93;SEC_608
2012;442;00-02;9;8;17;SEC_442
2012;517;25-34;99;159;258;SEC_517
2012;433;16-17;11;8;19;SEC_433
2012;130;18-24;29;34;63;SEC_130
2012;106;16-17;6;8;14;SEC_106
2012;306;16-17;22;19;41;SEC_306
2012;217;50-64;48;62;110;SEC_217
2012;110;25-34;81;79;160;SEC_110
2012;227;35-49;92;91;183;SEC_227
2012;625;75 i +;55;36;91;SEC_625
2012;439;65-74;57;31;88;SEC_439
2012;436;18-24;41;37;78;SEC_436
2012;320;00-02;21;12;33;SEC_320
2012;416;12-15;8;18;26;SEC_416
2012;417;50-64;50;40;90;SEC_417
2012;323;12-15;61;58;119;SEC_323
2012;131;00-02;17;15;32;SEC_131
2012;441;12-15;37;40;77;SEC_441
2012;439;00-02;24;16;40;SEC_439
2012;312;12-15;18;31;49;SEC_312
2012;312;00-02;26;26;52;SEC_312
2012;532;16-17;12;17;29;SEC_532
2012;105;25-34;88;87;175;SEC_105
2012;421;12-15;19;19;38;SEC_421
2012;625;03-11;38;54;92;SEC_625
2012;324;25-34;92;98;190;SEC_324
2012;201;35-49;156;162;318;SEC_201
2012;401;65-74;51;52;103;SEC_401
2012;430;25-34;98;109;207;SEC_430
2012;108;18-24;42;44;86;SEC_108
2012;404;18-24;47;66;113;SEC_404
2012;319;03-11;96;118;214;SEC_319
2012;307;25-34;106;92;198;SEC_307
2012;234;50-64;76;75;151;SEC_234
2012;212;00-02;27;22;49;SEC_212
2012;513;16-17;5;8;13;SEC_513
2012;624;75 i +;57;31;88;SEC_624
2012;107;00-02;16;23;39;SEC_107
2012;508;25-34;56;70;126;SEC_508
2012;247;18-24;52;58;110;SEC_247
2012;131;18-24;49;46;95;SEC_131
2012;416;25-34;56;56;112;SEC_416
2012;605;00-02;10;14;24;SEC_605
2012;521;65-74;84;97;181;SEC_521
2012;133;00-02;17;12;29;SEC_133
2012;205;25-34;73;63;136;SEC_205
2012;226;16-17;9;9;18;SEC_226
2012;204;12-15;12;4;16;SEC_204
2012;120;12-15;33;45;78;SEC_120
2012;303;50-64;116;106;222;SEC_303
2012;132;00-02;23;32;55;SEC_132
2012;320;25-34;53;73;126;SEC_320
2012;206;65-74;47;34;81;SEC_206
2012;126;65-74;89;90;179;SEC_126
2012;630;16-17;4;6;10;SEC_630
2012;309;75 i +;41;15;56;SEC_309
2012;528;12-15;21;22;43;SEC_528
2012;629;75 i +;30;25;55;SEC_629
2012;103;12-15;17;19;36;SEC_103
2012;434;16-17;9;6;15;SEC_434
2012;221;18-24;47;34;81;SEC_221
2012;434;50-64;59;68;127;SEC_434
2012;208;16-17;11;13;24;SEC_208
2012;322;50-64;112;93;205;SEC_322
2012;519;75 i +;42;30;72;SEC_519
2012;514;65-74;36;27;63;SEC_514
2012;525;16-17;9;13;22;SEC_525
2012;422;75 i +;79;54;133;SEC_422
2012;234;25-34;99;94;193;SEC_234
2012;230;18-24;30;47;77;SEC_230
2012;512;35-49;110;112;222;SEC_512
2012;602;35-49;78;86;164;SEC_602
2012;114;75 i +;95;61;156;SEC_114
2012;128;65-74;58;52;110;SEC_128
2012;202;18-24;26;34;60;SEC_202
2012;215;00-02;18;21;39;SEC_215
2012;510;50-64;82;74;156;SEC_510
2012;236;12-15;18;10;28;SEC_236
2012;538;16-17;10;17;27;SEC_538
2012;511;65-74;31;20;51;SEC_511
2012;224;00-02;9;12;21;SEC_224
2012;234;12-15;13;13;26;SEC_234
2012;320;16-17;7;5;12;SEC_320
2012;513;00-02;18;12;30;SEC_513
2012;624;16-17;7;7;14;SEC_624
2012;607;35-49;114;130;244;SEC_607
2012;219;03-11;49;56;105;SEC_219
2012;626;16-17;5;10;15;SEC_626
2012;104;00-02;10;11;21;SEC_104
2012;307;18-24;30;48;78;SEC_307
2012;535;18-24;38;32;70;SEC_535
2012;104;50-64;72;64;136;SEC_104
2012;114;35-49;175;200;375;SEC_114
2012;401;16-17;12;11;23;SEC_401
2012;101;16-17;14;15;29;SEC_101
2012;415;03-11;34;41;75;SEC_415
2012;236;25-34;70;81;151;SEC_236
2012;122;00-02;16;22;38;SEC_122
2012;435;03-11;56;50;106;SEC_435
2012;402;18-24;32;31;63;SEC_402
2012;310;65-74;37;37;74;SEC_310
2012;404;25-34;116;90;206;SEC_404
2012;501;18-24;34;29;63;SEC_501
2012;301;12-15;40;43;83;SEC_301
2012;427;35-49;124;154;278;SEC_427
2012;248;25-34;97;107;204;SEC_248
2012;325;50-64;194;150;344;SEC_325
2012;307;35-49;126;124;250;SEC_307
2012;134;35-49;177;170;347;SEC_134
2012;527;65-74;44;23;67;SEC_527
2012;114;12-15;31;19;50;SEC_114
2012;616;00-02;51;51;102;SEC_616
2012;211;75 i +;98;41;139;SEC_211
2012;531;75 i +;48;35;83;SEC_531
2012;324;16-17;11;10;21;SEC_324
2012;624;65-74;92;111;203;SEC_624
2012;236;75 i +;101;59;160;SEC_236
2012;240;75 i +;60;37;97;SEC_240
2012;411;75 i +;96;78;174;SEC_411
2012;509;00-02;8;19;27;SEC_509
2012;522;65-74;30;18;48;SEC_522
2012;621;35-49;161;180;341;SEC_621
2012;621;16-17;15;10;25;SEC_621
2012;238;25-34;66;81;147;SEC_238
2012;125;18-24;56;47;103;SEC_125
2012;434;75 i +;54;26;80;SEC_434
2012;414;65-74;45;41;86;SEC_414
2012;510;16-17;10;10;20;SEC_510
2012;535;00-02;8;10;18;SEC_535
2012;416;35-49;91;107;198;SEC_416
2012;130;25-34;63;48;111;SEC_130
2012;610;75 i +;68;56;124;SEC_610
2012;610;16-17;14;18;32;SEC_610
2012;247;12-15;27;25;52;SEC_247
2012;523;12-15;14;23;37;SEC_523
2012;129;35-49;138;153;291;SEC_129
2012;102;65-74;118;125;243;SEC_102
2012;419;50-64;55;59;114;SEC_419
2012;425;50-64;73;70;143;SEC_425
2012;120;35-49;229;207;436;SEC_120
2012;136;16-17;14;8;22;SEC_136
2012;118;18-24;75;62;137;SEC_118
2012;124;65-74;33;27;60;SEC_124
2012;436;35-49;125;158;283;SEC_436
2012;534;25-34;77;85;162;SEC_534
2012;235;12-15;31;36;67;SEC_235
2012;224;25-34;56;58;114;SEC_224
2012;527;00-02;16;18;34;SEC_527
2012;108;50-64;155;125;280;SEC_108
2012;618;00-02;7;3;10;SEC_618
2012;614;75 i +;64;49;113;SEC_614
2012;127;18-24;33;30;63;SEC_127
2012;114;50-64;153;124;277;SEC_114
2012;439;75 i +;57;51;108;SEC_439
2012;606;16-17;7;14;21;SEC_606
2012;203;75 i +;45;31;76;SEC_203
2012;613;03-11;47;57;104;SEC_613
2012;237;12-15;15;26;41;SEC_237
2012;323;50-64;385;343;728;SEC_323
2012;312;25-34;166;170;336;SEC_312
2012;622;35-49;91;105;196;SEC_622
2012;139;35-49;103;123;226;SEC_139
2012;103;03-11;31;32;63;SEC_103
2012;131;25-34;81;105;186;SEC_131
2012;425;00-02;18;21;39;SEC_425
2012;535;12-15;11;13;24;SEC_535
2012;226;50-64;99;81;180;SEC_226
2012;440;65-74;79;78;157;SEC_440
2012;531;03-11;35;31;66;SEC_531
2012;503;50-64;119;92;211;SEC_503
2012;632;03-11;53;54;107;SEC_632
2012;432;12-15;18;24;42;SEC_432
2012;420;75 i +;81;62;143;SEC_420
2012;216;50-64;111;102;213;SEC_216
2012;418;03-11;63;45;108;SEC_418
2012;310;50-64;99;95;194;SEC_310
2012;504;75 i +;87;75;162;SEC_504
2012;322;75 i +;69;48;117;SEC_322
2012;520;35-49;93;102;195;SEC_520
2012;230;16-17;13;12;25;SEC_230
2012;602;16-17;4;4;8;SEC_602
2012;404;35-49;163;177;340;SEC_404
2012;618;50-64;54;40;94;SEC_618
2012;509;75 i +;41;21;62;SEC_509
2012;616;03-11;161;148;309;SEC_616
2012;434;18-24;30;30;60;SEC_434
2012;308;25-34;132;126;258;SEC_308
2012;431;35-49;186;235;421;SEC_431
2012;614;16-17;5;8;13;SEC_614
2012;534;75 i +;65;49;114;SEC_534
2012;528;03-11;56;61;117;SEC_528
2012;422;50-64;77;90;167;SEC_422
2012;434;65-74;22;12;34;SEC_434
2012;528;50-64;97;83;180;SEC_528
2012;240;18-24;33;40;73;SEC_240
2012;512;50-64;61;58;119;SEC_512
2012;120;18-24;81;69;150;SEC_120
2012;610;25-34;58;65;123;SEC_610
2012;433;18-24;49;52;101;SEC_433
2012;102;16-17;8;14;22;SEC_102
2012;525;25-34;85;93;178;SEC_525
2012;304;12-15;73;42;115;SEC_304
2012;140;18-24;34;42;76;SEC_140
2012;619;00-02;15;11;26;SEC_619
2012;437;75 i +;47;30;77;SEC_437
2012;630;12-15;10;19;29;SEC_630
2012;609;03-11;39;29;68;SEC_609
2012;602;12-15;8;9;17;SEC_602
2012;130;75 i +;97;67;164;SEC_130
2012;306;75 i +;98;67;165;SEC_306
2012;125;75 i +;54;48;102;SEC_125
2012;101;18-24;50;45;95;SEC_101
2012;202;12-15;8;12;20;SEC_202
2012;315;65-74;71;64;135;SEC_315
2012;322;65-74;57;48;105;SEC_322
2012;139;50-64;85;89;174;SEC_139
2012;536;12-15;16;15;31;SEC_536
2012;429;00-02;6;8;14;SEC_429
2012;128;03-11;35;49;84;SEC_128
2012;435;16-17;12;16;28;SEC_435
2012;206;03-11;40;36;76;SEC_206
2012;532;35-49;161;162;323;SEC_532
2012;432;00-02;15;12;27;SEC_432
2012;103;65-74;40;28;68;SEC_103
2012;402;25-34;91;48;139;SEC_402
2012;608;50-64;79;60;139;SEC_608
2012;429;12-15;10;12;22;SEC_429
2012;314;16-17;15;29;44;SEC_314
2012;137;16-17;10;11;21;SEC_137
2012;248;75 i +;72;53;125;SEC_248
2012;139;16-17;4;13;17;SEC_139
2012;530;75 i +;99;70;169;SEC_530
2012;132;16-17;9;20;29;SEC_132
2012;123;16-17;6;12;18;SEC_123
2012;128;18-24;31;31;62;SEC_128
2012;214;03-11;30;30;60;SEC_214
2012;314;25-34;191;173;364;SEC_314
2012;322;03-11;66;61;127;SEC_322
2012;203;12-15;12;14;26;SEC_203
2012;215;03-11;39;41;80;SEC_215
2012;621;18-24;41;40;81;SEC_621
2012;303;35-49;183;193;376;SEC_303
2012;516;18-24;26;36;62;SEC_516
2012;512;16-17;8;6;14;SEC_512
2012;413;75 i +;43;27;70;SEC_413
2012;103;18-24;22;12;34;SEC_103
2012;245;75 i +;69;47;116;SEC_245
2012;306;35-49;200;205;405;SEC_306
2012;201;00-02;15;23;38;SEC_201
2012;119;25-34;83;80;163;SEC_119
2012;113;50-64;221;187;408;SEC_113
2012;208;75 i +;230;132;362;SEC_208
2012;111;25-34;43;51;94;SEC_111
2012;212;03-11;48;59;107;SEC_212
2012;244;00-02;11;10;21;SEC_244
2012;506;12-15;28;29;57;SEC_506
2012;502;00-02;28;21;49;SEC_502
2012;219;50-64;98;96;194;SEC_219
2012;536;16-17;11;9;20;SEC_536
2012;429;16-17;6;4;10;SEC_429
2012;311;03-11;68;79;147;SEC_311
2012;305;03-11;65;61;126;SEC_305
2012;307;12-15;16;18;34;SEC_307
2012;424;35-49;62;83;145;SEC_424
2012;248;18-24;56;51;107;SEC_248
2012;132;12-15;36;43;79;SEC_132
2012;629;12-15;7;7;14;SEC_629
2012;616;65-74;104;95;199;SEC_616
2012;322;16-17;13;20;33;SEC_322
2012;207;50-64;78;65;143;SEC_207
2012;423;25-34;87;96;183;SEC_423
2012;605;25-34;49;46;95;SEC_605
2012;219;75 i +;90;48;138;SEC_219
2012;624;03-11;37;47;84;SEC_624
2012;111;12-15;13;11;24;SEC_111
2012;424;50-64;49;41;90;SEC_424
2012;421;18-24;43;51;94;SEC_421
2012;228;25-34;68;71;139;SEC_228
2012;240;35-49;100;96;196;SEC_240
2012;614;12-15;10;13;23;SEC_614
2012;201;03-11;48;60;108;SEC_201
2012;311;65-74;66;53;119;SEC_311
2012;235;03-11;76;86;162;SEC_235
2012;140;12-15;13;18;31;SEC_140
2012;217;35-49;87;109;196;SEC_217
2012;121;00-02;15;13;28;SEC_121
2012;212;65-74;65;48;113;SEC_212
2012;307;65-74;112;91;203;SEC_307
2012;222;16-17;12;6;18;SEC_222
2012;625;16-17;7;3;10;SEC_625
2012;124;16-17;4;4;8;SEC_124
2012;311;50-64;112;96;208;SEC_311
2012;504;18-24;26;30;56;SEC_504
2012;307;75 i +;77;64;141;SEC_307
2012;315;00-02;25;32;57;SEC_315
2012;606;25-34;89;94;183;SEC_606
2012;613;25-34;83;81;164;SEC_613
2012;212;18-24;65;56;121;SEC_212
2012;301;03-11;142;142;284;SEC_301
2012;106;65-74;73;98;171;SEC_106
2012;127;03-11;37;41;78;SEC_127
2012;525;03-11;48;45;93;SEC_525
2012;626;03-11;34;40;74;SEC_626
2012;519;65-74;28;17;45;SEC_519
2012;134;65-74;59;58;117;SEC_134
2012;531;50-64;84;77;161;SEC_531
2012;526;50-64;40;47;87;SEC_526
2012;314;75 i +;92;55;147;SEC_314
2012;221;25-34;78;82;160;SEC_221
2012;610;12-15;18;26;44;SEC_610
2012;104;18-24;25;21;46;SEC_104
2012;531;18-24;43;36;79;SEC_531
2012;209;00-02;10;13;23;SEC_209
2012;220;25-34;85;88;173;SEC_220
2012;324;18-24;34;41;75;SEC_324
2012;214;16-17;5;6;11;SEC_214
2012;237;00-02;22;19;41;SEC_237
2012;136;03-11;54;49;103;SEC_136
2012;213;03-11;28;49;77;SEC_213
2012;620;12-15;6;16;22;SEC_620
2012;138;16-17;6;6;12;SEC_138
2012;219;25-34;106;113;219;SEC_219
2012;237;18-24;52;56;108;SEC_237
2012;223;12-15;26;21;47;SEC_223
2012;311;75 i +;103;56;159;SEC_311
2012;418;18-24;45;62;107;SEC_418
2012;209;25-34;96;89;185;SEC_209
2012;417;25-34;61;58;119;SEC_417
2012;323;16-17;30;29;59;SEC_323
2012;515;18-24;32;23;55;SEC_515
2012;605;16-17;3;4;7;SEC_605
2012;233;03-11;27;39;66;SEC_233
2012;532;00-02;28;23;51;SEC_532
2012;303;03-11;45;56;101;SEC_303
2012;112;25-34;126;95;221;SEC_112
2012;434;00-02;22;14;36;SEC_434
2012;537;16-17;12;7;19;SEC_537
2012;433;00-02;19;26;45;SEC_433
2012;428;25-34;67;72;139;SEC_428
2012;322;12-15;24;27;51;SEC_322
2012;428;00-02;19;16;35;SEC_428
2012;417;03-11;32;36;68;SEC_417
2012;313;00-02;30;26;56;SEC_313
2012;517;18-24;44;58;102;SEC_517
2012;323;75 i +;88;39;127;SEC_323
2012;632;12-15;20;15;35;SEC_632
2012;426;18-24;39;47;86;SEC_426
2012;136;75 i +;62;33;95;SEC_136
2012;617;16-17;7;10;17;SEC_617
2012;231;00-02;18;25;43;SEC_231
2012;619;03-11;42;45;87;SEC_619
2012;203;00-02;16;14;30;SEC_203
2012;517;35-49;155;207;362;SEC_517
2012;204;75 i +;43;21;64;SEC_204
2012;441;03-11;80;69;149;SEC_441
2012;630;75 i +;43;30;73;SEC_630
2012;630;18-24;31;27;58;SEC_630
2012;249;75 i +;75;43;118;SEC_249
2012;305;18-24;77;67;144;SEC_305
2012;604;65-74;51;31;82;SEC_604
2012;613;35-49;151;163;314;SEC_613
2012;627;35-49;92;107;199;SEC_627
2012;412;18-24;44;68;112;SEC_412
2012;125;16-17;8;13;21;SEC_125
2012;632;16-17;13;14;27;SEC_632
2012;239;50-64;101;82;183;SEC_239
2012;234;00-02;16;18;34;SEC_234
2012;209;03-11;22;41;63;SEC_209
2012;611;25-34;121;111;232;SEC_611
2012;121;18-24;28;30;58;SEC_121
2012;531;65-74;44;35;79;SEC_531
2012;414;16-17;9;7;16;SEC_414
2012;508;50-64;47;40;87;SEC_508
2012;619;18-24;38;38;76;SEC_619
2012;216;00-02;17;16;33;SEC_216
2012;110;00-02;18;8;26;SEC_110
2012;232;25-34;102;86;188;SEC_232
2012;318;16-17;7;6;13;SEC_318
2012;104;35-49;100;127;227;SEC_104
2012;404;50-64;112;109;221;SEC_404
2012;307;00-02;20;15;35;SEC_307
2012;520;00-02;10;7;17;SEC_520
2012;432;65-74;74;66;140;SEC_432
2012;422;25-34;89;100;189;SEC_422
2012;226;00-02;19;22;41;SEC_226
2012;227;50-64;67;52;119;SEC_227
2012;517;00-02;22;24;46;SEC_517
2012;125;35-49;229;231;460;SEC_125
2012;516;75 i +;48;23;71;SEC_516
2012;431;75 i +;85;44;129;SEC_431
2012;221;12-15;13;17;30;SEC_221
2012;614;18-24;24;30;54;SEC_614
2012;136;25-34;91;86;177;SEC_136
2012;324;50-64;74;64;138;SEC_324
2012;219;65-74;55;39;94;SEC_219
2012;249;12-15;17;22;39;SEC_249
2012;402;00-02;9;19;28;SEC_402
2012;409;75 i +;35;21;56;SEC_409
2012;526;75 i +;34;16;50;SEC_526
2012;305;12-15;31;25;56;SEC_305
2012;423;12-15;14;14;28;SEC_423
2012;207;75 i +;61;26;87;SEC_207
2012;126;12-15;21;20;41;SEC_126
2012;137;75 i +;59;36;95;SEC_137
2012;120;03-11;55;98;153;SEC_120
2012;211;25-34;114;134;248;SEC_211
2012;242;50-64;87;86;173;SEC_242
2012;423;16-17;8;5;13;SEC_423
2012;420;18-24;56;52;108;SEC_420
2012;308;03-11;101;97;198;SEC_308
2012;427;50-64;71;62;133;SEC_427
2012;123;00-02;15;18;33;SEC_123
2012;229;75 i +;51;37;88;SEC_229
2012;523;00-02;20;19;39;SEC_523
2012;110;18-24;32;39;71;SEC_110
2012;601;12-15;14;15;29;SEC_601
2012;318;03-11;20;37;57;SEC_318
2012;211;50-64;106;96;202;SEC_211
2012;118;35-49;196;193;389;SEC_118
2012;521;12-15;16;11;27;SEC_521
2012;219;12-15;30;23;53;SEC_219
2012;601;16-17;11;11;22;SEC_601
2012;117;00-02;24;29;53;SEC_117
2012;520;65-74;41;36;77;SEC_520
2012;615;12-15;12;17;29;SEC_615
2012;311;00-02;20;16;36;SEC_311
2012;134;50-64;130;117;247;SEC_134
2012;418;75 i +;75;59;134;SEC_418
2012;234;03-11;30;36;66;SEC_234
2012;411;50-64;82;69;151;SEC_411
2012;532;03-11;56;45;101;SEC_532
2012;239;16-17;11;8;19;SEC_239
2012;506;18-24;59;78;137;SEC_506
2012;138;00-02;9;10;19;SEC_138
2012;508;03-11;32;30;62;SEC_508
2012;418;12-15;22;30;52;SEC_418
2012;112;75 i +;75;30;105;SEC_112
2012;304;18-24;76;77;153;SEC_304
2012;309;18-24;39;29;68;SEC_309
2012;431;03-11;84;78;162;SEC_431
2012;401;03-11;44;57;101;SEC_401
2012;435;50-64;83;80;163;SEC_435
2012;530;50-64;102;99;201;SEC_530
2012;605;35-49;73;79;152;SEC_605
2012;407;75 i +;91;51;142;SEC_407
2012;219;35-49;182;168;350;SEC_219
2012;615;03-11;36;22;58;SEC_615
2012;222;75 i +;39;27;66;SEC_222
2012;601;75 i +;64;59;123;SEC_601
2012;622;65-74;41;44;85;SEC_622
2012;615;65-74;99;85;184;SEC_615
2012;214;00-02;16;17;33;SEC_214
2012;302;18-24;46;37;83;SEC_302
2012;602;50-64;39;32;71;SEC_602
2012;625;00-02;11;16;27;SEC_625
2012;246;35-49;155;187;342;SEC_246
2012;432;75 i +;69;50;119;SEC_432
2012;515;35-49;84;85;169;SEC_515
2012;527;16-17;14;9;23;SEC_527
2012;537;25-34;102;104;206;SEC_537
2012;510;12-15;20;21;41;SEC_510
2012;522;00-02;26;17;43;SEC_522
2012;139;18-24;27;29;56;SEC_139
2012;524;12-15;21;23;44;SEC_524
2012;618;12-15;13;16;29;SEC_618
2012;522;50-64;69;64;133;SEC_522
2012;426;12-15;27;19;46;SEC_426
2012;111;50-64;95;69;164;SEC_111
2012;503;00-02;7;11;18;SEC_503
2012;426;00-02;12;22;34;SEC_426
2012;137;65-74;71;67;138;SEC_137
2012;506;50-64;221;176;397;SEC_506
2012;242;03-11;41;48;89;SEC_242
2012;244;35-49;114;108;222;SEC_244
2012;127;50-64;78;68;146;SEC_127
2012;537;03-11;51;34;85;SEC_537
2012;319;12-15;33;36;69;SEC_319
2012;217;16-17;9;10;19;SEC_217
2012;615;00-02;12;8;20;SEC_615
2012;225;18-24;15;18;33;SEC_225
2012;134;16-17;11;13;24;SEC_134
2012;532;12-15;25;18;43;SEC_532
2012;404;65-74;66;48;114;SEC_404
2012;416;75 i +;51;41;92;SEC_416
2012;408;25-34;74;103;177;SEC_408
2012;435;00-02;24;27;51;SEC_435
2012;423;50-64;76;68;144;SEC_423
2012;439;18-24;47;53;100;SEC_439
2012;608;16-17;6;8;14;SEC_608
2012;612;00-02;10;14;24;SEC_612
2012;609;75 i +;39;31;70;SEC_609
2012;610;18-24;28;39;67;SEC_610
2012;536;25-34;75;69;144;SEC_536
2012;537;75 i +;76;59;135;SEC_537
2012;224;03-11;28;28;56;SEC_224
2012;521;75 i +;55;48;103;SEC_521
2012;217;65-74;12;16;28;SEC_217
2012;409;00-02;12;11;23;SEC_409
2012;248;16-17;9;11;20;SEC_248
2012;321;35-49;244;202;446;SEC_321
2012;240;65-74;35;29;64;SEC_240
2012;602;00-02;4;7;11;SEC_602
2012;623;00-02;13;11;24;SEC_623
2012;233;50-64;68;67;135;SEC_233
2012;434;25-34;53;38;91;SEC_434
2012;408;18-24;37;31;68;SEC_408
2012;228;00-02;16;15;31;SEC_228
2012;125;65-74;77;79;156;SEC_125
2012;512;03-11;36;28;64;SEC_512
2012;515;25-34;47;63;110;SEC_515
2012;506;25-34;101;103;204;SEC_506
2012;422;12-15;27;17;44;SEC_422
2012;434;12-15;7;10;17;SEC_434
2012;132;50-64;233;218;451;SEC_132
2012;612;18-24;27;32;59;SEC_612
2012;441;50-64;234;223;457;SEC_441
2012;131;75 i +;69;53;122;SEC_131
2012;433;25-34;126;122;248;SEC_433
2012;325;35-49;200;187;387;SEC_325
2012;226;75 i +;83;41;124;SEC_226
2012;314;18-24;62;124;186;SEC_314
2012;135;18-24;49;41;90;SEC_135
2012;525;50-64;69;63;132;SEC_525
2012;325;65-74;112;114;226;SEC_325
2012;225;75 i +;50;20;70;SEC_225
2012;518;03-11;47;44;91;SEC_518
2012;105;35-49;137;137;274;SEC_105
2012;123;25-34;87;79;166;SEC_123
2012;405;25-34;60;68;128;SEC_405
2012;610;50-64;90;77;167;SEC_610
2012;214;65-74;43;28;71;SEC_214
2012;224;18-24;21;22;43;SEC_224
2012;407;03-11;45;51;96;SEC_407
2012;431;65-74;65;44;109;SEC_431
2012;316;35-49;149;140;289;SEC_316
2012;430;75 i +;53;34;87;SEC_430
2012;216;25-34;121;98;219;SEC_216
2012;102;50-64;152;130;282;SEC_102
2012;521;25-34;56;49;105;SEC_521
2012;321;50-64;306;263;569;SEC_321
2012;420;65-74;65;38;103;SEC_420
2012;442;65-74;35;34;69;SEC_442
2012;506;00-02;13;17;30;SEC_506
2012;611;00-02;29;34;63;SEC_611
2012;113;16-17;10;13;23;SEC_113
2012;429;50-64;67;65;132;SEC_429
2012;122;25-34;61;61;122;SEC_122
2012;225;65-74;33;19;52;SEC_225
2012;505;12-15;12;13;25;SEC_505
2012;510;35-49;131;154;285;SEC_510
2012;503;12-15;11;11;22;SEC_503
2012;424;16-17;3;6;9;SEC_424
2012;209;65-74;49;30;79;SEC_209
2012;304;75 i +;102;58;160;SEC_304
2012;621;75 i +;48;28;76;SEC_621
2012;421;16-17;11;12;23;SEC_421
2012;110;16-17;8;6;14;SEC_110
2012;306;50-64;165;141;306;SEC_306
2012;519;00-02;10;9;19;SEC_519
2012;527;35-49;137;160;297;SEC_527
2012;420;50-64;108;96;204;SEC_420
2012;210;18-24;16;21;37;SEC_210
2012;520;18-24;38;30;68;SEC_520
2012;502;75 i +;127;69;196;SEC_502
2012;240;25-34;65;78;143;SEC_240
2012;113;12-15;21;25;46;SEC_113
2012;222;25-34;95;86;181;SEC_222
2012;242;18-24;33;39;72;SEC_242
2012;623;18-24;27;41;68;SEC_623
2012;403;16-17;2;12;14;SEC_403
2012;302;03-11;38;40;78;SEC_302
2012;533;50-64;59;65;124;SEC_533
2012;202;00-02;15;10;25;SEC_202
2012;310;18-24;29;36;65;SEC_310
2012;438;25-34;57;56;113;SEC_438
2012;315;50-64;167;163;330;SEC_315
2012;128;12-15;12;11;23;SEC_128
2012;321;03-11;74;79;153;SEC_321
2012;117;03-11;70;84;154;SEC_117
2012;114;00-02;15;26;41;SEC_114
2012;525;00-02;17;20;37;SEC_525
2012;128;16-17;6;6;12;SEC_128
2012;625;35-49;118;125;243;SEC_625
2012;302;35-49;142;168;310;SEC_302
2012;506;65-74;127;128;255;SEC_506
2012;434;35-49;86;85;171;SEC_434
2012;631;75 i +;59;33;92;SEC_631
2012;113;18-24;51;65;116;SEC_113
2012;512;75 i +;52;41;93;SEC_512
2012;526;25-34;66;83;149;SEC_526
2012;440;12-15;13;13;26;SEC_440
2012;625;65-74;82;68;150;SEC_625
2012;139;65-74;45;38;83;SEC_139
2012;629;16-17;1;9;10;SEC_629
2012;515;75 i +;40;18;58;SEC_515
2012;410;25-34;114;118;232;SEC_410
2012;204;00-02;9;9;18;SEC_204
2012;133;65-74;46;42;88;SEC_133
2012;105;00-02;15;23;38;SEC_105
2012;509;25-34;71;66;137;SEC_509
2012;425;12-15;12;17;29;SEC_425
2012;514;75 i +;51;34;85;SEC_514
2012;503;16-17;6;12;18;SEC_503
2012;319;35-49;277;270;547;SEC_319
2012;245;50-64;78;80;158;SEC_245
2012;622;18-24;28;29;57;SEC_622
2012;249;65-74;56;38;94;SEC_249
2012;430;35-49;125;165;290;SEC_430
2012;416;16-17;6;7;13;SEC_416
2012;429;25-34;40;46;86;SEC_429
2012;624;35-49;102;147;249;SEC_624
2012;116;65-74;105;91;196;SEC_116
2012;621;65-74;89;108;197;SEC_621
2012;118;25-34;117;125;242;SEC_118
2012;502;18-24;54;51;105;SEC_502
2012;223;35-49;161;163;324;SEC_223
2012;616;18-24;115;142;257;SEC_616
2012;514;00-02;15;10;25;SEC_514
2012;510;75 i +;67;41;108;SEC_510
2012;403;35-49;122;139;261;SEC_403
2012;213;75 i +;54;37;91;SEC_213
2012;212;35-49;178;197;375;SEC_212
2012;118;65-74;75;93;168;SEC_118
2012;413;35-49;67;84;151;SEC_413
2012;107;18-24;43;61;104;SEC_107
2012;113;25-34;144;133;277;SEC_113
2012;223;18-24;55;68;123;SEC_223
2012;107;25-34;115;150;265;SEC_107
2012;629;18-24;21;15;36;SEC_629
2012;425;35-49;127;123;250;SEC_425
2012;305;00-02;16;18;34;SEC_305
2012;206;16-17;8;9;17;SEC_206
2012;538;25-34;79;92;171;SEC_538
2012;322;25-34;102;86;188;SEC_322
2012;440;16-17;9;6;15;SEC_440
2012;112;65-74;70;67;137;SEC_112
2012;527;03-11;59;64;123;SEC_527
2012;515;50-64;36;30;66;SEC_515
2012;117;35-49;216;239;455;SEC_117
2012;534;12-15;16;19;35;SEC_534
2012;222;18-24;36;37;73;SEC_222
2012;220;00-02;13;16;29;SEC_220
2012;421;75 i +;94;67;161;SEC_421
2012;116;16-17;13;14;27;SEC_116
2012;535;03-11;27;39;66;SEC_535
2012;510;03-11;46;29;75;SEC_510
2012;120;75 i +;67;31;98;SEC_120
2012;538;65-74;77;40;117;SEC_538
2012;124;03-11;39;34;73;SEC_124
2012;405;12-15;14;18;32;SEC_405
2012;314;50-64;281;259;540;SEC_314
2012;609;35-49;108;107;215;SEC_609
2012;237;50-64;91;100;191;SEC_237
2012;442;16-17;11;9;20;SEC_442
2012;112;16-17;12;9;21;SEC_112
2012;245;35-49;155;148;303;SEC_245
2012;230;75 i +;54;24;78;SEC_230
2012;304;03-11;127;117;244;SEC_304
2012;436;00-02;18;21;39;SEC_436
2012;318;18-24;34;37;71;SEC_318
2012;306;65-74;63;57;120;SEC_306
2012;306;25-34;128;142;270;SEC_306
2012;601;65-74;111;89;200;SEC_601
2012;412;25-34;133;141;274;SEC_412
2012;244;75 i +;44;27;71;SEC_244
2012;632;25-34;53;65;118;SEC_632
2012;229;25-34;74;88;162;SEC_229
2012;135;65-74;84;75;159;SEC_135
2012;403;65-74;88;67;155;SEC_403
2012;235;50-64;98;89;187;SEC_235
2012;611;35-49;238;270;508;SEC_611
2012;620;65-74;55;48;103;SEC_620
2012;237;65-74;63;48;111;SEC_237
2012;616;12-15;62;83;145;SEC_616
2012;226;65-74;46;37;83;SEC_226
2012;246;03-11;49;57;106;SEC_246
2012;623;65-74;104;101;205;SEC_623
2012;529;16-17;4;10;14;SEC_529
2012;426;16-17;7;7;14;SEC_426
2012;238;50-64;61;70;131;SEC_238
2012;438;50-64;70;63;133;SEC_438
2012;612;25-34;45;57;102;SEC_612
2012;631;50-64;104;64;168;SEC_631
2012;214;12-15;22;12;34;SEC_214
2012;437;03-11;40;33;73;SEC_437
2012;401;00-02;8;24;32;SEC_401
2012;218;50-64;75;68;143;SEC_218
2012;511;25-34;64;54;118;SEC_511
2012;626;35-49;99;100;199;SEC_626
2012;225;50-64;49;34;83;SEC_225
2012;503;35-49;87;63;150;SEC_503
2012;440;00-02;9;9;18;SEC_440
2012;134;18-24;47;49;96;SEC_134
2012;310;12-15;12;13;25;SEC_310
2012;408;75 i +;42;37;79;SEC_408
2012;132;35-49;228;270;498;SEC_132
2012;211;12-15;21;31;52;SEC_211
2012;241;00-02;10;8;18;SEC_241
2012;428;03-11;36;26;62;SEC_428
2012;135;75 i +;71;56;127;SEC_135
2012;107;65-74;98;92;190;SEC_107
2012;607;75 i +;76;66;142;SEC_607
2012;607;00-02;9;15;24;SEC_607
2012;538;12-15;19;23;42;SEC_538
2012;231;16-17;11;14;25;SEC_231
2012;628;18-24;26;27;53;SEC_628
2012;630;25-34;60;73;133;SEC_630
2012;421;00-02;18;22;40;SEC_421
2012;243;35-49;217;209;426;SEC_243
2012;302;65-74;78;100;178;SEC_302
2012;420;16-17;10;19;29;SEC_420
2012;317;16-17;6;12;18;SEC_317
2012;207;65-74;35;23;58;SEC_207
2012;215;75 i +;68;28;96;SEC_215
2012;617;18-24;31;32;63;SEC_617
2012;603;03-11;41;40;81;SEC_603
2012;304;25-34;273;236;509;SEC_304
2012;618;16-17;6;6;12;SEC_618
2012;219;00-02;14;19;33;SEC_219
2012;521;00-02;14;12;26;SEC_521
2012;608;75 i +;58;38;96;SEC_608
2012;509;18-24;37;49;86;SEC_509
2012;207;16-17;5;8;13;SEC_207
2012;440;03-11;37;48;85;SEC_440
2012;409;50-64;55;49;104;SEC_409
2012;115;00-02;20;18;38;SEC_115
2012;233;00-02;19;15;34;SEC_233
2012;503;18-24;25;29;54;SEC_503
2012;206;12-15;24;11;35;SEC_206
2012;621;00-02;21;20;41;SEC_621
2012;406;12-15;26;21;47;SEC_406
2012;119;75 i +;92;54;146;SEC_119
2012;439;03-11;53;70;123;SEC_439
2012;630;35-49;79;83;162;SEC_630
2012;135;25-34;90;110;200;SEC_135
2012;308;75 i +;101;67;168;SEC_308
2012;307;03-11;30;36;66;SEC_307
2012;309;00-02;30;24;54;SEC_309
2012;413;00-02;9;12;21;SEC_413
2012;427;00-02;15;23;38;SEC_427
2012;507;16-17;6;12;18;SEC_507
2012;128;75 i +;58;36;94;SEC_128
2012;525;12-15;14;15;29;SEC_525
2012;248;65-74;42;37;79;SEC_248
2012;412;00-02;13;19;32;SEC_412
2012;201;65-74;51;35;86;SEC_201
2012;105;16-17;8;4;12;SEC_105
2012;317;65-74;31;33;64;SEC_317
2012;102;35-49;180;183;363;SEC_102
2012;440;50-64;81;73;154;SEC_440
2012;305;75 i +;98;57;155;SEC_305
2012;608;03-11;22;31;53;SEC_608
2012;239;25-34;104;114;218;SEC_239
2012;325;00-02;16;24;40;SEC_325
2012;627;25-34;65;73;138;SEC_627
2012;627;50-64;150;125;275;SEC_627
2012;103;75 i +;49;36;85;SEC_103
2012;417;35-49;92;91;183;SEC_417
2012;630;03-11;29;31;60;SEC_630
2012;136;50-64;114;101;215;SEC_136
2012;628;65-74;82;75;157;SEC_628
2012;245;03-11;37;44;81;SEC_245
2012;407;65-74;51;32;83;SEC_407
2012;402;35-49;113;121;234;SEC_402
2012;316;50-64;392;327;719;SEC_316
2012;439;50-64;62;75;137;SEC_439
2012;624;18-24;34;35;69;SEC_624
2012;236;16-17;11;9;20;SEC_236
2012;104;12-15;18;16;34;SEC_104
2012;518;75 i +;73;55;128;SEC_518
2012;433;03-11;46;65;111;SEC_433
2012;110;65-74;88;83;171;SEC_110
2012;110;50-64;153;131;284;SEC_110
2012;507;35-49;98;111;209;SEC_507
2012;632;35-49;105;116;221;SEC_632
2012;302;16-17;9;12;21;SEC_302
2012;618;75 i +;24;18;42;SEC_618
2012;414;03-11;49;41;90;SEC_414
2012;211;35-49;185;195;380;SEC_211
2012;536;03-11;42;38;80;SEC_536
2012;127;00-02;12;11;23;SEC_127
2012;424;75 i +;31;33;64;SEC_424
2012;528;00-02;21;14;35;SEC_528
2012;133;18-24;17;25;42;SEC_133
2012;407;16-17;7;3;10;SEC_407
2012;535;16-17;5;10;15;SEC_535
2012;109;50-64;117;112;229;SEC_109
2012;438;12-15;21;20;41;SEC_438
2012;201;16-17;9;9;18;SEC_201
2012;625;12-15;18;18;36;SEC_625
2012;442;50-64;48;50;98;SEC_442
2012;622;12-15;10;20;30;SEC_622
2012;510;18-24;29;36;65;SEC_510
2012;433;12-15;22;19;41;SEC_433
2012;108;65-74;54;49;103;SEC_108
2012;321;00-02;19;15;34;SEC_321
2012;502;25-34;114;131;245;SEC_502
2012;511;16-17;11;9;20;SEC_511
2012;304;35-49;322;327;649;SEC_304
2012;421;65-74;79;53;132;SEC_421
2012;215;16-17;11;8;19;SEC_215
2012;619;12-15;22;23;45;SEC_619
2012;229;00-02;18;10;28;SEC_229
2012;611;75 i +;93;64;157;SEC_611
2012;630;00-02;7;10;17;SEC_630
2012;109;00-02;16;23;39;SEC_109
2012;530;00-02;25;25;50;SEC_530
2012;404;03-11;67;60;127;SEC_404
2012;420;03-11;60;72;132;SEC_420
2012;319;16-17;6;6;12;SEC_319
2012;438;35-49;105;93;198;SEC_438
2012;244;03-11;28;27;55;SEC_244
2012;109;65-74;55;50;105;SEC_109
2012;117;16-17;19;14;33;SEC_117
2012;517;16-17;10;13;23;SEC_517
2012;308;18-24;64;68;132;SEC_308
2012;232;65-74;56;44;100;SEC_232
2012;132;65-74;105;108;213;SEC_132
2012;315;25-34;146;175;321;SEC_315
2012;417;00-02;12;15;27;SEC_417
2012;107;35-49;196;211;407;SEC_107
2012;505;00-02;18;16;34;SEC_505
2012;137;35-49;187;174;361;SEC_137
2012;203;50-64;72;48;120;SEC_203
2012;423;00-02;9;22;31;SEC_423
2012;530;12-15;20;29;49;SEC_530
2012;126;18-24;26;24;50;SEC_126
2012;229;12-15;19;10;29;SEC_229
2012;505;16-17;4;4;8;SEC_505
2012;238;12-15;11;18;29;SEC_238
2012;512;65-74;55;41;96;SEC_512
2012;138;12-15;19;11;30;SEC_138
2012;227;00-02;8;17;25;SEC_227
2012;226;12-15;19;15;34;SEC_226
2012;425;18-24;37;46;83;SEC_425
2012;538;18-24;42;39;81;SEC_538
2012;420;35-49;178;189;367;SEC_420
2012;527;18-24;41;38;79;SEC_527
2012;440;75 i +;71;49;120;SEC_440
2012;223;65-74;66;48;114;SEC_223
2012;631;16-17;8;5;13;SEC_631
2012;501;65-74;73;85;158;SEC_501
2012;628;12-15;15;20;35;SEC_628
2012;106;25-34;138;155;293;SEC_106
2012;239;03-11;44;48;92;SEC_239
2012;132;18-24;76;77;153;SEC_132
2012;125;25-34;100;130;230;SEC_125
2012;309;12-15;12;21;33;SEC_309
2012;233;25-34;116;107;223;SEC_233
2012;503;03-11;19;21;40;SEC_503
2012;527;50-64;80;82;162;SEC_527
2012;246;65-74;38;37;75;SEC_246
2012;423;03-11;49;44;93;SEC_423
2012;402;75 i +;60;47;107;SEC_402
2012;603;18-24;14;27;41;SEC_603
2012;136;18-24;35;36;71;SEC_136
2012;318;65-74;34;29;63;SEC_318
2012;415;18-24;30;35;65;SEC_415
2012;522;16-17;7;11;18;SEC_522
2012;235;00-02;30;26;56;SEC_235
2012;234;75 i +;77;44;121;SEC_234
2012;617;25-34;50;57;107;SEC_617
2012;205;75 i +;85;56;141;SEC_205
2012;511;12-15;15;13;28;SEC_511
2012;220;65-74;34;18;52;SEC_220
2012;412;03-11;65;58;123;SEC_412
2012;409;12-15;13;10;23;SEC_409
2012;620;18-24;22;24;46;SEC_620
2012;623;03-11;58;78;136;SEC_623
2012;531;00-02;15;11;26;SEC_531
2012;533;16-17;6;6;12;SEC_533
2012;112;12-15;24;29;53;SEC_112
2012;625;18-24;47;55;102;SEC_625
2012;428;50-64;46;40;86;SEC_428
2012;309;50-64;101;70;171;SEC_309
2012;609;18-24;21;20;41;SEC_609
2012;411;25-34;75;62;137;SEC_411
2012;133;50-64;94;69;163;SEC_133
2012;225;35-49;63;63;126;SEC_225
2012;131;03-11;43;63;106;SEC_131
2012;107;50-64;158;132;290;SEC_107
2012;436;75 i +;28;22;50;SEC_436
2012;218;16-17;5;4;9;SEC_218
2012;238;00-02;11;11;22;SEC_238
2012;402;03-11;34;43;77;SEC_402
2012;430;12-15;15;22;37;SEC_430
2012;431;50-64;110;101;211;SEC_431
2012;517;75 i +;63;37;100;SEC_517
2012;116;75 i +;82;61;143;SEC_116
2012;629;03-11;27;14;41;SEC_629
2012;224;50-64;56;57;113;SEC_224
2012;137;03-11;73;63;136;SEC_137
2012;301;50-64;189;185;374;SEC_301
2012;235;16-17;11;14;25;SEC_235
2012;119;03-11;32;36;68;SEC_119
2012;108;75 i +;116;71;187;SEC_108
2012;119;65-74;93;85;178;SEC_119
2012;625;50-64;197;167;364;SEC_625
2012;437;12-15;11;10;21;SEC_437
2012;140;16-17;6;14;20;SEC_140
2012;601;50-64;112;109;221;SEC_601
2012;604;75 i +;38;23;61;SEC_604
2012;410;03-11;57;67;124;SEC_410
2012;427;16-17;10;12;22;SEC_427
2012;304;50-64;134;127;261;SEC_304
2012;606;18-24;38;39;77;SEC_606
2012;325;03-11;65;71;136;SEC_325
2012;128;00-02;16;16;32;SEC_128
2012;222;35-49;119;146;265;SEC_222
2012;504;12-15;14;13;27;SEC_504
2012;606;75 i +;84;54;138;SEC_606
2012;138;35-49;87;71;158;SEC_138
2012;520;16-17;1;8;9;SEC_520
2012;436;16-17;8;8;16;SEC_436
2012;506;16-17;17;13;30;SEC_506
2012;604;25-34;43;60;103;SEC_604
2012;301;65-74;144;118;262;SEC_301
2012;620;50-64;60;57;117;SEC_620
2012;138;25-34;59;65;124;SEC_138
2012;203;03-11;36;44;80;SEC_203
2012;421;25-34;84;83;167;SEC_421
2012;602;18-24;16;14;30;SEC_602
2012;227;65-74;31;30;61;SEC_227
2012;221;00-02;27;15;42;SEC_221
2012;537;65-74;81;59;140;SEC_537
2012;229;50-64;69;69;138;SEC_229
2012;246;50-64;86;79;165;SEC_246
2012;237;75 i +;86;50;136;SEC_237
2012;119;12-15;15;19;34;SEC_119
2012;412;75 i +;97;84;181;SEC_412
2012;436;03-11;50;59;109;SEC_436
2012;216;35-49;143;156;299;SEC_216
2012;415;16-17;6;7;13;SEC_415
2012;119;50-64;150;122;272;SEC_119
2012;213;18-24;36;39;75;SEC_213
2012;217;03-11;23;34;57;SEC_217
2012;511;00-02;10;12;22;SEC_511
2012;527;75 i +;55;29;84;SEC_527
2012;239;65-74;58;39;97;SEC_239
2012;303;75 i +;124;110;234;SEC_303
2012;131;35-49;152;192;344;SEC_131
2012;415;00-02;12;17;29;SEC_415
2012;243;18-24;68;61;129;SEC_243
2012;304;00-02;53;64;117;SEC_304
2012;123;75 i +;98;63;161;SEC_123
2012;218;03-11;23;22;45;SEC_218
2012;513;75 i +;57;36;93;SEC_513
2012;323;00-02;37;44;81;SEC_323
2012;522;35-49;102;113;215;SEC_522
2012;523;65-74;84;61;145;SEC_523
2012;404;75 i +;90;52;142;SEC_404
2012;312;16-17;13;15;28;SEC_312
2012;404;16-17;8;15;23;SEC_404
2012;406;50-64;117;113;230;SEC_406
2012;628;75 i +;49;39;88;SEC_628
2012;204;16-17;5;4;9;SEC_204
2012;404;00-02;21;31;52;SEC_404
2012;612;16-17;3;8;11;SEC_612
2012;241;12-15;26;10;36;SEC_241
2012;628;25-34;64;74;138;SEC_628
2012;101;35-49;293;306;599;SEC_101
2012;614;25-34;45;65;110;SEC_614
2012;124;50-64;103;72;175;SEC_124
2012;242;12-15;20;17;37;SEC_242
2012;129;03-11;45;62;107;SEC_129
2012;201;50-64;79;66;145;SEC_201
2012;317;50-64;69;65;134;SEC_317
2012;303;12-15;22;26;48;SEC_303
2012;303;25-34;109;114;223;SEC_303
2012;606;50-64;75;72;147;SEC_606
2012;431;12-15;27;34;61;SEC_431
2012;526;18-24;23;33;56;SEC_526
2012;131;65-74;81;85;166;SEC_131
2012;228;65-74;43;23;66;SEC_228
2012;204;65-74;18;20;38;SEC_204
2012;236;65-74;61;42;103;SEC_236
2012;215;65-74;43;29;72;SEC_215
2012;538;35-49;161;140;301;SEC_538
2012;109;12-15;24;18;42;SEC_109
2012;442;35-49;77;75;152;SEC_442
2012;315;12-15;32;38;70;SEC_315
2012;103;35-49;104;109;213;SEC_103
2012;314;00-02;36;30;66;SEC_314
2012;310;75 i +;49;23;72;SEC_310
2012;439;35-49;146;167;313;SEC_439
2012;406;18-24;51;55;106;SEC_406
2012;511;35-49;93;108;201;SEC_511
2012;127;35-49;101;100;201;SEC_127
2012;242;00-02;13;17;30;SEC_242
2012;245;65-74;46;21;67;SEC_245
2012;605;03-11;26;29;55;SEC_605
2012;611;03-11;89;86;175;SEC_611
2012;245;16-17;11;13;24;SEC_245
2012;602;75 i +;31;34;65;SEC_602
2012;523;75 i +;96;73;169;SEC_523
2012;518;65-74;72;40;112;SEC_518
2012;312;18-24;53;52;105;SEC_312
2012;215;18-24;40;30;70;SEC_215
2012;607;16-17;8;7;15;SEC_607
2012;248;12-15;22;20;42;SEC_248
2012;621;03-11;48;53;101;SEC_621
2012;322;18-24;52;46;98;SEC_322
2012;202;50-64;68;50;118;SEC_202
2012;629;65-74;38;28;66;SEC_629
2012;112;00-02;21;21;42;SEC_112
2012;414;75 i +;60;46;106;SEC_414
2012;441;16-17;25;7;32;SEC_441
2012;124;18-24;27;28;55;SEC_124
2012;105;12-15;10;15;25;SEC_105
2012;405;65-74;66;37;103;SEC_405
2012;122;03-11;43;34;77;SEC_122
2012;622;50-64;102;78;180;SEC_622
2012;401;35-49;137;127;264;SEC_401
2012;319;00-02;23;38;61;SEC_319
2012;507;03-11;28;39;67;SEC_507
2012;235;35-49;210;238;448;SEC_235
2012;202;65-74;30;28;58;SEC_202
2012;109;16-17;5;12;17;SEC_109
2012;441;75 i +;100;72;172;SEC_441
2012;438;00-02;18;7;25;SEC_438
2012;426;50-64;76;80;156;SEC_426
2012;103;16-17;4;6;10;SEC_103
2012;101;00-02;35;37;72;SEC_101
2012;127;25-34;68;59;127;SEC_127
2012;131;16-17;9;10;19;SEC_131
2012;232;00-02;14;18;32;SEC_232
2012;211;03-11;64;61;125;SEC_211
2012;424;00-02;8;10;18;SEC_424
2012;106;50-64;258;210;468;SEC_106
2012;320;35-49;168;160;328;SEC_320
2012;603;00-02;15;16;31;SEC_603
2012;133;16-17;4;4;8;SEC_133
2012;134;12-15;28;22;50;SEC_134
2012;319;25-34;140;156;296;SEC_319
2012;605;75 i +;52;35;87;SEC_605
2012;410;16-17;8;16;24;SEC_410
2012;609;12-15;17;12;29;SEC_609
2012;101;65-74;56;44;100;SEC_101
2012;506;75 i +;100;72;172;SEC_506
2012;230;00-02;14;16;30;SEC_230
2012;412;50-64;177;152;329;SEC_412
2012;234;16-17;8;10;18;SEC_234
2012;131;12-15;19;15;34;SEC_131
2012;420;00-02;30;21;51;SEC_420
2012;110;75 i +;80;38;118;SEC_110
2012;620;03-11;20;16;36;SEC_620
2012;407;18-24;34;39;73;SEC_407
2012;325;16-17;21;12;33;SEC_325
2012;325;75 i +;188;100;288;SEC_325
2012;407;25-34;79;88;167;SEC_407
2012;419;03-11;42;59;101;SEC_419
2012;220;50-64;69;60;129;SEC_220
2012;620;25-34;28;28;56;SEC_620
2012;221;65-74;50;45;95;SEC_221
2012;125;50-64;152;142;294;SEC_125
2012;422;16-17;11;10;21;SEC_422
2012;427;18-24;31;46;77;SEC_427
2012;126;35-49;118;119;237;SEC_126
2012;528;18-24;48;47;95;SEC_528
2012;121;12-15;18;15;33;SEC_121
2012;314;65-74;94;89;183;SEC_314
2012;521;16-17;7;8;15;SEC_521
2012;314;03-11;87;98;185;SEC_314
2012;626;25-34;48;58;106;SEC_626
2012;630;65-74;58;53;111;SEC_630
2012;235;25-34;122;137;259;SEC_235
2012;218;75 i +;37;25;62;SEC_218
2012;204;25-34;53;50;103;SEC_204
2012;217;25-34;63;68;131;SEC_217
2012;419;65-74;45;26;71;SEC_419
2012;244;12-15;3;9;12;SEC_244
2012;402;65-74;42;30;72;SEC_402
2012;425;75 i +;79;48;127;SEC_425
2012;437;25-34;66;98;164;SEC_437
2012;117;12-15;32;35;67;SEC_117
2012;418;00-02;25;20;45;SEC_418
2012;433;75 i +;43;23;66;SEC_433
2012;223;25-34;122;103;225;SEC_223
2012;220;35-49;133;135;268;SEC_220
2012;518;25-34;75;74;149;SEC_518
2012;618;18-24;12;21;33;SEC_618
2012;207;12-15;8;13;21;SEC_207
2012;509;35-49;96;116;212;SEC_509
2012;208;18-24;62;53;115;SEC_208
2012;510;65-74;55;50;105;SEC_510
2012;208;50-64;190;157;347;SEC_208
2012;240;16-17;4;9;13;SEC_240
2012;439;25-34;90;117;207;SEC_439
2012;118;75 i +;55;41;96;SEC_118
2012;502;03-11;49;63;112;SEC_502
2012;512;00-02;6;13;19;SEC_512
2012;130;16-17;5;10;15;SEC_130
2012;308;50-64;224;205;429;SEC_308
2012;205;16-17;7;9;16;SEC_205
2012;618;65-74;49;43;92;SEC_618
2012;207;25-34;79;71;150;SEC_207
2012;422;00-02;12;22;34;SEC_422
2012;405;35-49;101;113;214;SEC_405
2012;618;03-11;36;42;78;SEC_618
2012;240;03-11;38;28;66;SEC_240
2012;116;03-11;54;62;116;SEC_116
2012;115;16-17;12;15;27;SEC_115
2012;531;16-17;13;9;22;SEC_531
2012;615;50-64;66;42;108;SEC_615
2012;620;75 i +;34;31;65;SEC_620
2012;232;16-17;9;5;14;SEC_232
2012;419;35-49;111;139;250;SEC_419
2012;215;35-49;143;148;291;SEC_215
2012;202;16-17;10;9;19;SEC_202
2012;133;25-34;52;66;118;SEC_133
2012;220;75 i +;63;40;103;SEC_220
2012;606;65-74;67;48;115;SEC_606
2012;435;35-49;121;169;290;SEC_435
2012;412;12-15;23;14;37;SEC_412
2012;627;03-11;34;32;66;SEC_627
2012;424;25-34;43;54;97;SEC_424
2012;622;75 i +;35;12;47;SEC_622
2012;306;03-11;72;60;132;SEC_306
2012;101;12-15;33;31;64;SEC_101
2012;632;00-02;8;14;22;SEC_632
2012;109;25-34;98;93;191;SEC_109
2012;410;12-15;26;27;53;SEC_410
2012;111;75 i +;65;41;106;SEC_111
2012;418;25-34;85;116;201;SEC_418
2012;316;75 i +;75;36;111;SEC_316
2012;126;50-64;86;59;145;SEC_126
2012;119;16-17;4;8;12;SEC_119
2012;324;75 i +;53;26;79;SEC_324
2012;235;65-74;77;57;134;SEC_235
2012;431;00-02;23;28;51;SEC_431
2012;305;16-17;11;11;22;SEC_305
2012;416;03-11;47;40;87;SEC_416
2012;210;75 i +;111;43;154;SEC_210
2012;112;35-49;188;160;348;SEC_112
2012;312;03-11;60;65;125;SEC_312
2012;321;18-24;80;87;167;SEC_321
2012;120;25-34;92;109;201;SEC_120
2012;431;18-24;69;52;121;SEC_431
2012;438;75 i +;46;44;90;SEC_438
2012;507;25-34;56;64;120;SEC_507
2012;216;65-74;81;56;137;SEC_216
2012;208;25-34;135;123;258;SEC_208
2012;102;18-24;43;55;98;SEC_102
2012;243;50-64;117;114;231;SEC_243
2012;413;03-11;22;32;54;SEC_413
2012;536;65-74;53;41;94;SEC_536
2012;129;50-64;94;87;181;SEC_129
2012;134;00-02;24;23;47;SEC_134
2012;508;00-02;10;15;25;SEC_508
2012;318;12-15;18;16;34;SEC_318
2012;403;12-15;16;15;31;SEC_403
2012;138;18-24;26;26;52;SEC_138
2012;619;65-74;97;82;179;SEC_619
2012;130;00-02;12;18;30;SEC_130
2012;627;00-02;9;19;28;SEC_627
2012;521;50-64;125;85;210;SEC_521
2012;319;18-24;49;51;100;SEC_319
2012;517;03-11;52;65;117;SEC_517
2012;526;65-74;34;35;69;SEC_526
2012;605;18-24;11;11;22;SEC_605
2012;207;03-11;37;33;70;SEC_207
2012;435;25-34;102;115;217;SEC_435
2012;513;12-15;20;9;29;SEC_513
2012;207;35-49;89;97;186;SEC_207
2012;419;18-24;30;45;75;SEC_419
2012;127;12-15;10;13;23;SEC_127
2012;422;35-49;142;164;306;SEC_422
2012;516;12-15;14;13;27;SEC_516
2012;623;16-17;12;10;22;SEC_623
2012;401;18-24;49;48;97;SEC_401
2012;117;50-64;234;216;450;SEC_117
2012;511;03-11;30;31;61;SEC_511
2012;525;75 i +;67;37;104;SEC_525
2012;218;35-49;81;96;177;SEC_218
2012;209;35-49;125;117;242;SEC_209
2012;426;03-11;49;50;99;SEC_426
2012;414;12-15;20;18;38;SEC_414
2012;529;50-64;88;85;173;SEC_529
2012;608;12-15;12;7;19;SEC_608
2012;616;25-34;305;320;625;SEC_616
2012;115;65-74;59;68;127;SEC_115
2012;523;16-17;18;14;32;SEC_523
2012;440;25-34;77;57;134;SEC_440
2012;323;25-34;208;203;411;SEC_323
2012;106;18-24;53;63;116;SEC_106
2012;248;00-02;12;19;31;SEC_248
2012;121;50-64;50;67;117;SEC_121
2012;120;50-64;198;194;392;SEC_120
2012;509;65-74;42;32;74;SEC_509
2012;515;00-02;8;15;23;SEC_515
2012;627;18-24;22;34;56;SEC_627
2012;516;35-49;86;87;173;SEC_516
2012;103;50-64;61;58;119;SEC_103
2012;225;12-15;4;12;16;SEC_225
2012;317;25-34;100;111;211;SEC_317
2012;419;16-17;11;15;26;SEC_419
2012;609;50-64;72;41;113;SEC_609
2012;432;35-49;116;140;256;SEC_432
2012;504;35-49;110;125;235;SEC_504
2012;429;75 i +;55;28;83;SEC_429
2012;138;03-11;23;28;51;SEC_138
2012;222;12-15;10;13;23;SEC_222
2012;624;50-64;103;60;163;SEC_624
2012;629;00-02;8;6;14;SEC_629
2012;228;35-49;106;121;227;SEC_228
2012;311;35-49;175;211;386;SEC_311
2012;106;75 i +;74;31;105;SEC_106
2012;115;50-64;131;116;247;SEC_115
2012;420;12-15;25;34;59;SEC_420
2012;615;35-49;87;106;193;SEC_615
2012;534;65-74;49;46;95;SEC_534
2012;122;35-49;120;112;232;SEC_122
2012;138;50-64;97;93;190;SEC_138
2012;243;16-17;10;15;25;SEC_243
2012;615;18-24;18;25;43;SEC_615
2012;535;25-34;56;54;110;SEC_535
2012;134;75 i +;80;34;114;SEC_134
2012;436;50-64;53;58;111;SEC_436
2012;616;16-17;38;30;68;SEC_616
2012;210;12-15;13;13;26;SEC_210
2012;301;16-17;19;16;35;SEC_301
2012;243;03-11;67;78;145;SEC_243
2012;210;25-34;47;52;99;SEC_210
2012;230;50-64;58;48;106;SEC_230
2012;413;18-24;31;23;54;SEC_413
2012;249;03-11;43;41;84;SEC_249
2012;623;75 i +;63;46;109;SEC_623
2012;127;75 i +;50;35;85;SEC_127
2012;205;18-24;37;44;81;SEC_205
2012;231;25-34;123;124;247;SEC_231
2012;323;18-24;107;93;200;SEC_323
2012;220;12-15;15;18;33;SEC_220
2012;432;50-64;159;138;297;SEC_432
2012;522;12-15;10;16;26;SEC_522
2012;529;12-15;23;30;53;SEC_529
2012;114;65-74;117;91;208;SEC_114
2012;233;16-17;4;7;11;SEC_233
2012;524;35-49;161;184;345;SEC_524
2012;232;75 i +;76;50;126;SEC_232
2012;430;50-64;69;70;139;SEC_430
2012;408;12-15;14;19;33;SEC_408
2012;406;75 i +;74;61;135;SEC_406
2012;121;65-74;31;17;48;SEC_121
2012;438;18-24;27;32;59;SEC_438
2012;213;25-34;81;94;175;SEC_213
2012;627;75 i +;47;33;80;SEC_627
2012;532;75 i +;90;58;148;SEC_532
2012;245;00-02;20;21;41;SEC_245
2012;317;03-11;52;60;112;SEC_317
2012;402;50-64;64;63;127;SEC_402
2012;245;12-15;21;17;38;SEC_245
2012;407;12-15;19;14;33;SEC_407
2012;134;25-34;93;110;203;SEC_134
2012;129;00-02;11;17;28;SEC_129
2012;440;35-49;112;112;224;SEC_440
2012;316;16-17;17;22;39;SEC_316
2012;238;65-74;38;33;71;SEC_238
2012;318;25-34;55;56;111;SEC_318
2012;319;75 i +;50;31;81;SEC_319
2012;502;50-64;139;116;255;SEC_502
2012;234;65-74;36;28;64;SEC_234
2012;236;03-11;43;38;81;SEC_236
2012;324;00-02;21;28;49;SEC_324
2012;610;00-02;15;13;28;SEC_610
2012;245;25-34;87;88;175;SEC_245
2012;106;35-49;182;162;344;SEC_106
2012;413;50-64;45;55;100;SEC_413
2012;313;50-64;222;194;416;SEC_313
2012;438;03-11;24;43;67;SEC_438
2012;211;18-24;61;48;109;SEC_211
2012;408;03-11;56;33;89;SEC_408
2012;402;12-15;18;16;34;SEC_402
2012;312;50-64;148;145;293;SEC_312
2012;527;25-34;107;107;214;SEC_527
2012;414;50-64;65;54;119;SEC_414
2012;242;25-34;88;108;196;SEC_242
2012;123;35-49;158;146;304;SEC_123
2012;309;35-49;140;159;299;SEC_309
2012;203;18-24;30;40;70;SEC_203
2012;409;35-49;81;91;172;SEC_409
2012;304;16-17;54;19;73;SEC_304
2012;533;18-24;37;33;70;SEC_533
2012;608;00-02;5;9;14;SEC_608
2012;529;35-49;170;159;329;SEC_529
2012;431;25-34;124;158;282;SEC_431
2012;501;16-17;7;13;20;SEC_501
2012;601;25-34;74;88;162;SEC_601
2012;125;03-11;88;85;173;SEC_125
2012;411;12-15;13;9;22;SEC_411
2012;323;65-74;107;118;225;SEC_323
2012;412;16-17;13;15;28;SEC_412
2012;427;25-34;90;108;198;SEC_427
2012;441;65-74;113;92;205;SEC_441
2012;524;03-11;54;62;116;SEC_524
2012;312;75 i +;79;52;131;SEC_312
2012;206;00-02;14;8;22;SEC_206
2012;407;50-64;70;76;146;SEC_407
2012;244;65-74;32;21;53;SEC_244
2012;502;35-49;184;217;401;SEC_502
2012;247;16-17;10;17;27;SEC_247
2012;417;16-17;5;11;16;SEC_417
2012;501;35-49;115;115;230;SEC_501
2012;405;18-24;28;26;54;SEC_405
2012;317;35-49;135;181;316;SEC_317
2012;408;35-49;125;116;241;SEC_408
2012;225;00-02;8;9;17;SEC_225
2012;124;75 i +;45;44;89;SEC_124
2012;606;00-02;20;19;39;SEC_606
2012;302;00-02;26;28;54;SEC_302
2012;235;75 i +;87;58;145;SEC_235
2012;632;50-64;78;64;142;SEC_632
2012;303;65-74;131;102;233;SEC_303
2012;120;16-17;12;17;29;SEC_120
2012;216;12-15;22;9;31;SEC_216
2012;621;12-15;21;31;52;SEC_621
2012;205;35-49;113;111;224;SEC_205
2012;627;16-17;3;7;10;SEC_627
2012;322;35-49;192;178;370;SEC_322
2012;108;25-34;109;95;204;SEC_108
2012;441;25-34;193;187;380;SEC_441
2012;536;35-49;111;126;237;SEC_536
2012;604;16-17;6;4;10;SEC_604
2012;519;35-49;75;100;175;SEC_519
2012;520;25-34;58;57;115;SEC_520
2012;522;18-24;33;27;60;SEC_522
2012;130;03-11;49;41;90;SEC_130
2012;511;50-64;51;46;97;SEC_511
2012;631;65-74;100;99;199;SEC_631
2012;417;65-74;30;22;52;SEC_417
2012;522;03-11;47;39;86;SEC_522
2012;210;16-17;6;2;8;SEC_210
2012;242;65-74;61;54;115;SEC_242
2012;538;75 i +;96;59;155;SEC_538
2012;107;16-17;6;17;23;SEC_107
2012;518;50-64;80;67;147;SEC_518
2012;125;00-02;20;35;55;SEC_125
2012;212;50-64;109;104;213;SEC_212
2012;607;65-74;90;63;153;SEC_607
2012;111;35-49;96;93;189;SEC_111
2012;241;16-17;13;9;22;SEC_241
2012;231;75 i +;91;48;139;SEC_231
2012;608;65-74;49;30;79;SEC_608
2012;307;50-64;190;148;338;SEC_307
2012;323;35-49;339;358;697;SEC_323
2012;238;75 i +;63;43;106;SEC_238
2012;507;18-24;24;38;62;SEC_507
2012;218;12-15;7;15;22;SEC_218
2012;129;75 i +;78;58;136;SEC_129
2012;524;75 i +;76;46;122;SEC_524
2012;220;18-24;30;30;60;SEC_220
2012;516;25-34;58;83;141;SEC_516
2012;138;75 i +;37;30;67;SEC_138
2012;123;65-74;55;53;108;SEC_123
2012;208;00-02;13;16;29;SEC_208
2012;612;12-15;8;24;32;SEC_612
2012;204;18-24;26;25;51;SEC_204
2012;201;18-24;25;26;51;SEC_201
2012;402;16-17;4;3;7;SEC_402
2012;410;75 i +;145;102;247;SEC_410
2012;507;50-64;85;62;147;SEC_507
2012;604;35-49;79;110;189;SEC_604
2012;248;03-11;46;52;98;SEC_248
2012;210;03-11;27;31;58;SEC_210
2012;409;18-24;28;31;59;SEC_409
2012;210;00-02;9;9;18;SEC_210
2012;122;50-64;59;47;106;SEC_122
2012;432;16-17;10;3;13;SEC_432
2012;419;75 i +;46;35;81;SEC_419
2012;206;50-64;75;67;142;SEC_206
2012;612;50-64;63;60;123;SEC_612
2012;241;35-49;102;103;205;SEC_241
2012;529;18-24;54;60;114;SEC_529
2012;135;35-49;184;174;358;SEC_135
2012;206;18-24;36;29;65;SEC_206
2012;611;50-64;115;114;229;SEC_611
2012;121;03-11;27;47;74;SEC_121
2012;613;18-24;31;38;69;SEC_613
2012;631;25-34;66;58;124;SEC_631
2012;232;35-49;118;146;264;SEC_232
2012;135;00-02;16;21;37;SEC_135
2012;212;16-17;10;19;29;SEC_212
2012;218;00-02;10;8;18;SEC_218
2012;229;18-24;42;29;71;SEC_229
2012;202;25-34;87;98;185;SEC_202
2012;316;25-34;175;214;389;SEC_316
2012;538;50-64;90;82;172;SEC_538
2012;244;16-17;7;3;10;SEC_244
2012;519;18-24;19;38;57;SEC_519
2012;216;16-17;17;17;34;SEC_216
2012;121;35-49;110;122;232;SEC_121
2012;137;00-02;21;21;42;SEC_137
2012;501;12-15;19;18;37;SEC_501
2012;505;75 i +;77;61;138;SEC_505
2012;323;03-11;134;156;290;SEC_323
2012;622;16-17;7;10;17;SEC_622
2012;520;75 i +;55;46;101;SEC_520
2012;524;50-64;90;81;171;SEC_524
2012;613;75 i +;85;48;133;SEC_613
2012;605;65-74;73;59;132;SEC_605
2012;537;00-02;16;13;29;SEC_537
2012;518;00-02;10;17;27;SEC_518
2012;439;12-15;18;20;38;SEC_439
2012;215;12-15;19;19;38;SEC_215
2012;247;00-02;31;36;67;SEC_247
2012;528;65-74;65;48;113;SEC_528
2012;417;18-24;35;18;53;SEC_417
2012;508;75 i +;36;22;58;SEC_508
2012;533;65-74;47;21;68;SEC_533
2012;301;00-02;45;48;93;SEC_301
2012;237;03-11;63;71;134;SEC_237
2012;115;75 i +;79;38;117;SEC_115
2012;405;00-02;14;14;28;SEC_405
2012;512;18-24;33;33;66;SEC_512
2012;111;03-11;30;37;67;SEC_111
2012;519;03-11;23;34;57;SEC_519
2012;115;35-49;156;174;330;SEC_115
2012;104;03-11;37;40;77;SEC_104
2012;505;50-64;117;74;191;SEC_505
2012;138;65-74;55;38;93;SEC_138
2012;526;35-49;91;87;178;SEC_526
2012;612;75 i +;53;44;97;SEC_612
2012;631;12-15;13;18;31;SEC_631
2012;422;65-74;47;26;73;SEC_422
2012;309;65-74;31;40;71;SEC_309
2012;414;35-49;135;127;262;SEC_414
2012;427;75 i +;65;36;101;SEC_427
2012;407;00-02;17;13;30;SEC_407
2012;102;03-11;61;59;120;SEC_102
2012;320;03-11;70;62;132;SEC_320
2012;206;35-49;115;129;244;SEC_206
2012;116;12-15;31;22;53;SEC_116
2012;518;16-17;6;12;18;SEC_518
2012;408;00-02;19;10;29;SEC_408
2012;103;25-34;47;51;98;SEC_103
2012;115;25-34;90;84;174;SEC_115
2012;610;65-74;133;110;243;SEC_610
2012;109;18-24;41;30;71;SEC_109
2012;324;65-74;40;38;78;SEC_324
2012;411;03-11;35;26;61;SEC_411
2012;124;35-49;77;85;162;SEC_124
2012;403;75 i +;82;66;148;SEC_403
2012;222;50-64;68;54;122;SEC_222
2012;116;18-24;48;39;87;SEC_116
2012;504;50-64;93;71;164;SEC_504
2012;224;16-17;7;7;14;SEC_224
2012;132;03-11;106;66;172;SEC_132
2012;428;16-17;6;8;14;SEC_428
2012;213;16-17;4;9;13;SEC_213
2012;534;18-24;41;37;78;SEC_534
2012;106;12-15;18;21;39;SEC_106
2012;303;18-24;42;39;81;SEC_303
2012;316;18-24;109;100;209;SEC_316
2012;308;00-02;25;26;51;SEC_308
2012;247;50-64;98;104;202;SEC_247
2012;609;16-17;5;13;18;SEC_609
2012;206;75 i +;77;41;118;SEC_206
2012;115;18-24;28;51;79;SEC_115
2012;126;75 i +;69;40;109;SEC_126
2012;626;65-74;68;55;123;SEC_626
2012;504;65-74;92;73;165;SEC_504
2012;419;12-15;14;21;35;SEC_419
2012;423;35-49;119;138;257;SEC_423
2012;320;12-15;20;22;42;SEC_320
2012;409;25-34;56;63;119;SEC_409
2012;415;65-74;23;27;50;SEC_415
2012;418;16-17;13;16;29;SEC_418
2012;126;03-11;50;43;93;SEC_126
2012;126;16-17;9;7;16;SEC_126
2012;614;03-11;43;38;81;SEC_614
2012;426;35-49;135;133;268;SEC_426
2012;514;18-24;32;15;47;SEC_514
2012;603;12-15;16;16;32;SEC_603
2012;603;50-64;44;42;86;SEC_603
2012;212;75 i +;82;48;130;SEC_212
2012;109;35-49;123;126;249;SEC_109
2012;140;35-49;118;134;252;SEC_140
2012;246;25-34;104;104;208;SEC_246
2012;411;35-49;102;101;203;SEC_411
2012;435;18-24;43;42;85;SEC_435
2012;231;12-15;25;24;49;SEC_231
2012;617;75 i +;58;36;94;SEC_617
2012;228;18-24;36;39;75;SEC_228
2012;429;65-74;26;21;47;SEC_429
2012;409;16-17;3;4;7;SEC_409
2012;133;03-11;34;34;68;SEC_133
2012;536;50-64;64;65;129;SEC_536
2012;118;03-11;78;65;143;SEC_118
2012;234;18-24;41;40;81;SEC_234
2012;629;25-34;38;40;78;SEC_629
2012;515;12-15;7;14;21;SEC_515
2012;208;12-15;26;22;48;SEC_208
2012;427;03-11;64;60;124;SEC_427
2012;239;35-49;135;150;285;SEC_239
2012;122;18-24;31;13;44;SEC_122
2012;310;16-17;6;4;10;SEC_310
2012;242;16-17;7;5;12;SEC_242
2012;606;35-49;134;152;286;SEC_606
2012;123;18-24;47;48;95;SEC_123
2012;622;03-11;28;35;63;SEC_622
2012;221;16-17;9;14;23;SEC_221
2012;405;50-64;50;62;112;SEC_405
2012;538;03-11;56;53;109;SEC_538
2012;225;16-17;4;2;6;SEC_225
2012;115;12-15;17;22;39;SEC_115
2012;321;16-17;13;14;27;SEC_321
2012;611;65-74;131;105;236;SEC_611
2012;317;00-02;21;20;41;SEC_317
2012;438;65-74;61;44;105;SEC_438
2012;222;65-74;38;40;78;SEC_222
2012;505;18-24;32;23;55;SEC_505
2012;409;03-11;25;28;53;SEC_409
2012;410;35-49;173;160;333;SEC_410
2012;236;00-02;11;19;30;SEC_236
2012;436;12-15;16;17;33;SEC_436
2012;245;18-24;46;44;90;SEC_245
2012;523;50-64;87;103;190;SEC_523
2012;529;00-02;19;20;39;SEC_529
2012;515;16-17;5;7;12;SEC_515
2012;604;03-11;26;33;59;SEC_604
2012;313;16-17;12;12;24;SEC_313
2012;301;35-49;368;393;761;SEC_301
2012;622;25-34;58;51;109;SEC_622
2012;227;75 i +;52;37;89;SEC_227
2012;537;35-49;142;130;272;SEC_537
2012;504;00-02;15;15;30;SEC_504
2012;239;18-24;41;44;85;SEC_239
2012;213;00-02;9;9;18;SEC_213
2012;424;03-11;23;24;47;SEC_424
2012;432;25-34;85;89;174;SEC_432
2012;426;25-34;89;95;184;SEC_426
2012;617;50-64;83;80;163;SEC_617
2012;428;65-74;14;12;26;SEC_428
2012;504;03-11;28;35;63;SEC_504
2012;202;75 i +;41;30;71;SEC_202
2012;601;18-24;41;50;91;SEC_601
2012;321;12-15;46;39;85;SEC_321
2012;242;35-49;117;142;259;SEC_242
2012;321;25-34;164;149;313;SEC_321
2012;502;65-74;84;86;170;SEC_502
2012;409;65-74;33;28;61;SEC_409
2012;530;65-74;69;56;125;SEC_530
2012;108;00-02;18;16;34;SEC_108
2012;513;25-34;53;47;100;SEC_513
2012;312;65-74;125;101;226;SEC_312
2012;121;25-34;74;52;126;SEC_121
2012;133;75 i +;60;34;94;SEC_133
2012;525;65-74;44;32;76;SEC_525
2012;616;75 i +;63;47;110;SEC_616
2012;139;03-11;35;38;73;SEC_139
2012;625;25-34;88;92;180;SEC_625
2012;303;00-02;22;15;37;SEC_303
2012;203;25-34;89;85;174;SEC_203
2012;116;00-02;16;20;36;SEC_116
2012;113;03-11;59;87;146;SEC_113
2012;230;12-15;21;22;43;SEC_230
2012;317;18-24;35;39;74;SEC_317
2012;319;65-74;49;57;106;SEC_319
2012;203;16-17;3;5;8;SEC_203
2012;249;18-24;50;46;96;SEC_249
2012;239;75 i +;102;56;158;SEC_239
2012;606;12-15;18;25;43;SEC_606
2012;522;25-34;87;81;168;SEC_522
2012;631;18-24;40;26;66;SEC_631
2012;226;25-34;96;107;203;SEC_226
2012;223;00-02;22;15;37;SEC_223
2012;210;50-64;70;80;150;SEC_210
2012;604;12-15;13;12;25;SEC_604
2012;617;03-11;33;42;75;SEC_617
2012;433;35-49;140;168;308;SEC_433
2012;406;65-74;73;61;134;SEC_406
2012;229;16-17;13;13;26;SEC_229
2012;105;75 i +;67;38;105;SEC_105
2012;215;25-34;102;91;193;SEC_215
2012;201;12-15;13;18;31;SEC_201
2012;442;18-24;16;26;42;SEC_442
2012;601;03-11;45;68;113;SEC_601
2012;617;35-49;110;130;240;SEC_617
2012;241;18-24;49;39;88;SEC_241
2012;511;18-24;29;37;66;SEC_511
2012;137;12-15;34;25;59;SEC_137
2012;435;75 i +;87;39;126;SEC_435
2012;415;35-49;119;145;264;SEC_415
2012;517;12-15;27;30;57;SEC_517
2012;121;75 i +;86;46;132;SEC_121
2012;315;35-49;255;241;496;SEC_315
2012;243;65-74;68;55;123;SEC_243
2012;415;75 i +;31;21;52;SEC_415
2012;516;50-64;47;48;95;SEC_516
2012;226;18-24;43;42;85;SEC_226
2012;232;03-11;32;40;72;SEC_232
2012;221;75 i +;79;51;130;SEC_221
2012;233;65-74;48;24;72;SEC_233
2012;311;25-34;118;129;247;SEC_311
2012;531;35-49;118;137;255;SEC_531
2012;117;18-24;61;70;131;SEC_117
2012;628;50-64;93;69;162;SEC_628
2012;215;50-64;91;72;163;SEC_215
2012;140;50-64;87;62;149;SEC_140
2012;301;18-24;74;81;155;SEC_301
2012;306;12-15;30;29;59;SEC_306
2012;314;35-49;276;298;574;SEC_314
2012;315;75 i +;57;37;94;SEC_315
2012;628;00-02;12;11;23;SEC_628
2012;130;12-15;18;20;38;SEC_130
2012;205;65-74;50;34;84;SEC_205
2012;241;75 i +;64;38;102;SEC_241
2012;244;18-24;34;24;58;SEC_244
2012;133;12-15;16;13;29;SEC_133
2012;632;18-24;22;33;55;SEC_632
2012;244;25-34;55;58;113;SEC_244
2012;536;75 i +;76;50;126;SEC_536
2012;239;00-02;11;11;22;SEC_239
2012;504;16-17;3;10;13;SEC_504
2012;117;65-74;104;94;198;SEC_117
2012;411;00-02;12;11;23;SEC_411
2012;408;16-17;6;7;13;SEC_408
2012;425;25-34;73;113;186;SEC_425
2012;602;25-34;35;38;73;SEC_602
2012;206;25-34;73;83;156;SEC_206
2012;128;35-49;137;146;283;SEC_128
2012;423;75 i +;79;53;132;SEC_423
2012;321;75 i +;121;76;197;SEC_321
2012;107;03-11;78;81;159;SEC_107
2012;228;50-64;45;57;102;SEC_228
2012;433;50-64;77;82;159;SEC_433
2012;119;35-49;139;129;268;SEC_119
2012;428;35-49;80;100;180;SEC_428
2012;318;00-02;10;7;17;SEC_318
2012;632;75 i +;51;37;88;SEC_632
2012;432;18-24;39;45;84;SEC_432
2012;224;75 i +;35;23;58;SEC_224
2012;417;12-15;12;11;23;SEC_417
2012;316;03-11;52;69;121;SEC_316
2012;122;16-17;10;7;17;SEC_122
2012;522;75 i +;37;32;69;SEC_522
2012;309;16-17;7;12;19;SEC_309
2012;135;16-17;13;10;23;SEC_135
2012;528;75 i +;65;51;116;SEC_528
2012;630;50-64;115;88;203;SEC_630
2012;607;50-64;84;74;158;SEC_607
2012;121;16-17;10;10;20;SEC_121
2012;316;12-15;22;25;47;SEC_316
2012;430;18-24;38;38;76;SEC_430
2012;626;18-24;33;18;51;SEC_626
2012;403;00-02;19;18;37;SEC_403
2012;202;35-49;106;133;239;SEC_202
2012;524;25-34;117;109;226;SEC_524
2012;503;75 i +;40;21;61;SEC_503
2012;241;03-11;35;38;73;SEC_241
2012;231;50-64;77;65;142;SEC_231
2012;103;00-02;6;17;23;SEC_103
2012;135;03-11;46;62;108;SEC_135
2012;508;16-17;5;7;12;SEC_508
2012;214;25-34;107;108;215;SEC_214
2012;249;50-64;94;83;177;SEC_249
2012;612;35-49;111;137;248;SEC_612
2012;135;12-15;27;23;50;SEC_135
2012;529;65-74;64;41;105;SEC_529
2012;626;75 i +;68;45;113;SEC_626
2012;418;50-64;107;105;212;SEC_418
2012;441;18-24;77;83;160;SEC_441
2012;135;50-64;159;141;300;SEC_135
2012;613;65-74;125;116;241;SEC_613
2012;442;12-15;11;13;24;SEC_442
2012;115;03-11;50;54;104;SEC_115
2012;310;35-49;107;110;217;SEC_310
2012;509;50-64;63;50;113;SEC_509
2012;429;18-24;23;30;53;SEC_429
2012;426;65-74;39;31;70;SEC_426
2012;430;00-02;24;19;43;SEC_430
2012;530;03-11;54;72;126;SEC_530
2012;116;25-34;91;84;175;SEC_116
2012;417;75 i +;35;21;56;SEC_417
2012;602;03-11;28;19;47;SEC_602
2012;308;16-17;16;22;38;SEC_308
2012;610;03-11;38;42;80;SEC_610
2012;208;03-11;37;52;89;SEC_208
2012;428;12-15;11;8;19;SEC_428
2012;501;50-64;135;111;246;SEC_501
2012;419;00-02;14;14;28;SEC_419
2012;208;35-49;172;154;326;SEC_208
2012;214;18-24;35;43;78;SEC_214
2012;608;35-49;86;114;200;SEC_608
2012;112;18-24;54;68;122;SEC_112
2012;403;03-11;40;39;79;SEC_403
2012;140;00-02;14;18;32;SEC_140
2012;309;25-34;104;85;189;SEC_309
2012;413;12-15;7;5;12;SEC_413
2012;405;16-17;7;11;18;SEC_405
2012;609;00-02;12;14;26;SEC_609
2012;517;50-64;77;81;158;SEC_517
2012;318;35-49;98;83;181;SEC_318
2012;607;25-34;69;78;147;SEC_607
2012;218;25-34;54;90;144;SEC_218
2012;229;65-74;34;25;59;SEC_229
2012;209;75 i +;80;67;147;SEC_209
2012;244;50-64;55;53;108;SEC_244
2012;408;65-74;48;25;73;SEC_408
2012;509;03-11;38;43;81;SEC_509
2012;306;00-02;23;21;44;SEC_306
2012;427;12-15;15;25;40;SEC_427
2012;204;50-64;48;41;89;SEC_204
2012;627;65-74;58;71;129;SEC_627
2012;413;16-17;14;9;23;SEC_413
2012;133;35-49;102;106;208;SEC_133
2012;507;65-74;47;51;98;SEC_507
2012;216;75 i +;76;52;128;SEC_216
2012;514;12-15;16;13;29;SEC_514
2012;609;25-34;49;44;93;SEC_609
2012;524;00-02;23;22;45;SEC_524
2012;325;12-15;34;31;65;SEC_325
2012;231;03-11;60;64;124;SEC_231
2012;622;00-02;9;12;21;SEC_622
2012;113;65-74;70;72;142;SEC_113
2012;231;18-24;45;40;85;SEC_231
2012;525;35-49;113;121;234;SEC_525
2012;416;65-74;44;25;69;SEC_416
2012;424;12-15;8;12;20;SEC_424
2012;211;65-74;38;33;71;SEC_211
2012;411;18-24;33;26;59;SEC_411
2012;204;03-11;23;24;47;SEC_204
2012;613;00-02;18;16;34;SEC_613
2012;223;16-17;15;10;25;SEC_223
2012;233;18-24;27;33;60;SEC_233
2012;101;03-11;129;135;264;SEC_101
2012;505;65-74;135;136;271;SEC_505
2012;212;12-15;27;18;45;SEC_212
2012;617;00-02;11;16;27;SEC_617
2012;627;12-15;19;9;28;SEC_627
2012;110;35-49;117;111;228;SEC_110
2012;528;25-34;120;101;221;SEC_528
2012;406;03-11;38;67;105;SEC_406
2012;518;18-24;40;42;82;SEC_518
2012;101;75 i +;54;45;99;SEC_101
2012;523;35-49;181;184;365;SEC_523
2012;304;65-74;83;60;143;SEC_304
2012;612;65-74;124;88;212;SEC_612
2012;104;75 i +;86;42;128;SEC_104
2012;231;35-49;173;175;348;SEC_231
2012;106;00-02;22;25;47;SEC_106
2012;533;03-11;42;52;94;SEC_533
2012;213;12-15;7;25;32;SEC_213
2012;535;50-64;119;90;209;SEC_535
2012;227;12-15;15;15;30;SEC_227
2012;110;03-11;45;38;83;SEC_110
2012;514;35-49;91;121;212;SEC_514
2012;205;50-64;102;102;204;SEC_205
2012;406;16-17;15;13;28;SEC_406
2012;313;65-74;91;76;167;SEC_313
2012;236;18-24;41;45;86;SEC_236
2012;129;16-17;12;7;19;SEC_129
2012;602;65-74;58;44;102;SEC_602
2012;222;00-02;10;19;29;SEC_222
2012;507;75 i +;47;23;70;SEC_507
2012;246;00-02;18;19;37;SEC_246
2012;113;00-02;29;40;69;SEC_113
2012;517;65-74;53;39;92;SEC_517
2012;403;25-34;94;102;196;SEC_403
2012;518;35-49;127;135;262;SEC_518
2012;620;35-49;56;55;111;SEC_620
2012;129;65-74;73;67;140;SEC_129
2012;530;16-17;9;17;26;SEC_530
2012;214;75 i +;34;32;66;SEC_214
2012;437;50-64;73;57;130;SEC_437
2012;114;16-17;11;17;28;SEC_114
2012;140;65-74;51;53;104;SEC_140
2012;122;65-74;71;45;116;SEC_122
2012;105;03-11;60;62;122;SEC_105
2012;523;25-34;119;110;229;SEC_523
2012;320;18-24;32;27;59;SEC_320
2012;219;18-24;55;39;94;SEC_219
2012;313;03-11;94;92;186;SEC_313
2012;505;03-11;40;39;79;SEC_505
2012;415;50-64;57;55;112;SEC_415
2012;406;25-34;119;109;228;SEC_406
2012;623;25-34;78;88;166;SEC_623
2012;209;16-17;13;11;24;SEC_209
2012;516;16-17;7;6;13;SEC_516
2012;530;18-24;68;66;134;SEC_530
2012;418;65-74;72;54;126;SEC_418
2012;620;00-02;6;7;13;SEC_620
2012;248;50-64;97;108;205;SEC_248
2012;110;12-15;5;14;19;SEC_110
2012;414;25-34;72;69;141;SEC_414
2012;613;16-17;6;10;16;SEC_613
2012;616;35-49;419;429;848;SEC_616
2012;213;50-64;86;77;163;SEC_213
2012;139;00-02;11;10;21;SEC_139
2012;248;35-49;179;171;350;SEC_248
2012;525;18-24;49;36;85;SEC_525
2012;233;35-49;120;157;277;SEC_233
2012;227;25-34;54;51;105;SEC_227
2012;605;12-15;7;5;12;SEC_605
2012;536;00-02;12;12;24;SEC_536
2012;533;75 i +;59;42;101;SEC_533
2012;520;03-11;31;36;67;SEC_520
2012;105;65-74;39;48;87;SEC_105
2012;236;50-64;86;67;153;SEC_236
2012;516;65-74;28;17;45;SEC_516
2012;201;25-34;115;107;222;SEC_201
2012;618;25-34;31;25;56;SEC_618
2012;611;18-24;65;60;125;SEC_611
2012;440;18-24;26;26;52;SEC_440
2012;412;65-74;108;82;190;SEC_412
2012;305;50-64;186;170;356;SEC_305
2012;631;03-11;33;43;76;SEC_631
2012;404;12-15;30;40;70;SEC_404
2012;127;65-74;32;19;51;SEC_127
2012;521;18-24;22;25;47;SEC_521
2012;237;35-49;178;215;393;SEC_237
2012;603;75 i +;21;22;43;SEC_603
2012;301;25-34;188;201;389;SEC_301
2012;238;35-49;122;136;258;SEC_238
2012;247;35-49;166;192;358;SEC_247
2012;613;12-15;13;23;36;SEC_613
2012;132;25-34;143;146;289;SEC_132
2012;119;18-24;37;39;76;SEC_119
2012;128;25-34;91;81;172;SEC_128
2012;228;16-17;4;9;13;SEC_228
2012;116;50-64;146;125;271;SEC_116
2012;604;00-02;10;13;23;SEC_604
2012;436;25-34;89;94;183;SEC_436
2012;315;18-24;64;58;122;SEC_315
2012;124;25-34;59;48;107;SEC_124
2012;111;65-74;67;47;114;SEC_111
2012;232;12-15;18;17;35;SEC_232
2012;236;35-49;124;114;238;SEC_236
2012;442;25-34;43;50;93;SEC_442
2012;422;03-11;45;62;107;SEC_422
2012;203;65-74;31;36;67;SEC_203
2012;243;00-02;19;23;42;SEC_243
2012;615;75 i +;43;38;81;SEC_615
2012;534;35-49;125;137;262;SEC_534
2012;220;16-17;10;3;13;SEC_220
2012;318;75 i +;31;21;52;SEC_318
2012;311;12-15;29;26;55;SEC_311
2012;310;25-34;90;68;158;SEC_310
2012;249;16-17;11;9;20;SEC_249
2012;118;16-17;13;16;29;SEC_118
2012;429;03-11;25;23;48;SEC_429
2012;302;75 i +;68;37;105;SEC_302
2012;414;00-02;11;14;25;SEC_414
2012;610;35-49;135;148;283;SEC_610
2012;316;65-74;91;99;190;SEC_316
2012;502;12-15;29;29;58;SEC_502
2012;521;35-49;104;111;215;SEC_521
2012;322;00-02;19;30;49;SEC_322
2012;226;03-11;50;37;87;SEC_226
2012;310;00-02;16;12;28;SEC_310
2012;132;75 i +;101;68;169;SEC_132
2012;108;12-15;31;26;57;SEC_108
2012;123;12-15;14;29;43;SEC_123
2012;527;12-15;24;24;48;SEC_527
2012;305;25-34;108;122;230;SEC_305
2012;415;12-15;10;13;23;SEC_415
2012;306;18-24;50;67;117;SEC_306
2012;533;25-34;85;98;183;SEC_533
2012;140;03-11;36;44;80;SEC_140
2012;130;65-74;59;34;93;SEC_130
2012;410;18-24;56;52;108;SEC_410
2012;534;00-02;10;22;32;SEC_534
2012;424;18-24;19;24;43;SEC_424
2012;412;35-49;171;192;363;SEC_412
2012;230;03-11;50;45;95;SEC_230
2012;136;65-74;55;55;110;SEC_136
2012;313;12-15;32;40;72;SEC_313
2012;413;65-74;22;16;38;SEC_413
2012;537;50-64;119;102;221;SEC_537
2012;316;00-02;18;15;33;SEC_316
2012;626;00-02;8;10;18;SEC_626
2012;218;18-24;37;29;66;SEC_218
2012;139;25-34;68;72;140;SEC_139
2012;209;18-24;40;49;89;SEC_209
2012;530;35-49;190;211;401;SEC_530
2012;120;65-74;68;67;135;SEC_120
2012;524;18-24;55;62;117;SEC_524
2012;628;03-11;45;44;89;SEC_628
2012;238;03-11;30;33;63;SEC_238
2012;414;18-24;37;29;66;SEC_414
2012;213;35-49;119;111;230;SEC_213
2012;407;35-49;117;133;250;SEC_407
2012;626;50-64;84;73;157;SEC_626
2012;241;25-34;64;59;123;SEC_241
2012;108;16-17;9;10;19;SEC_108
2012;319;50-64;151;123;274;SEC_319
2012;601;00-02;22;12;34;SEC_601
2012;410;00-02;19;20;39;SEC_410
2012;532;50-64;99;72;171;SEC_532
2012;406;35-49;133;161;294;SEC_406
2012;243;25-34;123;101;224;SEC_243
2012;318;50-64;103;106;209;SEC_318
2012;617;65-74;64;39;103;SEC_617
2012;126;25-34;70;57;127;SEC_126
2012;425;03-11;33;50;83;SEC_425
2012;113;75 i +;62;41;103;SEC_113
2012;136;12-15;16;25;41;SEC_136
2012;247;25-34;119;121;240;SEC_247
2012;243;75 i +;110;71;181;SEC_243
2012;526;03-11;23;25;48;SEC_526
2012;515;65-74;26;30;56;SEC_515
2012;607;18-24;36;35;71;SEC_607
2012;217;75 i +;43;23;66;SEC_217
2012;442;03-11;30;20;50;SEC_442
2012;114;03-11;50;71;121;SEC_114
2012;513;18-24;25;23;48;SEC_513
2012;204;35-49;85;86;171;SEC_204
2012;118;50-64;218;182;400;SEC_118
2012;436;65-74;29;24;53;SEC_436
2012;315;03-11;74;87;161;SEC_315
2012;238;16-17;5;11;16;SEC_238
2012;104;16-17;5;7;12;SEC_104
2012;241;50-64;82;71;153;SEC_241
2012;235;18-24;68;47;115;SEC_235
2012;614;35-49;102;116;218;SEC_614
2012;413;25-34;59;54;113;SEC_413
2012;437;35-49;89;122;211;SEC_437
2012;526;12-15;9;16;25;SEC_526
2012;225;25-34;54;54;108;SEC_225
2012;111;16-17;6;10;16;SEC_111
2012;122;75 i +;56;45;101;SEC_122
2012;314;12-15;43;31;74;SEC_314
2012;228;03-11;33;34;67;SEC_228
2012;225;03-11;15;22;37;SEC_225
