AnyPadro;Seccio;GrupEdat;Dones;Homes;Total;IdSeccio
2006;632;03-11;52;42;94;SEC_632
2006;519;18-24;41;26;67;SEC_519
2006;416;75 i +;52;33;85;SEC_416
2006;516;00-02;13;11;24;SEC_516
2006;428;16-17;8;6;14;SEC_428
2006;322;25-34;161;166;327;SEC_322
2006;140;35-49;107;115;222;SEC_140
2006;134;25-34;99;115;214;SEC_134
2006;221;75 i +;50;39;89;SEC_221
2006;307;03-11;31;31;62;SEC_307
2006;624;50-64;159;129;288;SEC_624
2006;425;18-24;35;39;74;SEC_425
2006;216;25-34;110;123;233;SEC_216
2006;312;25-34;157;156;313;SEC_312
2006;126;16-17;3;4;7;SEC_126
2006;432;12-15;23;24;47;SEC_432
2006;602;03-11;14;22;36;SEC_602
2006;537;35-49;135;139;274;SEC_537
2006;423;12-15;15;13;28;SEC_423
2006;614;50-64;118;100;218;SEC_614
2006;618;18-24;22;18;40;SEC_618
2006;525;00-02;13;12;25;SEC_525
2006;601;75 i +;58;37;95;SEC_601
2006;631;65-74;58;51;109;SEC_631
2006;323;50-64;341;340;681;SEC_323
2006;209;03-11;29;31;60;SEC_209
2006;504;18-24;31;48;79;SEC_504
2006;243;00-02;18;28;46;SEC_243
2006;531;65-74;50;47;97;SEC_531
2006;522;25-34;80;114;194;SEC_522
2006;602;75 i +;21;13;34;SEC_602
2006;112;75 i +;69;35;104;SEC_112
2006;221;35-49;127;125;252;SEC_221
2006;530;75 i +;91;53;144;SEC_530
2006;137;75 i +;52;25;77;SEC_137
2006;608;00-02;9;10;19;SEC_608
2006;532;18-24;72;64;136;SEC_532
2006;322;16-17;9;8;17;SEC_322
2006;130;12-15;14;14;28;SEC_130
2006;203;00-02;15;14;29;SEC_203
2006;405;65-74;92;67;159;SEC_405
2006;419;18-24;53;46;99;SEC_419
2006;135;12-15;25;13;38;SEC_135
2006;538;50-64;105;83;188;SEC_538
2006;628;50-64;134;110;244;SEC_628
2006;243;18-24;65;51;116;SEC_243
2006;139;25-34;94;101;195;SEC_139
2006;118;35-49;188;169;357;SEC_118
2006;232;18-24;39;42;81;SEC_232
2006;216;50-64;140;112;252;SEC_216
2006;230;25-34;105;110;215;SEC_230
2006;628;12-15;18;15;33;SEC_628
2006;101;75 i +;40;32;72;SEC_101
2006;625;35-49;140;114;254;SEC_625
2006;537;16-17;13;8;21;SEC_537
2006;211;12-15;16;24;40;SEC_211
2006;619;65-74;104;95;199;SEC_619
2006;425;16-17;8;7;15;SEC_425
2006;521;03-11;25;34;59;SEC_521
2006;514;75 i +;30;18;48;SEC_514
2006;233;12-15;12;13;25;SEC_233
2006;246;25-34;129;138;267;SEC_246
2006;211;75 i +;89;44;133;SEC_211
2006;317;00-02;18;17;35;SEC_317
2006;426;35-49;126;120;246;SEC_426
2006;117;16-17;22;12;34;SEC_117
2006;601;00-02;14;21;35;SEC_601
2006;305;03-11;63;47;110;SEC_305
2006;409;50-64;55;64;119;SEC_409
2006;519;03-11;30;34;64;SEC_519
2006;432;18-24;48;64;112;SEC_432
2006;502;18-24;74;68;142;SEC_502
2006;609;35-49;81;76;157;SEC_609
2006;624;16-17;8;7;15;SEC_624
2006;219;25-34;121;143;264;SEC_219
2006;220;35-49;108;112;220;SEC_220
2006;427;03-11;35;46;81;SEC_427
2006;507;16-17;10;9;19;SEC_507
2006;437;12-15;16;21;37;SEC_437
2006;429;18-24;24;32;56;SEC_429
2006;608;50-64;84;67;151;SEC_608
2006;123;50-64;117;109;226;SEC_123
2006;216;12-15;22;17;39;SEC_216
2006;402;03-11;33;30;63;SEC_402
2006;321;35-49;266;256;522;SEC_321
2006;105;00-02;24;17;41;SEC_105
2006;506;03-11;67;63;130;SEC_506
2006;234;35-49;105;110;215;SEC_234
2006;434;75 i +;58;26;84;SEC_434
2006;111;18-24;32;30;62;SEC_111
2006;526;50-64;63;54;117;SEC_526
2006;210;03-11;25;23;48;SEC_210
2006;105;18-24;47;52;99;SEC_105
2006;215;16-17;5;3;8;SEC_215
2006;531;18-24;34;51;85;SEC_531
2006;511;18-24;21;22;43;SEC_511
2006;311;75 i +;96;51;147;SEC_311
2006;525;12-15;11;15;26;SEC_525
2006;233;35-49;101;117;218;SEC_233
2006;244;16-17;3;5;8;SEC_244
2006;324;18-24;40;39;79;SEC_324
2006;605;50-64;74;43;117;SEC_605
2006;102;35-49;161;183;344;SEC_102
2006;436;35-49;99;132;231;SEC_436
2006;320;16-17;12;7;19;SEC_320
2006;413;12-15;19;11;30;SEC_413
2006;631;35-49;93;103;196;SEC_631
2006;615;16-17;4;6;10;SEC_615
2006;513;03-11;32;22;54;SEC_513
2006;434;65-74;40;14;54;SEC_434
2006;416;35-49;82;100;182;SEC_416
2006;247;35-49;143;168;311;SEC_247
2006;122;18-24;39;24;63;SEC_122
2006;106;00-02;26;25;51;SEC_106
2006;229;75 i +;57;32;89;SEC_229
2006;116;12-15;31;20;51;SEC_116
2006;225;50-64;54;35;89;SEC_225
2006;248;65-74;51;49;100;SEC_248
2006;101;16-17;6;13;19;SEC_101
2006;519;50-64;38;36;74;SEC_519
2006;428;75 i +;33;22;55;SEC_428
2006;323;16-17;31;30;61;SEC_323
2006;101;50-64;128;118;246;SEC_101
2006;112;00-02;24;22;46;SEC_112
2006;310;75 i +;40;26;66;SEC_310
2006;407;75 i +;71;49;120;SEC_407
2006;105;75 i +;60;33;93;SEC_105
2006;231;03-11;45;36;81;SEC_231
2006;109;00-02;15;13;28;SEC_109
2006;130;25-34;84;79;163;SEC_130
2006;138;16-17;6;7;13;SEC_138
2006;513;35-49;72;85;157;SEC_513
2006;620;03-11;13;29;42;SEC_620
2006;110;50-64;181;149;330;SEC_110
2006;515;18-24;39;42;81;SEC_515
2006;203;35-49;101;104;205;SEC_203
2006;411;25-34;70;84;154;SEC_411
2006;532;35-49;147;155;302;SEC_532
2006;625;25-34;106;109;215;SEC_625
2006;508;18-24;31;24;55;SEC_508
2006;629;35-49;62;59;121;SEC_629
2006;432;25-34;116;132;248;SEC_432
2006;405;18-24;32;18;50;SEC_405
2006;205;16-17;8;10;18;SEC_205
2006;119;00-02;15;13;28;SEC_119
2006;609;25-34;73;82;155;SEC_609
2006;226;03-11;41;35;76;SEC_226
2006;420;35-49;167;184;351;SEC_420
2006;242;50-64;92;91;183;SEC_242
2006;236;16-17;8;11;19;SEC_236
2006;421;00-02;17;11;28;SEC_421
2006;421;65-74;90;61;151;SEC_421
2006;512;65-74;61;59;120;SEC_512
2006;317;25-34;124;137;261;SEC_317
2006;321;12-15;34;44;78;SEC_321
2006;206;65-74;59;37;96;SEC_206
2006;230;18-24;49;40;89;SEC_230
2006;208;03-11;39;45;84;SEC_208
2006;137;16-17;20;11;31;SEC_137
2006;514;00-02;11;12;23;SEC_514
2006;604;03-11;22;28;50;SEC_604
2006;440;03-11;36;38;74;SEC_440
2006;423;50-64;86;72;158;SEC_423
2006;316;00-02;21;15;36;SEC_316
2006;111;12-15;14;13;27;SEC_111
2006;113;65-74;47;41;88;SEC_113
2006;306;75 i +;98;64;162;SEC_306
2006;306;16-17;15;16;31;SEC_306
2006;128;03-11;24;30;54;SEC_128
2006;605;12-15;6;2;8;SEC_605
2006;421;35-49;123;144;267;SEC_421
2006;121;50-64;33;37;70;SEC_121
2006;304;16-17;10;12;22;SEC_304
2006;518;16-17;13;10;23;SEC_518
2006;136;25-34;133;123;256;SEC_136
2006;419;35-49;101;134;235;SEC_419
2006;533;16-17;10;9;19;SEC_533
2006;415;50-64;55;49;104;SEC_415
2006;532;25-34;166;158;324;SEC_532
2006;435;00-02;15;21;36;SEC_435
2006;406;35-49;150;159;309;SEC_406
2006;231;35-49;129;123;252;SEC_231
2006;235;18-24;63;73;136;SEC_235
2006;631;12-15;18;14;32;SEC_631
2006;107;00-02;17;31;48;SEC_107
2006;130;16-17;4;16;20;SEC_130
2006;228;25-34;81;97;178;SEC_228
2006;127;75 i +;35;26;61;SEC_127
2006;439;16-17;9;12;21;SEC_439
2006;618;75 i +;27;15;42;SEC_618
2006;306;03-11;55;55;110;SEC_306
2006;106;75 i +;59;31;90;SEC_106
2006;248;16-17;13;10;23;SEC_248
2006;110;65-74;63;49;112;SEC_110
2006;624;25-34;89;118;207;SEC_624
2006;525;03-11;31;31;62;SEC_525
2006;615;50-64;135;84;219;SEC_615
2006;433;25-34;139;167;306;SEC_433
2006;423;35-49;106;124;230;SEC_423
2006;534;75 i +;56;35;91;SEC_534
2006;230;03-11;38;34;72;SEC_230
2006;140;16-17;7;3;10;SEC_140
2006;315;16-17;13;21;34;SEC_315
2006;205;75 i +;63;34;97;SEC_205
2006;527;03-11;60;35;95;SEC_527
2006;520;25-34;66;78;144;SEC_520
2006;108;18-24;44;46;90;SEC_108
2006;513;00-02;10;12;22;SEC_513
2006;538;16-17;10;12;22;SEC_538
2006;227;25-34;69;64;133;SEC_227
2006;319;35-49;198;208;406;SEC_319
2006;537;25-34;113;125;238;SEC_537
2006;614;35-49;94;100;194;SEC_614
2006;204;50-64;43;32;75;SEC_204
2006;115;00-02;13;18;31;SEC_115
2006;246;16-17;9;14;23;SEC_246
2006;117;25-34;147;177;324;SEC_117
2006;322;65-74;53;47;100;SEC_322
2006;119;35-49;117;115;232;SEC_119
2006;111;25-34;78;86;164;SEC_111
2006;220;00-02;14;12;26;SEC_220
2006;125;35-49;145;188;333;SEC_125
2006;421;16-17;6;10;16;SEC_421
2006;126;25-34;100;94;194;SEC_126
2006;632;65-74;62;54;116;SEC_632
2006;108;50-64;127;117;244;SEC_108
2006;120;03-11;60;72;132;SEC_120
2006;424;35-49;55;73;128;SEC_424
2006;407;35-49;111;145;256;SEC_407
2006;614;25-34;58;94;152;SEC_614
2006;607;18-24;30;41;71;SEC_607
2006;307;16-17;8;16;24;SEC_307
2006;305;65-74;57;59;116;SEC_305
2006;315;50-64;148;145;293;SEC_315
2006;513;18-24;25;19;44;SEC_513
2006;427;16-17;9;7;16;SEC_427
2006;513;12-15;7;12;19;SEC_513
2006;111;16-17;14;3;17;SEC_111
2006;309;00-02;6;15;21;SEC_309
2006;112;12-15;33;32;65;SEC_112
2006;129;18-24;46;37;83;SEC_129
2006;441;50-64;224;223;447;SEC_441
2006;235;25-34;171;195;366;SEC_235
2006;631;25-34;86;116;202;SEC_631
2006;228;50-64;50;47;97;SEC_228
2006;406;18-24;77;60;137;SEC_406
2006;615;00-02;6;10;16;SEC_615
2006;104;03-11;42;38;80;SEC_104
2006;118;25-34;163;184;347;SEC_118
2006;321;25-34;180;158;338;SEC_321
2006;133;25-34;84;93;177;SEC_133
2006;408;03-11;32;39;71;SEC_408
2006;318;12-15;9;24;33;SEC_318
2006;325;50-64;200;183;383;SEC_325
2006;407;03-11;38;34;72;SEC_407
2006;213;35-49;123;123;246;SEC_213
2006;306;00-02;24;18;42;SEC_306
2006;416;03-11;37;34;71;SEC_416
2006;409;18-24;31;43;74;SEC_409
2006;436;75 i +;31;20;51;SEC_436
2006;502;75 i +;121;64;185;SEC_502
2006;229;35-49;104;106;210;SEC_229
2006;139;00-02;12;13;25;SEC_139
2006;127;18-24;42;37;79;SEC_127
2006;239;16-17;12;7;19;SEC_239
2006;109;50-64;119;130;249;SEC_109
2006;626;35-49;83;99;182;SEC_626
2006;505;50-64;191;140;331;SEC_505
2006;629;12-15;7;5;12;SEC_629
2006;436;65-74;35;19;54;SEC_436
2006;129;16-17;7;12;19;SEC_129
2006;316;18-24;174;171;345;SEC_316
2006;303;25-34;144;167;311;SEC_303
2006;229;25-34;73;80;153;SEC_229
2006;248;50-64;89;83;172;SEC_248
2006;127;35-49;101;100;201;SEC_127
2006;438;25-34;91;90;181;SEC_438
2006;602;50-64;56;37;93;SEC_602
2006;325;03-11;74;68;142;SEC_325
2006;611;25-34;175;184;359;SEC_611
2006;529;03-11;31;44;75;SEC_529
2006;121;12-15;18;16;34;SEC_121
2006;626;75 i +;38;37;75;SEC_626
2006;620;25-34;46;41;87;SEC_620
2006;421;12-15;12;21;33;SEC_421
2006;217;50-64;38;42;80;SEC_217
2006;111;75 i +;43;36;79;SEC_111
2006;244;65-74;36;21;57;SEC_244
2006;231;25-34;108;129;237;SEC_231
2006;535;16-17;8;15;23;SEC_535
2006;308;18-24;74;80;154;SEC_308
2006;203;65-74;38;29;67;SEC_203
2006;307;65-74;68;58;126;SEC_307
2006;319;00-02;37;39;76;SEC_319
2006;213;75 i +;49;25;74;SEC_213
2006;430;12-15;16;12;28;SEC_430
2006;415;65-74;26;27;53;SEC_415
2006;430;75 i +;56;36;92;SEC_430
2006;103;16-17;4;3;7;SEC_103
2006;401;18-24;59;71;130;SEC_401
2006;222;50-64;74;69;143;SEC_222
2006;433;16-17;16;9;25;SEC_433
2006;239;12-15;13;19;32;SEC_239
2006;219;35-49;153;173;326;SEC_219
2006;113;00-02;20;28;48;SEC_113
2006;123;16-17;12;14;26;SEC_123
2006;228;00-02;9;19;28;SEC_228
2006;206;00-02;8;17;25;SEC_206
2006;622;65-74;35;29;64;SEC_622
2006;403;18-24;64;52;116;SEC_403
2006;512;12-15;21;10;31;SEC_512
2006;219;12-15;24;13;37;SEC_219
2006;510;00-02;9;14;23;SEC_510
2006;536;16-17;9;4;13;SEC_536
2006;244;75 i +;51;35;86;SEC_244
2006;233;03-11;23;36;59;SEC_233
2006;238;18-24;28;41;69;SEC_238
2006;613;00-02;13;18;31;SEC_613
2006;617;12-15;15;16;31;SEC_617
2006;509;18-24;45;47;92;SEC_509
2006;614;65-74;66;63;129;SEC_614
2006;230;12-15;17;20;37;SEC_230
2006;416;50-64;55;52;107;SEC_416
2006;236;18-24;57;47;104;SEC_236
2006;307;25-34;118;112;230;SEC_307
2006;621;12-15;32;22;54;SEC_621
2006;513;75 i +;41;20;61;SEC_513
2006;106;25-34;178;188;366;SEC_106
2006;226;35-49;134;147;281;SEC_226
2006;231;00-02;18;25;43;SEC_231
2006;139;35-49;98;120;218;SEC_139
2006;105;35-49;155;130;285;SEC_105
2006;414;35-49;102;112;214;SEC_414
2006;238;35-49;109;120;229;SEC_238
2006;225;18-24;32;28;60;SEC_225
2006;421;18-24;24;32;56;SEC_421
2006;119;16-17;10;12;22;SEC_119
2006;525;18-24;44;39;83;SEC_525
2006;435;16-17;17;12;29;SEC_435
2006;247;18-24;62;59;121;SEC_247
2006;211;03-11;48;57;105;SEC_211
2006;214;50-64;52;39;91;SEC_214
2006;409;00-02;13;6;19;SEC_409
2006;319;50-64;138;132;270;SEC_319
2006;435;35-49;110;148;258;SEC_435
2006;309;03-11;31;54;85;SEC_309
2006;305;00-02;26;17;43;SEC_305
2006;411;65-74;70;57;127;SEC_411
2006;415;12-15;9;18;27;SEC_415
2006;235;00-02;35;23;58;SEC_235
2006;417;50-64;54;56;110;SEC_417
2006;506;18-24;69;76;145;SEC_506
2006;313;65-74;89;79;168;SEC_313
2006;619;18-24;46;57;103;SEC_619
2006;233;25-34;89;101;190;SEC_233
2006;249;18-24;47;52;99;SEC_249
2006;216;35-49;138;143;281;SEC_216
2006;611;12-15;43;28;71;SEC_611
2006;619;03-11;32;45;77;SEC_619
2006;115;18-24;40;47;87;SEC_115
2006;526;18-24;18;33;51;SEC_526
2006;442;12-15;8;10;18;SEC_442
2006;526;12-15;14;17;31;SEC_526
2006;203;25-34;88;112;200;SEC_203
2006;527;12-15;20;20;40;SEC_527
2006;239;18-24;37;51;88;SEC_239
2006;524;03-11;51;47;98;SEC_524
2006;628;75 i +;40;27;67;SEC_628
2006;137;03-11;47;56;103;SEC_137
2006;434;00-02;8;8;16;SEC_434
2006;626;16-17;12;5;17;SEC_626
2006;520;12-15;15;12;27;SEC_520
2006;128;00-02;9;11;20;SEC_128
2006;105;65-74;35;33;68;SEC_105
2006;518;65-74;84;72;156;SEC_518
2006;616;50-64;235;242;477;SEC_616
2006;611;18-24;64;57;121;SEC_611
2006;237;18-24;65;60;125;SEC_237
2006;614;18-24;26;39;65;SEC_614
2006;226;50-64;89;82;171;SEC_226
2006;107;12-15;16;27;43;SEC_107
2006;414;25-34;95;84;179;SEC_414
2006;107;65-74;100;87;187;SEC_107
2006;136;18-24;45;38;83;SEC_136
2006;601;35-49;131;153;284;SEC_601
2006;320;75 i +;33;15;48;SEC_320
2006;520;03-11;25;40;65;SEC_520
2006;204;16-17;8;6;14;SEC_204
2006;312;00-02;17;21;38;SEC_312
2006;537;65-74;71;69;140;SEC_537
2006;236;35-49;123;132;255;SEC_236
2006;404;65-74;82;65;147;SEC_404
2006;308;65-74;95;83;178;SEC_308
2006;626;18-24;28;27;55;SEC_626
2006;122;16-17;10;1;11;SEC_122
2006;403;35-49;100;115;215;SEC_403
2006;209;75 i +;81;53;134;SEC_209
2006;314;35-49;317;282;599;SEC_314
2006;606;12-15;20;16;36;SEC_606
2006;410;50-64;173;159;332;SEC_410
2006;508;50-64;37;36;73;SEC_508
2006;304;18-24;47;64;111;SEC_304
2006;310;03-11;29;37;66;SEC_310
2006;516;65-74;44;30;74;SEC_516
2006;116;65-74;71;73;144;SEC_116
2006;418;35-49;146;161;307;SEC_418
2006;442;00-02;14;6;20;SEC_442
2006;506;00-02;14;23;37;SEC_506
2006;439;03-11;46;53;99;SEC_439
2006;536;03-11;36;26;62;SEC_536
2006;429;12-15;9;13;22;SEC_429
2006;208;16-17;11;13;24;SEC_208
2006;237;25-34;150;156;306;SEC_237
2006;221;03-11;40;35;75;SEC_221
2006;101;12-15;29;31;60;SEC_101
2006;410;12-15;29;23;52;SEC_410
2006;414;50-64;70;61;131;SEC_414
2006;413;25-34;44;57;101;SEC_413
2006;420;18-24;64;73;137;SEC_420
2006;625;16-17;18;15;33;SEC_625
2006;412;12-15;26;25;51;SEC_412
2006;318;18-24;47;42;89;SEC_318
2006;111;50-64;98;78;176;SEC_111
2006;120;16-17;22;16;38;SEC_120
2006;130;03-11;39;40;79;SEC_130
2006;624;00-02;5;15;20;SEC_624
2006;305;50-64;144;151;295;SEC_305
2006;109;25-34;78;71;149;SEC_109
2006;412;00-02;23;14;37;SEC_412
2006;136;75 i +;64;44;108;SEC_136
2006;422;00-02;16;23;39;SEC_422
2006;526;65-74;30;36;66;SEC_526
2006;205;25-34;89;74;163;SEC_205
2006;126;03-11;36;35;71;SEC_126
2006;226;75 i +;87;53;140;SEC_226
2006;247;25-34;124;126;250;SEC_247
2006;535;65-74;55;68;123;SEC_535
2006;502;35-49;148;160;308;SEC_502
2006;107;03-11;52;58;110;SEC_107
2006;301;12-15;38;46;84;SEC_301
2006;421;03-11;34;32;66;SEC_421
2006;407;00-02;6;12;18;SEC_407
2006;311;35-49;151;176;327;SEC_311
2006;227;00-02;11;6;17;SEC_227
2006;107;25-34;160;180;340;SEC_107
2006;412;65-74;104;104;208;SEC_412
2006;622;18-24;30;41;71;SEC_622
2006;422;03-11;46;46;92;SEC_422
2006;125;00-02;28;27;55;SEC_125
2006;244;03-11;22;20;42;SEC_244
2006;212;35-49;176;174;350;SEC_212
2006;321;00-02;20;30;50;SEC_321
2006;517;18-24;64;58;122;SEC_517
2006;509;00-02;12;20;32;SEC_509
2006;530;18-24;51;55;106;SEC_530
2006;115;75 i +;70;41;111;SEC_115
2006;621;25-34;130;165;295;SEC_621
2006;126;00-02;12;11;23;SEC_126
2006;610;18-24;34;46;80;SEC_610
2006;632;25-34;87;93;180;SEC_632
2006;115;35-49;142;135;277;SEC_115
2006;220;25-34;81;83;164;SEC_220
2006;317;03-11;53;37;90;SEC_317
2006;124;50-64;86;71;157;SEC_124
2006;431;25-34;158;191;349;SEC_431
2006;433;18-24;75;48;123;SEC_433
2006;120;75 i +;62;26;88;SEC_120
2006;609;65-74;42;45;87;SEC_609
2006;436;00-02;16;20;36;SEC_436
2006;518;12-15;19;24;43;SEC_518
2006;105;50-64;126;114;240;SEC_105
2006;123;00-02;13;13;26;SEC_123
2006;403;16-17;7;10;17;SEC_403
2006;223;18-24;46;55;101;SEC_223
2006;313;75 i +;69;44;113;SEC_313
2006;501;16-17;10;8;18;SEC_501
2006;606;18-24;42;51;93;SEC_606
2006;525;75 i +;45;33;78;SEC_525
2006;603;35-49;49;66;115;SEC_603
2006;101;35-49;220;225;445;SEC_101
2006;612;25-34;90;95;185;SEC_612
2006;320;50-64;98;102;200;SEC_320
2006;413;65-74;36;28;64;SEC_413
2006;517;12-15;18;25;43;SEC_517
2006;415;18-24;34;50;84;SEC_415
2006;112;03-11;54;57;111;SEC_112
2006;304;65-74;75;62;137;SEC_304
2006;607;12-15;17;17;34;SEC_607
2006;131;16-17;12;5;17;SEC_131
2006;428;00-02;19;13;32;SEC_428
2006;510;03-11;36;35;71;SEC_510
2006;134;00-02;18;17;35;SEC_134
2006;205;65-74;59;53;112;SEC_205
2006;217;25-34;68;85;153;SEC_217
2006;113;35-49;168;173;341;SEC_113
2006;139;75 i +;34;18;52;SEC_139
2006;616;35-49;302;290;592;SEC_616
2006;221;50-64;84;85;169;SEC_221
2006;521;65-74;58;69;127;SEC_521
2006;611;00-02;27;30;57;SEC_611
2006;140;12-15;2;16;18;SEC_140
2006;116;75 i +;66;45;111;SEC_116
2006;310;16-17;6;9;15;SEC_310
2006;107;50-64;176;152;328;SEC_107
2006;441;25-34;137;161;298;SEC_441
2006;601;18-24;44;51;95;SEC_601
2006;218;16-17;3;9;12;SEC_218
2006;305;12-15;43;21;64;SEC_305
2006;535;50-64;135;119;254;SEC_535
2006;605;18-24;23;21;44;SEC_605
2006;622;25-34;70;83;153;SEC_622
2006;503;25-34;76;83;159;SEC_503
2006;319;16-17;7;10;17;SEC_319
2006;218;25-34;78;105;183;SEC_218
2006;217;12-15;11;10;21;SEC_217
2006;134;03-11;38;51;89;SEC_134
2006;435;03-11;41;42;83;SEC_435
2006;435;12-15;15;18;33;SEC_435
2006;607;75 i +;48;27;75;SEC_607
2006;506;16-17;16;20;36;SEC_506
2006;611;03-11;57;63;120;SEC_611
2006;429;00-02;7;7;14;SEC_429
2006;238;16-17;6;8;14;SEC_238
2006;135;75 i +;57;39;96;SEC_135
2006;603;65-74;31;33;64;SEC_603
2006;138;03-11;31;19;50;SEC_138
2006;617;03-11;35;45;80;SEC_617
2006;245;75 i +;66;35;101;SEC_245
2006;104;50-64;72;57;129;SEC_104
2006;608;65-74;69;50;119;SEC_608
2006;325;16-17;12;15;27;SEC_325
2006;536;65-74;55;49;104;SEC_536
2006;111;00-02;7;14;21;SEC_111
2006;124;18-24;41;37;78;SEC_124
2006;521;25-34;72;108;180;SEC_521
2006;133;03-11;25;39;64;SEC_133
2006;621;18-24;51;76;127;SEC_621
2006;437;18-24;42;40;82;SEC_437
2006;530;50-64;103;80;183;SEC_530
2006;504;03-11;25;35;60;SEC_504
2006;301;25-34;272;264;536;SEC_301
2006;405;25-34;84;78;162;SEC_405
2006;124;03-11;27;24;51;SEC_124
2006;532;50-64;121;90;211;SEC_532
2006;233;50-64;61;53;114;SEC_233
2006;618;25-34;37;43;80;SEC_618
2006;116;50-64;180;147;327;SEC_116
2006;201;35-49;67;90;157;SEC_201
2006;103;00-02;12;8;20;SEC_103
2006;423;25-34;112;145;257;SEC_423
2006;233;00-02;7;15;22;SEC_233
2006;109;03-11;37;33;70;SEC_109
2006;428;65-74;32;21;53;SEC_428
2006;315;18-24;59;71;130;SEC_315
2006;115;65-74;60;45;105;SEC_115
2006;236;50-64;93;85;178;SEC_236
2006;528;50-64;89;81;170;SEC_528
2006;245;12-15;18;20;38;SEC_245
2006;418;25-34;114;149;263;SEC_418
2006;138;00-02;10;7;17;SEC_138
2006;408;50-64;85;71;156;SEC_408
2006;622;03-11;23;41;64;SEC_622
2006;214;18-24;31;41;72;SEC_214
2006;517;03-11;53;62;115;SEC_517
2006;131;18-24;62;53;115;SEC_131
2006;320;18-24;33;30;63;SEC_320
2006;206;12-15;12;15;27;SEC_206
2006;210;75 i +;96;47;143;SEC_210
2006;416;18-24;28;27;55;SEC_416
2006;105;03-11;30;47;77;SEC_105
2006;117;50-64;223;221;444;SEC_117
2006;223;65-74;62;53;115;SEC_223
2006;214;65-74;37;30;67;SEC_214
2006;137;18-24;60;60;120;SEC_137
2006;232;12-15;13;11;24;SEC_232
2006;430;16-17;5;8;13;SEC_430
2006;129;65-74;53;59;112;SEC_129
2006;526;75 i +;35;20;55;SEC_526
2006;318;16-17;15;8;23;SEC_318
2006;207;35-49;81;74;155;SEC_207
2006;313;16-17;20;14;34;SEC_313
2006;234;03-11;28;29;57;SEC_234
2006;105;12-15;16;32;48;SEC_105
2006;139;18-24;31;42;73;SEC_139
2006;248;25-34;118;154;272;SEC_248
2006;519;65-74;43;32;75;SEC_519
2006;411;03-11;27;24;51;SEC_411
2006;133;00-02;15;11;26;SEC_133
2006;522;50-64;58;55;113;SEC_522
2006;131;50-64;183;172;355;SEC_131
2006;312;50-64;172;148;320;SEC_312
2006;503;65-74;33;26;59;SEC_503
2006;128;35-49;109;94;203;SEC_128
2006;509;12-15;12;19;31;SEC_509
2006;527;65-74;56;41;97;SEC_527
2006;623;12-15;12;31;43;SEC_623
2006;437;75 i +;36;20;56;SEC_437
2006;442;16-17;6;7;13;SEC_442
2006;116;25-34;125;131;256;SEC_116
2006;123;18-24;46;37;83;SEC_123
2006;507;75 i +;36;18;54;SEC_507
2006;405;16-17;9;8;17;SEC_405
2006;609;03-11;32;32;64;SEC_609
2006;106;65-74;63;41;104;SEC_106
2006;437;16-17;8;10;18;SEC_437
2006;437;35-49;102;107;209;SEC_437
2006;609;00-02;14;11;25;SEC_609
2006;441;16-17;25;30;55;SEC_441
2006;627;75 i +;36;20;56;SEC_627
2006;303;75 i +;86;65;151;SEC_303
2006;231;16-17;6;6;12;SEC_231
2006;130;35-49;117;133;250;SEC_130
2006;140;65-74;68;52;120;SEC_140
2006;136;50-64;118;111;229;SEC_136
2006;108;12-15;19;27;46;SEC_108
2006;420;03-11;54;67;121;SEC_420
2006;517;65-74;69;59;128;SEC_517
2006;522;18-24;45;46;91;SEC_522
2006;624;12-15;12;19;31;SEC_624
2006;211;00-02;22;17;39;SEC_211
2006;308;50-64;197;189;386;SEC_308
2006;433;65-74;46;38;84;SEC_433
2006;126;35-49;77;81;158;SEC_126
2006;102;00-02;14;25;39;SEC_102
2006;244;12-15;11;8;19;SEC_244
2006;606;16-17;8;8;16;SEC_606
2006;309;50-64;74;75;149;SEC_309
2006;221;16-17;14;11;25;SEC_221
2006;242;35-49;123;119;242;SEC_242
2006;222;18-24;48;51;99;SEC_222
2006;424;50-64;61;52;113;SEC_424
2006;314;50-64;222;231;453;SEC_314
2006;215;12-15;16;16;32;SEC_215
2006;629;25-34;31;48;79;SEC_629
2006;118;16-17;25;16;41;SEC_118
2006;507;50-64;82;79;161;SEC_507
2006;119;75 i +;69;48;117;SEC_119
2006;518;03-11;50;44;94;SEC_518
2006;432;65-74;75;60;135;SEC_432
2006;132;35-49;214;255;469;SEC_132
2006;206;50-64;66;66;132;SEC_206
2006;101;03-11;84;60;144;SEC_101
2006;222;25-34;100;125;225;SEC_222
2006;207;25-34;63;72;135;SEC_207
2006;232;35-49;114;97;211;SEC_232
2006;126;75 i +;56;28;84;SEC_126
2006;527;75 i +;52;26;78;SEC_527
2006;604;16-17;7;11;18;SEC_604
2006;625;12-15;18;26;44;SEC_625
2006;608;35-49;87;89;176;SEC_608
2006;242;12-15;18;15;33;SEC_242
2006;319;12-15;22;26;48;SEC_319
2006;244;00-02;8;10;18;SEC_244
2006;245;00-02;12;13;25;SEC_245
2006;323;35-49;344;352;696;SEC_323
2006;432;00-02;14;11;25;SEC_432
2006;140;00-02;9;14;23;SEC_140
2006;309;65-74;35;25;60;SEC_309
2006;224;16-17;3;5;8;SEC_224
2006;235;16-17;11;13;24;SEC_235
2006;529;35-49;150;147;297;SEC_529
2006;442;35-49;78;72;150;SEC_442
2006;306;25-34;124;141;265;SEC_306
2006;301;75 i +;93;63;156;SEC_301
2006;522;65-74;33;36;69;SEC_522
2006;248;00-02;14;13;27;SEC_248
2006;606;65-74;74;68;142;SEC_606
2006;408;65-74;51;42;93;SEC_408
2006;436;25-34;125;145;270;SEC_436
2006;316;16-17;28;29;57;SEC_316
2006;232;75 i +;64;32;96;SEC_232
2006;519;75 i +;25;25;50;SEC_519
2006;516;25-34;69;91;160;SEC_516
2006;523;75 i +;100;49;149;SEC_523
2006;138;25-34;67;53;120;SEC_138
2006;407;65-74;68;53;121;SEC_407
2006;114;35-49;163;160;323;SEC_114
2006;522;35-49;104;92;196;SEC_522
2006;107;75 i +;68;36;104;SEC_107
2006;521;16-17;5;4;9;SEC_521
2006;127;50-64;71;64;135;SEC_127
2006;628;65-74;46;62;108;SEC_628
2006;133;35-49;87;97;184;SEC_133
2006;527;35-49;134;143;277;SEC_527
2006;310;35-49;118;99;217;SEC_310
2006;203;75 i +;49;29;78;SEC_203
2006;526;25-34;72;83;155;SEC_526
2006;406;65-74;76;69;145;SEC_406
2006;625;00-02;13;19;32;SEC_625
2006;217;03-11;21;32;53;SEC_217
2006;241;50-64;48;57;105;SEC_241
2006;230;50-64;42;36;78;SEC_230
2006;534;65-74;64;54;118;SEC_534
2006;524;65-74;79;56;135;SEC_524
2006;413;50-64;40;36;76;SEC_413
2006;225;25-34;39;62;101;SEC_225
2006;125;65-74;46;62;108;SEC_125
2006;132;18-24;90;102;192;SEC_132
2006;211;50-64;76;72;148;SEC_211
2006;414;12-15;23;11;34;SEC_414
2006;531;35-49;102;121;223;SEC_531
2006;204;75 i +;42;18;60;SEC_204
2006;213;65-74;47;46;93;SEC_213
2006;225;12-15;7;9;16;SEC_225
2006;236;65-74;66;48;114;SEC_236
2006;614;00-02;14;9;23;SEC_614
2006;426;50-64;68;66;134;SEC_426
2006;317;75 i +;64;24;88;SEC_317
2006;218;65-74;35;28;63;SEC_218
2006;614;12-15;15;14;29;SEC_614
2006;501;65-74;34;31;65;SEC_501
2006;609;75 i +;29;24;53;SEC_609
2006;529;18-24;52;50;102;SEC_529
2006;104;18-24;21;22;43;SEC_104
2006;529;16-17;7;17;24;SEC_529
2006;420;65-74;77;65;142;SEC_420
2006;115;50-64;122;135;257;SEC_115
2006;441;03-11;70;57;127;SEC_441
2006;528;25-34;130;132;262;SEC_528
2006;242;18-24;41;59;100;SEC_242
2006;310;65-74;40;31;71;SEC_310
2006;428;18-24;40;30;70;SEC_428
2006;538;75 i +;70;38;108;SEC_538
2006;630;65-74;34;37;71;SEC_630
2006;404;00-02;22;21;43;SEC_404
2006;322;03-11;46;57;103;SEC_322
2006;611;35-49;194;237;431;SEC_611
2006;602;12-15;4;9;13;SEC_602
2006;418;12-15;20;20;40;SEC_418
2006;224;50-64;40;50;90;SEC_224
2006;524;18-24;53;54;107;SEC_524
2006;210;00-02;14;5;19;SEC_210
2006;432;50-64;156;158;314;SEC_432
2006;228;03-11;15;19;34;SEC_228
2006;614;75 i +;40;27;67;SEC_614
2006;136;12-15;15;19;34;SEC_136
2006;304;50-64;110;106;216;SEC_304
2006;315;75 i +;65;33;98;SEC_315
2006;602;00-02;5;5;10;SEC_602
2006;522;03-11;40;41;81;SEC_522
2006;408;12-15;13;14;27;SEC_408
2006;206;25-34;92;119;211;SEC_206
2006;536;75 i +;65;49;114;SEC_536
2006;126;12-15;12;6;18;SEC_126
2006;301;00-02;38;47;85;SEC_301
2006;431;75 i +;86;42;128;SEC_431
2006;325;35-49;205;184;389;SEC_325
2006;618;35-49;70;66;136;SEC_618
2006;413;03-11;22;20;42;SEC_413
2006;537;50-64;138;105;243;SEC_537
2006;232;50-64;86;88;174;SEC_232
2006;133;65-74;44;38;82;SEC_133
2006;528;65-74;61;61;122;SEC_528
2006;432;35-49;117;122;239;SEC_432
2006;204;25-34;50;68;118;SEC_204
2006;111;65-74;55;48;103;SEC_111
2006;116;18-24;60;54;114;SEC_116
2006;248;03-11;52;49;101;SEC_248
2006;303;12-15;16;18;34;SEC_303
2006;605;00-02;10;5;15;SEC_605
2006;134;35-49;153;146;299;SEC_134
2006;414;00-02;14;15;29;SEC_414
2006;428;35-49;78;96;174;SEC_428
2006;412;18-24;88;80;168;SEC_412
2006;403;50-64;122;91;213;SEC_403
2006;221;25-34;90;119;209;SEC_221
2006;239;00-02;18;16;34;SEC_239
2006;502;50-64;155;149;304;SEC_502
2006;231;12-15;13;18;31;SEC_231
2006;310;50-64;85;94;179;SEC_310
2006;533;75 i +;38;32;70;SEC_533
2006;524;50-64;99;85;184;SEC_524
2006;137;00-02;31;19;50;SEC_137
2006;308;00-02;35;35;70;SEC_308
2006;227;65-74;39;26;65;SEC_227
2006;442;18-24;23;26;49;SEC_442
2006;234;16-17;7;7;14;SEC_234
2006;236;00-02;7;15;22;SEC_236
2006;103;35-49;80;82;162;SEC_103
2006;201;75 i +;37;29;66;SEC_201
2006;406;25-34;112;146;258;SEC_406
2006;412;16-17;9;16;25;SEC_412
2006;506;75 i +;71;47;118;SEC_506
2006;503;16-17;3;9;12;SEC_503
2006;239;35-49;141;150;291;SEC_239
2006;436;18-24;54;47;101;SEC_436
2006;412;75 i +;70;55;125;SEC_412
2006;314;12-15;36;55;91;SEC_314
2006;117;75 i +;67;38;105;SEC_117
2006;505;00-02;9;16;25;SEC_505
2006;318;75 i +;24;13;37;SEC_318
2006;612;12-15;16;15;31;SEC_612
2006;248;18-24;53;50;103;SEC_248
2006;528;75 i +;60;42;102;SEC_528
2006;412;03-11;57;37;94;SEC_412
2006;212;50-64;101;99;200;SEC_212
2006;433;00-02;24;20;44;SEC_433
2006;408;16-17;4;10;14;SEC_408
2006;408;75 i +;47;25;72;SEC_408
2006;427;50-64;71;55;126;SEC_427
2006;102;18-24;59;44;103;SEC_102
2006;122;50-64;89;54;143;SEC_122
2006;521;12-15;11;10;21;SEC_521
2006;240;18-24;33;28;61;SEC_240
2006;243;75 i +;87;64;151;SEC_243
2006;601;65-74;85;96;181;SEC_601
2006;438;16-17;10;3;13;SEC_438
2006;303;65-74;136;130;266;SEC_303
2006;430;25-34;99;150;249;SEC_430
2006;212;65-74;65;63;128;SEC_212
2006;418;18-24;52;56;108;SEC_418
2006;412;50-64;182;163;345;SEC_412
2006;511;12-15;8;12;20;SEC_511
2006;425;65-74;64;50;114;SEC_425
2006;307;18-24;52;64;116;SEC_307
2006;530;00-02;25;14;39;SEC_530
2006;237;65-74;72;62;134;SEC_237
2006;247;00-02;15;27;42;SEC_247
2006;416;00-02;8;15;23;SEC_416
2006;505;16-17;11;6;17;SEC_505
2006;602;16-17;5;3;8;SEC_602
2006;235;35-49;166;182;348;SEC_235
2006;610;12-15;11;17;28;SEC_610
2006;506;65-74;92;97;189;SEC_506
2006;104;16-17;5;5;10;SEC_104
2006;411;50-64;98;78;176;SEC_411
2006;502;16-17;15;7;22;SEC_502
2006;315;25-34;167;187;354;SEC_315
2006;314;18-24;117;117;234;SEC_314
2006;103;75 i +;41;27;68;SEC_103
2006;501;18-24;41;49;90;SEC_501
2006;424;75 i +;20;20;40;SEC_424
2006;505;18-24;38;33;71;SEC_505
2006;422;35-49;119;148;267;SEC_422
2006;217;75 i +;46;26;72;SEC_217
2006;319;65-74;47;37;84;SEC_319
2006;608;12-15;19;18;37;SEC_608
2006;303;50-64;149;119;268;SEC_303
2006;612;75 i +;44;25;69;SEC_612
2006;112;50-64;161;160;321;SEC_112
2006;103;50-64;61;57;118;SEC_103
2006;509;35-49;87;98;185;SEC_509
2006;625;65-74;54;62;116;SEC_625
2006;308;75 i +;81;53;134;SEC_308
2006;136;00-02;27;15;42;SEC_136
2006;210;25-34;75;68;143;SEC_210
2006;233;75 i +;54;26;80;SEC_233
2006;512;75 i +;52;22;74;SEC_512
2006;604;65-74;39;36;75;SEC_604
2006;215;75 i +;65;36;101;SEC_215
2006;421;25-34;85;103;188;SEC_421
2006;620;65-74;42;42;84;SEC_620
2006;528;18-24;56;51;107;SEC_528
2006;316;12-15;41;45;86;SEC_316
2006;613;16-17;5;7;12;SEC_613
2006;133;50-64;97;84;181;SEC_133
2006;410;75 i +;110;97;207;SEC_410
2006;507;25-34;95;103;198;SEC_507
2006;520;18-24;30;27;57;SEC_520
2006;611;65-74;101;110;211;SEC_611
2006;419;12-15;14;11;25;SEC_419
2006;137;35-49;171;158;329;SEC_137
2006;108;65-74;69;50;119;SEC_108
2006;504;75 i +;65;49;114;SEC_504
2006;617;35-49;91;101;192;SEC_617
2006;612;16-17;5;11;16;SEC_612
2006;322;35-49;137;145;282;SEC_322
2006;237;03-11;48;52;100;SEC_237
2006;525;16-17;10;5;15;SEC_525
2006;431;65-74;78;59;137;SEC_431
2006;118;65-74;49;59;108;SEC_118
2006;523;18-24;61;78;139;SEC_523
2006;611;50-64;158;119;277;SEC_611
2006;314;65-74;71;73;144;SEC_314
2006;619;25-34;85;101;186;SEC_619
2006;523;35-49;154;169;323;SEC_523
2006;619;35-49;133;128;261;SEC_619
2006;312;12-15;24;19;43;SEC_312
2006;248;12-15;25;19;44;SEC_248
2006;602;18-24;19;24;43;SEC_602
2006;502;03-11;41;48;89;SEC_502
2006;235;03-11;53;68;121;SEC_235
2006;407;25-34;105;119;224;SEC_407
2006;225;75 i +;48;28;76;SEC_225
2006;230;00-02;14;7;21;SEC_230
2006;238;75 i +;66;39;105;SEC_238
2006;103;12-15;15;6;21;SEC_103
2006;414;16-17;5;4;9;SEC_414
2006;522;12-15;10;12;22;SEC_522
2006;249;03-11;31;39;70;SEC_249
2006;211;65-74;65;42;107;SEC_211
2006;601;50-64;147;117;264;SEC_601
2006;304;00-02;25;23;48;SEC_304
2006;110;75 i +;56;34;90;SEC_110
2006;204;12-15;6;9;15;SEC_204
2006;324;16-17;9;9;18;SEC_324
2006;532;16-17;7;7;14;SEC_532
2006;216;16-17;5;8;13;SEC_216
2006;512;18-24;25;36;61;SEC_512
2006;117;00-02;23;28;51;SEC_117
2006;213;50-64;81;82;163;SEC_213
2006;630;16-17;5;8;13;SEC_630
2006;440;25-34;81;93;174;SEC_440
2006;316;35-49;240;153;393;SEC_316
2006;218;75 i +;39;20;59;SEC_218
2006;610;50-64;169;128;297;SEC_610
2006;309;12-15;14;13;27;SEC_309
2006;534;16-17;5;10;15;SEC_534
2006;606;35-49;122;129;251;SEC_606
2006;243;12-15;27;35;62;SEC_243
2006;630;25-34;79;120;199;SEC_630
2006;102;65-74;96;84;180;SEC_102
2006;225;00-02;8;5;13;SEC_225
2006;230;65-74;40;36;76;SEC_230
2006;403;75 i +;67;38;105;SEC_403
2006;501;75 i +;24;13;37;SEC_501
2006;134;12-15;17;23;40;SEC_134
2006;616;75 i +;50;31;81;SEC_616
2006;621;16-17;13;14;27;SEC_621
2006;323;25-34;279;297;576;SEC_323
2006;411;00-02;11;10;21;SEC_411
2006;625;03-11;37;43;80;SEC_625
2006;631;50-64;158;122;280;SEC_631
2006;234;25-34;104;100;204;SEC_234
2006;219;16-17;9;12;21;SEC_219
2006;247;03-11;53;42;95;SEC_247
2006;223;25-34;121;113;234;SEC_223
2006;404;18-24;76;61;137;SEC_404
2006;441;00-02;17;28;45;SEC_441
2006;132;03-11;71;75;146;SEC_132
2006;204;18-24;21;30;51;SEC_204
2006;223;75 i +;65;37;102;SEC_223
2006;524;16-17;11;13;24;SEC_524
2006;533;65-74;74;51;125;SEC_533
2006;436;50-64;57;60;117;SEC_436
2006;405;03-11;31;30;61;SEC_405
2006;220;16-17;6;8;14;SEC_220
2006;604;25-34;39;74;113;SEC_604
2006;418;03-11;46;37;83;SEC_418
2006;630;75 i +;37;18;55;SEC_630
2006;511;16-17;6;3;9;SEC_511
2006;435;75 i +;104;47;151;SEC_435
2006;402;35-49;89;108;197;SEC_402
2006;116;03-11;58;59;117;SEC_116
2006;114;12-15;19;17;36;SEC_114
2006;520;50-64;79;73;152;SEC_520
2006;614;03-11;31;33;64;SEC_614
2006;235;12-15;26;14;40;SEC_235
2006;531;25-34;99;115;214;SEC_531
2006;520;16-17;11;11;22;SEC_520
2006;246;65-74;58;44;102;SEC_246
2006;307;12-15;15;25;40;SEC_307
2006;112;35-49;189;171;360;SEC_112
2006;310;18-24;46;39;85;SEC_310
2006;431;35-49;165;201;366;SEC_431
2006;224;18-24;27;27;54;SEC_224
2006;213;25-34;88;104;192;SEC_213
2006;109;12-15;16;19;35;SEC_109
2006;208;65-74;132;112;244;SEC_208
2006;421;75 i +;78;47;125;SEC_421
2006;524;35-49;148;151;299;SEC_524
2006;507;65-74;43;34;77;SEC_507
2006;626;03-11;35;45;80;SEC_626
2006;119;18-24;60;47;107;SEC_119
2006;306;65-74;84;59;143;SEC_306
2006;511;25-34;59;69;128;SEC_511
2006;213;16-17;9;5;14;SEC_213
2006;627;65-74;39;36;75;SEC_627
2006;129;50-64;112;98;210;SEC_129
2006;531;03-11;31;41;72;SEC_531
2006;301;16-17;17;18;35;SEC_301
2006;213;18-24;62;53;115;SEC_213
2006;606;75 i +;56;28;84;SEC_606
2006;323;00-02;46;49;95;SEC_323
2006;238;50-64;63;68;131;SEC_238
2006;537;03-11;42;43;85;SEC_537
2006;424;12-15;6;12;18;SEC_424
2006;104;00-02;10;16;26;SEC_104
2006;623;75 i +;55;30;85;SEC_623
2006;607;16-17;10;5;15;SEC_607
2006;231;65-74;59;50;109;SEC_231
2006;120;35-49;232;215;447;SEC_120
2006;229;50-64;67;46;113;SEC_229
2006;536;25-34;69;86;155;SEC_536
2006;528;16-17;15;7;22;SEC_528
2006;239;50-64;88;69;157;SEC_239
2006;131;75 i +;54;41;95;SEC_131
2006;503;00-02;6;6;12;SEC_503
2006;234;50-64;60;53;113;SEC_234
2006;506;50-64;248;210;458;SEC_506
2006;404;50-64;111;105;216;SEC_404
2006;409;35-49;85;87;172;SEC_409
2006;442;65-74;24;23;47;SEC_442
2006;127;16-17;13;9;22;SEC_127
2006;508;03-11;18;19;37;SEC_508
2006;220;75 i +;55;33;88;SEC_220
2006;306;35-49;180;200;380;SEC_306
2006;609;18-24;30;39;69;SEC_609
2006;604;35-49;89;101;190;SEC_604
2006;534;50-64;82;75;157;SEC_534
2006;324;12-15;11;13;24;SEC_324
2006;431;03-11;68;80;148;SEC_431
2006;109;16-17;9;6;15;SEC_109
2006;311;25-34;114;148;262;SEC_311
2006;313;00-02;28;35;63;SEC_313
2006;420;25-34;159;162;321;SEC_420
2006;114;00-02;20;18;38;SEC_114
2006;535;12-15;17;16;33;SEC_535
2006;218;35-49;85;87;172;SEC_218
2006;419;00-02;9;18;27;SEC_419
2006;222;16-17;8;9;17;SEC_222
2006;116;35-49;156;162;318;SEC_116
2006;226;12-15;16;15;31;SEC_226
2006;124;35-49;88;71;159;SEC_124
2006;214;00-02;15;11;26;SEC_214
2006;236;03-11;36;30;66;SEC_236
2006;507;12-15;11;11;22;SEC_507
2006;410;16-17;10;12;22;SEC_410
2006;131;00-02;12;21;33;SEC_131
2006;427;25-34;115;130;245;SEC_427
2006;439;18-24;58;75;133;SEC_439
2006;428;12-15;9;17;26;SEC_428
2006;102;50-64;189;169;358;SEC_102
2006;112;25-34;164;149;313;SEC_112
2006;124;25-34;75;65;140;SEC_124
2006;613;18-24;34;30;64;SEC_613
2006;401;00-02;15;14;29;SEC_401
2006;537;75 i +;74;44;118;SEC_537
2006;302;16-17;12;7;19;SEC_302
2006;301;18-24;77;85;162;SEC_301
2006;128;65-74;51;50;101;SEC_128
2006;132;75 i +;69;49;118;SEC_132
2006;324;00-02;17;12;29;SEC_324
2006;219;65-74;60;53;113;SEC_219
2006;519;25-34;73;101;174;SEC_519
2006;630;50-64;125;103;228;SEC_630
2006;306;12-15;30;23;53;SEC_306
2006;317;16-17;11;9;20;SEC_317
2006;120;18-24;79;77;156;SEC_120
2006;425;25-34;83;72;155;SEC_425
2006;201;16-17;5;5;10;SEC_201
2006;109;65-74;46;41;87;SEC_109
2006;236;12-15;25;18;43;SEC_236
2006;113;16-17;20;18;38;SEC_113
2006;533;03-11;34;30;64;SEC_533
2006;138;65-74;37;40;77;SEC_138
2006;247;12-15;26;18;44;SEC_247
2006;242;65-74;80;58;138;SEC_242
2006;212;16-17;13;13;26;SEC_212
2006;627;18-24;44;63;107;SEC_627
2006;321;50-64;291;275;566;SEC_321
2006;440;16-17;2;5;7;SEC_440
2006;426;03-11;41;35;76;SEC_426
2006;608;16-17;7;8;15;SEC_608
2006;321;16-17;23;30;53;SEC_321
2006;109;75 i +;65;35;100;SEC_109
2006;305;35-49;226;212;438;SEC_305
2006;209;25-34;83;81;164;SEC_209
2006;224;35-49;79;92;171;SEC_224
2006;240;00-02;10;6;16;SEC_240
2006;537;12-15;28;21;49;SEC_537
2006;104;35-49;93;108;201;SEC_104
2006;243;16-17;12;16;28;SEC_243
2006;512;00-02;15;18;33;SEC_512
2006;302;35-49;119;150;269;SEC_302
2006;423;65-74;62;70;132;SEC_423
2006;322;18-24;48;54;102;SEC_322
2006;535;03-11;23;38;61;SEC_535
2006;516;03-11;21;36;57;SEC_516
2006;301;50-64;201;192;393;SEC_301
2006;409;65-74;41;32;73;SEC_409
2006;403;03-11;27;26;53;SEC_403
2006;220;65-74;48;36;84;SEC_220
2006;534;03-11;27;38;65;SEC_534
2006;226;25-34;116;122;238;SEC_226
2006;413;18-24;21;30;51;SEC_413
2006;248;75 i +;74;38;112;SEC_248
2006;420;12-15;25;27;52;SEC_420
2006;508;35-49;62;85;147;SEC_508
2006;433;75 i +;44;24;68;SEC_433
2006;402;25-34;86;86;172;SEC_402
2006;130;75 i +;73;49;122;SEC_130
2006;423;00-02;21;14;35;SEC_423
2006;210;12-15;8;7;15;SEC_210
2006;101;18-24;66;53;119;SEC_101
2006;618;65-74;23;35;58;SEC_618
2006;135;18-24;77;62;139;SEC_135
2006;234;12-15;14;14;28;SEC_234
2006;538;03-11;41;53;94;SEC_538
2006;515;50-64;43;31;74;SEC_515
2006;509;16-17;7;4;11;SEC_509
2006;215;03-11;35;38;73;SEC_215
2006;440;00-02;11;6;17;SEC_440
2006;626;50-64;107;87;194;SEC_626
2006;227;75 i +;53;36;89;SEC_227
2006;241;16-17;11;9;20;SEC_241
2006;209;00-02;10;17;27;SEC_209
2006;503;75 i +;36;11;47;SEC_503
2006;510;75 i +;59;33;92;SEC_510
2006;431;00-02;24;21;45;SEC_431
2006;442;25-34;41;65;106;SEC_442
2006;111;35-49;106;100;206;SEC_111
2006;227;03-11;35;25;60;SEC_227
2006;201;65-74;58;43;101;SEC_201
2006;612;00-02;16;8;24;SEC_612
2006;121;18-24;18;25;43;SEC_121
2006;216;03-11;59;29;88;SEC_216
2006;212;12-15;21;29;50;SEC_212
2006;135;03-11;59;49;108;SEC_135
2006;222;00-02;11;13;24;SEC_222
2006;114;65-74;83;87;170;SEC_114
2006;613;12-15;15;16;31;SEC_613
2006;618;16-17;4;4;8;SEC_618
2006;309;18-24;33;34;67;SEC_309
2006;511;35-49;79;72;151;SEC_511
2006;616;00-02;35;40;75;SEC_616
2006;512;25-34;84;102;186;SEC_512
2006;433;03-11;55;61;116;SEC_433
2006;246;03-11;45;35;80;SEC_246
2006;404;03-11;54;65;119;SEC_404
2006;225;65-74;31;21;52;SEC_225
2006;601;25-34;111;117;228;SEC_601
2006;505;25-34;121;120;241;SEC_505
2006;617;25-34;92;101;193;SEC_617
2006;221;00-02;11;10;21;SEC_221
2006;530;12-15;19;19;38;SEC_530
2006;629;16-17;4;5;9;SEC_629
2006;220;03-11;30;21;51;SEC_220
2006;242;03-11;37;34;71;SEC_242
2006;626;00-02;11;11;22;SEC_626
2006;620;75 i +;14;10;24;SEC_620
2006;406;03-11;42;55;97;SEC_406
2006;118;50-64;216;206;422;SEC_118
2006;232;03-11;29;32;61;SEC_232
2006;502;25-34;148;181;329;SEC_502
2006;414;75 i +;63;41;104;SEC_414
2006;301;35-49;295;282;577;SEC_301
2006;215;18-24;45;29;74;SEC_215
2006;314;03-11;72;93;165;SEC_314
2006;624;75 i +;34;22;56;SEC_624
2006;417;03-11;13;21;34;SEC_417
2006;311;00-02;19;25;44;SEC_311
2006;243;25-34;127;132;259;SEC_243
2006;130;50-64;58;61;119;SEC_130
2006;112;18-24;66;62;128;SEC_112
2006;132;16-17;15;19;34;SEC_132
2006;307;75 i +;86;53;139;SEC_307
2006;604;50-64;66;53;119;SEC_604
2006;536;50-64;74;58;132;SEC_536
2006;237;75 i +;75;37;112;SEC_237
2006;410;18-24;56;64;120;SEC_410
2006;410;65-74;125;106;231;SEC_410
2006;309;75 i +;29;15;44;SEC_309
2006;427;12-15;10;19;29;SEC_427
2006;511;00-02;10;10;20;SEC_511
2006;127;25-34;59;72;131;SEC_127
2006;241;00-02;9;11;20;SEC_241
2006;218;50-64;81;65;146;SEC_218
2006;245;25-34;113;115;228;SEC_245
2006;538;35-49;146;132;278;SEC_538
2006;413;00-02;9;9;18;SEC_413
2006;535;18-24;52;42;94;SEC_535
2006;405;00-02;9;9;18;SEC_405
2006;204;65-74;32;29;61;SEC_204
2006;304;75 i +;105;44;149;SEC_304
2006;417;65-74;38;21;59;SEC_417
2006;127;03-11;25;26;51;SEC_127
2006;118;12-15;30;30;60;SEC_118
2006;516;12-15;11;19;30;SEC_516
2006;129;75 i +;43;25;68;SEC_129
2006;511;65-74;52;37;89;SEC_511
2006;513;65-74;58;45;103;SEC_513
2006;131;35-49;132;152;284;SEC_131
2006;510;50-64;93;84;177;SEC_510
2006;223;35-49;146;152;298;SEC_223
2006;135;35-49;191;169;360;SEC_135
2006;613;35-49;107;125;232;SEC_613
2006;140;25-34;88;115;203;SEC_140
2006;214;03-11;29;19;48;SEC_214
2006;613;03-11;41;36;77;SEC_613
2006;318;00-02;12;11;23;SEC_318
2006;632;00-02;18;14;32;SEC_632
2006;605;35-49;60;56;116;SEC_605
2006;247;65-74;63;63;126;SEC_247
2006;534;12-15;14;14;28;SEC_534
2006;241;25-34;73;74;147;SEC_241
2006;514;03-11;37;36;73;SEC_514
2006;404;75 i +;67;37;104;SEC_404
2006;232;00-02;14;9;23;SEC_232
2006;521;00-02;5;12;17;SEC_521
2006;129;25-34;124;129;253;SEC_129
2006;224;12-15;12;11;23;SEC_224
2006;320;12-15;13;11;24;SEC_320
2006;203;50-64;60;57;117;SEC_203
2006;625;18-24;69;82;151;SEC_625
2006;621;00-02;17;21;38;SEC_621
2006;424;00-02;12;7;19;SEC_424
2006;311;65-74;80;66;146;SEC_311
2006;435;25-34;113;131;244;SEC_435
2006;120;65-74;48;51;99;SEC_120
2006;117;12-15;37;31;68;SEC_117
2006;529;65-74;85;65;150;SEC_529
2006;433;50-64;71;72;143;SEC_433
2006;134;16-17;13;8;21;SEC_134
2006;309;16-17;7;5;12;SEC_309
2006;117;35-49;224;220;444;SEC_117
2006;209;35-49;120;121;241;SEC_209
2006;605;65-74;64;67;131;SEC_605
2006;424;25-34;61;71;132;SEC_424
2006;233;18-24;32;42;74;SEC_233
2006;526;35-49;81;101;182;SEC_526
2006;103;25-34;67;73;140;SEC_103
2006;618;50-64;66;42;108;SEC_618
2006;412;35-49;175;190;365;SEC_412
2006;240;75 i +;61;29;90;SEC_240
2006;605;75 i +;33;27;60;SEC_605
2006;606;03-11;38;46;84;SEC_606
2006;110;16-17;6;10;16;SEC_110
2006;317;18-24;47;48;95;SEC_317
2006;631;16-17;8;7;15;SEC_631
2006;246;00-02;20;28;48;SEC_246
2006;202;12-15;10;15;25;SEC_202
2006;604;18-24;29;32;61;SEC_604
2006;324;50-64;68;70;138;SEC_324
2006;506;25-34;132;138;270;SEC_506
2006;616;03-11;129;161;290;SEC_616
2006;215;25-34;91;101;192;SEC_215
2006;619;16-17;8;12;20;SEC_619
2006;427;65-74;51;27;78;SEC_427
2006;212;00-02;26;26;52;SEC_212
2006;226;00-02;9;16;25;SEC_226
2006;316;75 i +;69;29;98;SEC_316
2006;425;12-15;16;21;37;SEC_425
2006;524;12-15;19;25;44;SEC_524
2006;214;16-17;5;7;12;SEC_214
2006;518;75 i +;58;34;92;SEC_518
2006;125;50-64;176;161;337;SEC_125
2006;534;00-02;15;15;30;SEC_534
2006;528;35-49;136;140;276;SEC_528
2006;502;65-74;74;67;141;SEC_502
2006;405;35-49;76;97;173;SEC_405
2006;612;65-74;79;73;152;SEC_612
2006;505;03-11;28;25;53;SEC_505
2006;217;18-24;28;27;55;SEC_217
2006;241;03-11;36;22;58;SEC_241
2006;222;03-11;41;27;68;SEC_222
2006;628;18-24;38;44;82;SEC_628
2006;222;65-74;38;33;71;SEC_222
2006;133;16-17;5;9;14;SEC_133
2006;620;12-15;16;8;24;SEC_620
2006;535;75 i +;42;24;66;SEC_535
2006;519;12-15;6;20;26;SEC_519
2006;217;00-02;4;15;19;SEC_217
2006;240;65-74;49;44;93;SEC_240
2006;609;16-17;8;7;15;SEC_609
2006;220;12-15;18;20;38;SEC_220
2006;137;65-74;50;44;94;SEC_137
2006;119;12-15;12;22;34;SEC_119
2006;406;16-17;16;9;25;SEC_406
2006;314;00-02;21;29;50;SEC_314
2006;139;16-17;8;6;14;SEC_139
2006;403;25-34;85;107;192;SEC_403
2006;239;65-74;75;62;137;SEC_239
2006;121;16-17;5;7;12;SEC_121
2006;625;50-64;192;180;372;SEC_625
2006;136;16-17;10;10;20;SEC_136
2006;536;12-15;14;10;24;SEC_536
2006;420;16-17;10;11;21;SEC_420
2006;402;16-17;8;2;10;SEC_402
2006;235;50-64;118;87;205;SEC_235
2006;228;35-49;75;93;168;SEC_228
2006;125;75 i +;53;30;83;SEC_125
2006;527;00-02;21;25;46;SEC_527
2006;441;65-74;85;80;165;SEC_441
2006;201;50-64;63;42;105;SEC_201
2006;531;50-64;87;72;159;SEC_531
2006;315;65-74;53;50;103;SEC_315
2006;223;16-17;13;10;23;SEC_223
2006;538;12-15;10;13;23;SEC_538
2006;124;65-74;33;40;73;SEC_124
2006;440;12-15;17;13;30;SEC_440
2006;315;35-49;198;209;407;SEC_315
2006;439;75 i +;47;31;78;SEC_439
2006;632;12-15;11;21;32;SEC_632
2006;246;18-24;53;44;97;SEC_246
2006;140;75 i +;51;42;93;SEC_140
2006;615;18-24;23;21;44;SEC_615
2006;111;03-11;18;35;53;SEC_111
2006;113;18-24;89;92;181;SEC_113
2006;134;65-74;54;40;94;SEC_134
2006;414;03-11;31;36;67;SEC_414
2006;531;75 i +;42;30;72;SEC_531
2006;207;18-24;28;31;59;SEC_207
2006;431;18-24;75;85;160;SEC_431
2006;628;03-11;39;40;79;SEC_628
2006;415;75 i +;43;22;65;SEC_415
2006;508;16-17;4;2;6;SEC_508
2006;530;16-17;14;17;31;SEC_530
2006;214;12-15;14;8;22;SEC_214
2006;228;75 i +;47;28;75;SEC_228
2006;307;50-64;221;190;411;SEC_307
2006;201;18-24;27;29;56;SEC_201
2006;417;75 i +;30;20;50;SEC_417
2006;318;65-74;30;23;53;SEC_318
2006;221;12-15;23;20;43;SEC_221
2006;324;35-49;103;110;213;SEC_324
2006;242;16-17;7;7;14;SEC_242
2006;325;00-02;20;19;39;SEC_325
2006;604;75 i +;26;16;42;SEC_604
2006;621;03-11;49;65;114;SEC_621
2006;208;50-64;181;143;324;SEC_208
2006;137;25-34;128;133;261;SEC_137
2006;208;35-49;178;179;357;SEC_208
2006;245;35-49;129;132;261;SEC_245
2006;602;25-34;48;43;91;SEC_602
2006;224;75 i +;34;19;53;SEC_224
2006;508;12-15;11;11;22;SEC_508
2006;320;03-11;52;45;97;SEC_320
2006;510;18-24;44;46;90;SEC_510
2006;218;18-24;33;41;74;SEC_218
2006;406;75 i +;47;50;97;SEC_406
2006;314;75 i +;94;46;140;SEC_314
2006;136;03-11;44;40;84;SEC_136
2006;436;03-11;41;47;88;SEC_436
2006;209;65-74;57;50;107;SEC_209
2006;319;75 i +;41;22;63;SEC_319
2006;317;50-64;61;73;134;SEC_317
2006;622;16-17;8;8;16;SEC_622
2006;241;75 i +;67;33;100;SEC_241
2006;311;50-64;120;94;214;SEC_311
2006;243;35-49;202;198;400;SEC_243
2006;606;50-64;85;57;142;SEC_606
2006;509;75 i +;27;15;42;SEC_509
2006;422;50-64;84;72;156;SEC_422
2006;626;65-74;62;50;112;SEC_626
2006;206;35-49;99;100;199;SEC_206
2006;114;18-24;52;56;108;SEC_114
2006;628;35-49;108;90;198;SEC_628
2006;125;25-34;144;153;297;SEC_125
2006;612;03-11;28;44;72;SEC_612
2006;108;00-02;9;22;31;SEC_108
2006;228;18-24;25;36;61;SEC_228
2006;517;50-64;91;79;170;SEC_517
2006;401;25-34;103;83;186;SEC_401
2006;119;25-34;95;114;209;SEC_119
2006;441;18-24;111;107;218;SEC_441
2006;132;50-64;222;212;434;SEC_132
2006;514;50-64;57;53;110;SEC_514
2006;632;75 i +;35;20;55;SEC_632
2006;516;35-49;92;113;205;SEC_516
2006;601;12-15;27;21;48;SEC_601
2006;404;12-15;27;24;51;SEC_404
2006;410;00-02;23;26;49;SEC_410
2006;422;75 i +;79;49;128;SEC_422
2006;207;75 i +;66;29;95;SEC_207
2006;246;50-64;76;63;139;SEC_246
2006;118;03-11;61;59;120;SEC_118
2006;615;25-34;70;76;146;SEC_615
2006;113;03-11;45;70;115;SEC_113
2006;121;65-74;59;35;94;SEC_121
2006;222;35-49;93;117;210;SEC_222
2006;116;00-02;21;14;35;SEC_116
2006;629;50-64;52;44;96;SEC_629
2006;532;65-74;72;67;139;SEC_532
2006;521;35-49;69;83;152;SEC_521
2006;627;35-49;93;75;168;SEC_627
2006;415;00-02;17;11;28;SEC_415
2006;517;16-17;12;13;25;SEC_517
2006;204;03-11;12;13;25;SEC_204
2006;621;35-49;137;136;273;SEC_621
2006;103;65-74;49;32;81;SEC_103
2006;442;50-64;50;42;92;SEC_442
2006;103;18-24;28;30;58;SEC_103
2006;105;25-34;117;108;225;SEC_105
2006;211;35-49;186;217;403;SEC_211
2006;422;25-34;113;132;245;SEC_422
2006;121;35-49;105;105;210;SEC_121
2006;320;00-02;22;17;39;SEC_320
2006;436;12-15;13;15;28;SEC_436
2006;208;00-02;17;12;29;SEC_208
2006;204;35-49;64;80;144;SEC_204
2006;509;25-34;85;111;196;SEC_509
2006;229;12-15;18;22;40;SEC_229
2006;430;35-49;112;124;236;SEC_430
2006;226;65-74;60;43;103;SEC_226
2006;622;50-64;98;92;190;SEC_622
2006;535;00-02;10;6;16;SEC_535
2006;440;50-64;109;93;202;SEC_440
2006;514;35-49;84;99;183;SEC_514
2006;117;03-11;81;73;154;SEC_117
2006;122;65-74;66;68;134;SEC_122
2006;213;03-11;26;50;76;SEC_213
2006;131;25-34;131;141;272;SEC_131
2006;302;75 i +;56;33;89;SEC_302
2006;441;35-49;226;208;434;SEC_441
2006;438;18-24;39;38;77;SEC_438
2006;222;75 i +;41;22;63;SEC_222
2006;109;18-24;47;44;91;SEC_109
2006;110;35-49;115;100;215;SEC_110
2006;401;12-15;24;13;37;SEC_401
2006;428;50-64;45;31;76;SEC_428
2006;419;50-64;65;54;119;SEC_419
2006;229;16-17;5;5;10;SEC_229
2006;430;65-74;48;40;88;SEC_430
2006;242;75 i +;75;54;129;SEC_242
2006;508;75 i +;39;26;65;SEC_508
2006;223;50-64;98;79;177;SEC_223
2006;407;18-24;33;49;82;SEC_407
2006;319;18-24;56;65;121;SEC_319
2006;315;03-11;57;65;122;SEC_315
2006;211;25-34;123;197;320;SEC_211
2006;415;03-11;25;32;57;SEC_415
2006;307;35-49;136;115;251;SEC_307
2006;140;50-64;86;91;177;SEC_140
2006;123;35-49;153;153;306;SEC_123
2006;137;12-15;27;21;48;SEC_137
2006;311;16-17;9;19;28;SEC_311
2006;313;18-24;88;80;168;SEC_313
2006;406;12-15;24;27;51;SEC_406
2006;505;75 i +;54;39;93;SEC_505
2006;230;35-49;103;138;241;SEC_230
2006;224;00-02;5;7;12;SEC_224
2006;211;18-24;72;74;146;SEC_211
2006;523;65-74;89;78;167;SEC_523
2006;508;25-34;70;62;132;SEC_508
2006;416;65-74;50;46;96;SEC_416
2006;302;25-34;154;171;325;SEC_302
2006;303;03-11;36;52;88;SEC_303
2006;322;75 i +;51;38;89;SEC_322
2006;308;35-49;244;241;485;SEC_308
2006;511;03-11;28;20;48;SEC_511
2006;122;25-34;88;79;167;SEC_122
2006;110;25-34;112;126;238;SEC_110
2006;101;00-02;46;55;101;SEC_101
2006;523;16-17;14;8;22;SEC_523
2006;207;16-17;5;3;8;SEC_207
2006;520;35-49;88;83;171;SEC_520
2006;520;65-74;52;45;97;SEC_520
2006;323;75 i +;62;27;89;SEC_323
2006;623;00-02;22;22;44;SEC_623
2006;405;75 i +;56;42;98;SEC_405
2006;514;12-15;17;8;25;SEC_514
2006;630;12-15;10;10;20;SEC_630
2006;214;75 i +;31;16;47;SEC_214
2006;630;35-49;72;85;157;SEC_630
2006;232;65-74;65;53;118;SEC_232
2006;530;65-74;85;80;165;SEC_530
2006;108;16-17;11;6;17;SEC_108
2006;223;12-15;25;29;54;SEC_223
2006;229;00-02;7;11;18;SEC_229
2006;119;65-74;58;55;113;SEC_119
2006;408;00-02;12;12;24;SEC_408
2006;526;16-17;4;8;12;SEC_526
2006;138;75 i +;35;18;53;SEC_138
2006;626;25-34;79;79;158;SEC_626
2006;211;16-17;13;11;24;SEC_211
2006;132;65-74;89;82;171;SEC_132
2006;630;03-11;20;30;50;SEC_630
2006;623;65-74;65;74;139;SEC_623
2006;611;75 i +;67;41;108;SEC_611
2006;311;03-11;49;61;110;SEC_311
2006;224;03-11;24;22;46;SEC_224
2006;308;12-15;31;34;65;SEC_308
2006;403;65-74;86;88;174;SEC_403
2006;431;50-64;104;107;211;SEC_431
2006;203;03-11;24;37;61;SEC_203
2006;114;16-17;11;6;17;SEC_114
2006;419;25-34;85;117;202;SEC_419
2006;212;25-34;148;177;325;SEC_212
2006;234;65-74;61;36;97;SEC_234
2006;434;25-34;60;60;120;SEC_434
2006;510;65-74;73;50;123;SEC_510
2006;617;18-24;40;36;76;SEC_617
2006;429;16-17;6;11;17;SEC_429
2006;408;35-49;97;114;211;SEC_408
2006;409;03-11;20;22;42;SEC_409
2006;516;75 i +;27;18;45;SEC_516
2006;423;18-24;46;50;96;SEC_423
2006;631;03-11;30;35;65;SEC_631
2006;610;25-34;94;94;188;SEC_610
2006;213;12-15;13;12;25;SEC_213
2006;411;35-49;104;114;218;SEC_411
2006;112;16-17;11;18;29;SEC_112
2006;438;35-49;97;102;199;SEC_438
2006;410;03-11;47;70;117;SEC_410
2006;503;18-24;43;41;84;SEC_503
2006;228;12-15;23;12;35;SEC_228
2006;216;00-02;26;19;45;SEC_216
2006;227;35-49;80;72;152;SEC_227
2006;621;50-64;221;203;424;SEC_621
2006;208;25-34;131;129;260;SEC_208
2006;518;50-64;82;58;140;SEC_518
2006;434;12-15;16;10;26;SEC_434
2006;608;18-24;27;31;58;SEC_608
2006;242;00-02;17;9;26;SEC_242
2006;221;18-24;46;45;91;SEC_221
2006;125;18-24;56;68;124;SEC_125
2006;528;12-15;22;20;42;SEC_528
2006;113;25-34;180;156;336;SEC_113
2006;318;03-11;30;33;63;SEC_318
2006;401;03-11;56;67;123;SEC_401
2006;238;25-34;78;100;178;SEC_238
2006;313;03-11;79;82;161;SEC_313
2006;503;35-49;83;66;149;SEC_503
2006;125;12-15;19;20;39;SEC_125
2006;315;12-15;22;24;46;SEC_315
2006;513;25-34;82;71;153;SEC_513
2006;420;50-64;103;84;187;SEC_420
2006;627;50-64;157;163;320;SEC_627
2006;523;03-11;53;46;99;SEC_523
2006;529;50-64;83;85;168;SEC_529
2006;128;12-15;12;14;26;SEC_128
2006;227;18-24;18;20;38;SEC_227
2006;624;18-24;37;34;71;SEC_624
2006;415;25-34;96;107;203;SEC_415
2006;501;00-02;8;16;24;SEC_501
2006;228;16-17;12;5;17;SEC_228
2006;102;03-11;62;69;131;SEC_102
2006;427;18-24;38;43;81;SEC_427
2006;139;03-11;30;47;77;SEC_139
2006;612;35-49;91;114;205;SEC_612
2006;207;12-15;9;10;19;SEC_207
2006;402;12-15;13;8;21;SEC_402
2006;524;75 i +;64;31;95;SEC_524
2006;138;35-49;85;79;164;SEC_138
2006;401;75 i +;86;43;129;SEC_401
2006;201;12-15;9;11;20;SEC_201
2006;503;50-64;120;108;228;SEC_503
2006;515;12-15;17;16;33;SEC_515
2006;318;35-49;119;99;218;SEC_318
2006;624;35-49;85;122;207;SEC_624
2006;618;03-11;30;35;65;SEC_618
2006;134;18-24;54;66;120;SEC_134
2006;418;65-74;74;63;137;SEC_418
2006;115;12-15;13;32;45;SEC_115
2006;133;75 i +;54;36;90;SEC_133
2006;425;50-64;70;70;140;SEC_425
2006;623;35-49;121;128;249;SEC_623
2006;230;16-17;8;9;17;SEC_230
2006;632;16-17;8;7;15;SEC_632
2006;616;18-24;125;126;251;SEC_616
2006;103;03-11;26;27;53;SEC_103
2006;416;25-34;61;71;132;SEC_416
2006;414;65-74;49;50;99;SEC_414
2006;439;65-74;57;63;120;SEC_439
2006;313;12-15;34;30;64;SEC_313
2006;322;12-15;20;18;38;SEC_322
2006;108;25-34;111;108;219;SEC_108
2006;442;75 i +;35;22;57;SEC_442
2006;139;50-64;84;84;168;SEC_139
2006;137;50-64;172;151;323;SEC_137
2006;321;18-24;87;96;183;SEC_321
2006;511;75 i +;54;34;88;SEC_511
2006;504;16-17;5;9;14;SEC_504
2006;126;65-74;61;78;139;SEC_126
2006;325;65-74;103;81;184;SEC_325
2006;527;16-17;13;5;18;SEC_527
2006;201;00-02;11;8;19;SEC_201
2006;122;35-49;80;98;178;SEC_122
2006;514;65-74;54;40;94;SEC_514
2006;136;65-74;60;43;103;SEC_136
2006;534;18-24;35;36;71;SEC_534
2006;118;75 i +;56;24;80;SEC_118
2006;526;00-02;12;7;19;SEC_526
2006;411;16-17;11;5;16;SEC_411
2006;414;18-24;34;37;71;SEC_414
2006;429;35-49;57;70;127;SEC_429
2006;423;75 i +;60;35;95;SEC_423
2006;522;00-02;15;21;36;SEC_522
2006;303;35-49;136;166;302;SEC_303
2006;603;50-64;68;44;112;SEC_603
2006;321;03-11;88;84;172;SEC_321
2006;306;18-24;69;68;137;SEC_306
2006;434;16-17;5;9;14;SEC_434
2006;313;25-34;191;187;378;SEC_313
2006;218;12-15;15;11;26;SEC_218
2006;529;12-15;27;25;52;SEC_529
2006;302;50-64;180;162;342;SEC_302
2006;238;00-02;6;18;24;SEC_238
2006;417;35-49;75;83;158;SEC_417
2006;133;18-24;39;31;70;SEC_133
2006;235;75 i +;87;50;137;SEC_235
2006;201;03-11;28;32;60;SEC_201
2006;102;16-17;9;15;24;SEC_102
2006;402;18-24;33;23;56;SEC_402
2006;515;16-17;8;9;17;SEC_515
2006;247;16-17;9;16;25;SEC_247
2006;617;50-64;88;77;165;SEC_617
2006;232;25-34;97;107;204;SEC_232
2006;237;50-64;96;89;185;SEC_237
2006;304;12-15;25;19;44;SEC_304
2006;514;18-24;43;34;77;SEC_514
2006;505;65-74;78;98;176;SEC_505
2006;402;50-64;70;67;137;SEC_402
2006;616;65-74;62;61;123;SEC_616
2006;409;16-17;4;6;10;SEC_409
2006;239;25-34;117;124;241;SEC_239
2006;424;18-24;29;34;63;SEC_424
2006;213;00-02;16;19;35;SEC_213
2006;306;50-64;150;130;280;SEC_306
2006;134;50-64;122;112;234;SEC_134
2006;604;12-15;14;12;26;SEC_604
2006;113;12-15;24;29;53;SEC_113
2006;438;00-02;13;11;24;SEC_438
2006;429;03-11;19;19;38;SEC_429
2006;225;03-11;12;15;27;SEC_225
2006;516;16-17;7;10;17;SEC_516
2006;617;65-74;68;50;118;SEC_617
2006;528;03-11;58;47;105;SEC_528
2006;612;18-24;31;33;64;SEC_612
2006;244;50-64;51;41;92;SEC_244
2006;434;35-49;70;78;148;SEC_434
2006;202;25-34;83;97;180;SEC_202
2006;626;12-15;16;10;26;SEC_626
2006;249;65-74;67;35;102;SEC_249
2006;218;03-11;27;29;56;SEC_218
2006;135;16-17;12;13;25;SEC_135
2006;533;00-02;18;21;39;SEC_533
2006;610;35-49;118;126;244;SEC_610
2006;622;12-15;11;17;28;SEC_622
2006;210;35-49;84;80;164;SEC_210
2006;441;12-15;28;38;66;SEC_441
2006;310;25-34;112;121;233;SEC_310
2006;510;12-15;13;18;31;SEC_510
2006;115;25-34;129;132;261;SEC_115
2006;509;50-64;67;53;120;SEC_509
2006;313;35-49;217;194;411;SEC_313
2006;416;12-15;15;17;32;SEC_416
2006;312;75 i +;63;32;95;SEC_312
2006;508;65-74;40;31;71;SEC_508
2006;621;75 i +;37;20;57;SEC_621
2006;237;12-15;21;19;40;SEC_237
2006;132;00-02;38;21;59;SEC_132
2006;123;12-15;30;31;61;SEC_123
2006;126;50-64;131;98;229;SEC_126
2006;210;18-24;15;29;44;SEC_210
2006;237;35-49;160;204;364;SEC_237
2006;520;00-02;9;7;16;SEC_520
2006;302;00-02;16;15;31;SEC_302
2006;532;00-02;14;21;35;SEC_532
2006;516;50-64;43;42;85;SEC_516
2006;132;25-34;172;207;379;SEC_132
2006;401;50-64;90;94;184;SEC_401
2006;231;75 i +;91;44;135;SEC_231
2006;413;16-17;5;5;10;SEC_413
2006;240;12-15;14;16;30;SEC_240
2006;305;75 i +;95;55;150;SEC_305
2006;102;12-15;23;27;50;SEC_102
2006;121;25-34;73;79;152;SEC_121
2006;530;35-49;164;162;326;SEC_530
2006;316;25-34;151;166;317;SEC_316
2006;505;35-49;115;106;221;SEC_505
2006;501;03-11;41;40;81;SEC_501
2006;537;00-02;18;4;22;SEC_537
2006;515;25-34;61;69;130;SEC_515
2006;603;00-02;4;7;11;SEC_603
2006;517;35-49;155;172;327;SEC_517
2006;311;18-24;61;47;108;SEC_311
2006;241;35-49;119;98;217;SEC_241
2006;202;35-49;87;104;191;SEC_202
2006;512;03-11;20;35;55;SEC_512
2006;215;50-64;75;62;137;SEC_215
2006;209;18-24;32;48;80;SEC_209
2006;104;65-74;59;42;101;SEC_104
2006;225;35-49;53;57;110;SEC_225
2006;238;65-74;43;38;81;SEC_238
2006;603;18-24;18;22;40;SEC_603
2006;437;03-11;39;36;75;SEC_437
2006;208;18-24;62;63;125;SEC_208
2006;239;03-11;42;38;80;SEC_239
2006;122;00-02;17;16;33;SEC_122
2006;114;25-34;166;154;320;SEC_114
2006;139;65-74;33;26;59;SEC_139
2006;313;50-64;212;187;399;SEC_313
2006;202;03-11;22;27;49;SEC_202
2006;122;12-15;9;9;18;SEC_122
2006;620;00-02;3;5;8;SEC_620
2006;418;00-02;21;15;36;SEC_418
2006;116;16-17;7;17;24;SEC_116
2006;609;50-64;124;97;221;SEC_609
2006;244;25-34;73;74;147;SEC_244
2006;617;16-17;12;12;24;SEC_617
2006;523;25-34;130;154;284;SEC_523
2006;128;75 i +;46;33;79;SEC_128
2006;615;75 i +;25;17;42;SEC_615
2006;124;75 i +;38;20;58;SEC_124
2006;106;16-17;14;14;28;SEC_106
2006;430;03-11;34;49;83;SEC_430
2006;239;75 i +;96;57;153;SEC_239
2006;325;25-34;120;138;258;SEC_325
2006;409;25-34;58;90;148;SEC_409
2006;628;25-34;62;83;145;SEC_628
2006;117;65-74;73;64;137;SEC_117
2006;241;12-15;17;12;29;SEC_241
2006;320;65-74;34;29;63;SEC_320
2006;607;35-49;128;127;255;SEC_607
2006;215;00-02;8;11;19;SEC_215
2006;129;03-11;40;48;88;SEC_129
2006;507;03-11;26;38;64;SEC_507
2006;603;12-15;10;14;24;SEC_603
2006;434;50-64;42;46;88;SEC_434
2006;202;16-17;2;4;6;SEC_202
2006;418;75 i +;60;38;98;SEC_418
2006;417;16-17;6;3;9;SEC_417
2006;516;18-24;30;31;61;SEC_516
2006;318;50-64;85;100;185;SEC_318
2006;441;75 i +;83;63;146;SEC_441
2006;527;50-64;65;64;129;SEC_527
2006;424;16-17;2;1;3;SEC_424
2006;410;25-34;118;118;236;SEC_410
2006;220;18-24;33;46;79;SEC_220
2006;501;25-34;91;121;212;SEC_501
2006;537;18-24;59;51;110;SEC_537
2006;518;35-49;137;140;277;SEC_518
2006;419;65-74;51;33;84;SEC_419
2006;438;65-74;60;55;115;SEC_438
2006;236;75 i +;76;43;119;SEC_236
2006;204;00-02;7;8;15;SEC_204
2006;523;50-64;113;100;213;SEC_523
2006;401;65-74;78;64;142;SEC_401
2006;525;65-74;72;53;125;SEC_525
2006;241;65-74;43;37;80;SEC_241
2006;316;50-64;312;345;657;SEC_316
2006;438;12-15;11;21;32;SEC_438
2006;619;50-64;146;132;278;SEC_619
2006;120;50-64;160;166;326;SEC_120
2006;423;16-17;7;6;13;SEC_423
2006;613;75 i +;50;31;81;SEC_613
2006;502;12-15;25;17;42;SEC_502
2006;203;16-17;7;4;11;SEC_203
2006;619;12-15;16;21;37;SEC_619
2006;538;25-34;100;123;223;SEC_538
2006;120;12-15;44;36;80;SEC_120
2006;610;65-74;73;85;158;SEC_610
2006;622;35-49;79;86;165;SEC_622
2006;401;35-49;141;122;263;SEC_401
2006;610;16-17;13;10;23;SEC_610
2006;238;12-15;13;12;25;SEC_238
2006;229;65-74;39;36;75;SEC_229
2006;422;16-17;7;12;19;SEC_422
2006;608;25-34;59;78;137;SEC_608
2006;115;16-17;9;16;25;SEC_115
2006;522;16-17;11;8;19;SEC_522
2006;512;16-17;5;9;14;SEC_512
2006;430;18-24;38;44;82;SEC_430
2006;244;18-24;27;25;52;SEC_244
2006;312;03-11;49;62;111;SEC_312
2006;527;25-34;123;129;252;SEC_527
2006;422;65-74;58;47;105;SEC_422
2006;618;12-15;6;13;19;SEC_618
2006;120;25-34;119;140;259;SEC_120
2006;133;12-15;11;14;25;SEC_133
2006;314;25-34;199;233;432;SEC_314
2006;205;00-02;5;9;14;SEC_205
2006;227;12-15;13;8;21;SEC_227
2006;607;00-02;10;10;20;SEC_607
2006;623;50-64;208;182;390;SEC_623
2006;134;75 i +;65;35;100;SEC_134
2006;219;75 i +;92;55;147;SEC_219
2006;425;35-49;107;129;236;SEC_425
2006;533;50-64;58;53;111;SEC_533
2006;514;25-34;68;85;153;SEC_514
2006;210;50-64;91;79;170;SEC_210
2006;246;12-15;18;15;33;SEC_246
2006;402;75 i +;44;32;76;SEC_402
2006;417;25-34;65;76;141;SEC_417
2006;407;12-15;12;12;24;SEC_407
2006;608;03-11;24;24;48;SEC_608
2006;529;25-34;135;126;261;SEC_529
2006;230;75 i +;58;26;84;SEC_230
2006;425;03-11;24;36;60;SEC_425
2006;128;50-64;105;75;180;SEC_128
2006;416;16-17;3;9;12;SEC_416
2006;628;16-17;9;6;15;SEC_628
2006;320;25-34;96;108;204;SEC_320
2006;222;12-15;18;18;36;SEC_222
2006;202;18-24;34;38;72;SEC_202
2006;610;75 i +;54;34;88;SEC_610
2006;610;00-02;15;13;28;SEC_610
2006;406;50-64;134;115;249;SEC_406
2006;632;50-64;91;76;167;SEC_632
2006;113;75 i +;49;30;79;SEC_113
2006;208;75 i +;139;90;229;SEC_208
2006;602;65-74;49;66;115;SEC_602
2006;302;65-74;67;51;118;SEC_302
2006;130;00-02;17;14;31;SEC_130
2006;629;75 i +;30;13;43;SEC_629
2006;419;03-11;42;41;83;SEC_419
2006;624;03-11;29;38;67;SEC_624
2006;437;65-74;47;40;87;SEC_437
2006;528;00-02;16;17;33;SEC_528
2006;615;65-74;59;70;129;SEC_615
2006;136;35-49;117;140;257;SEC_136
2006;439;35-49;133;154;287;SEC_439
2006;319;03-11;72;66;138;SEC_319
2006;126;18-24;34;31;65;SEC_126
2006;129;12-15;26;18;44;SEC_129
2006;231;18-24;43;44;87;SEC_231
2006;531;16-17;9;4;13;SEC_531
2006;438;03-11;24;29;53;SEC_438
2006;317;35-49;100;120;220;SEC_317
2006;423;03-11;30;29;59;SEC_423
2006;305;18-24;84;83;167;SEC_305
2006;510;25-34;79;99;178;SEC_510
2006;207;03-11;22;24;46;SEC_207
2006;101;25-34;188;191;379;SEC_101
2006;205;50-64;91;79;170;SEC_205
2006;536;35-49;95;112;207;SEC_536
2006;515;65-74;32;28;60;SEC_515
2006;119;03-11;28;39;67;SEC_119
2006;246;75 i +;76;49;125;SEC_246
2006;104;12-15;14;14;28;SEC_104
2006;602;35-49;59;62;121;SEC_602
2006;538;00-02;22;18;40;SEC_538
2006;439;25-34;126;149;275;SEC_439
2006;124;12-15;8;17;25;SEC_124
2006;309;35-49;105;112;217;SEC_309
2006;511;50-64;43;48;91;SEC_511
2006;202;65-74;40;31;71;SEC_202
2006;606;00-02;23;11;34;SEC_606
2006;526;03-11;22;27;49;SEC_526
2006;308;03-11;86;109;195;SEC_308
2006;201;25-34;55;74;129;SEC_201
2006;325;75 i +;162;83;245;SEC_325
2006;218;00-02;7;9;16;SEC_218
2006;517;00-02;18;15;33;SEC_517
2006;228;65-74;46;41;87;SEC_228
2006;237;16-17;7;7;14;SEC_237
2006;629;00-02;12;7;19;SEC_629
2006;121;03-11;30;32;62;SEC_121
2006;323;03-11;138;140;278;SEC_323
2006;425;75 i +;58;40;98;SEC_425
2006;628;00-02;12;13;25;SEC_628
2006;108;35-49;162;145;307;SEC_108
2006;627;12-15;5;18;23;SEC_627
2006;104;25-34;80;75;155;SEC_104
2006;535;35-49;99;94;193;SEC_535
2006;214;35-49;81;108;189;SEC_214
2006;216;75 i +;73;44;117;SEC_216
2006;216;65-74;74;61;135;SEC_216
2006;418;16-17;15;14;29;SEC_418
2006;219;00-02;18;18;36;SEC_219
2006;621;65-74;48;55;103;SEC_621
2006;611;16-17;14;13;27;SEC_611
2006;434;18-24;28;32;60;SEC_434
2006;632;18-24;37;49;86;SEC_632
2006;535;25-34;68;87;155;SEC_535
2006;409;12-15;10;8;18;SEC_409
2006;529;75 i +;75;46;121;SEC_529
2006;118;00-02;29;30;59;SEC_118
2006;249;75 i +;65;51;116;SEC_249
2006;433;12-15;21;26;47;SEC_433
2006;206;75 i +;69;40;109;SEC_206
2006;531;00-02;13;10;23;SEC_531
2006;232;16-17;8;7;15;SEC_232
2006;432;03-11;39;38;77;SEC_432
2006;124;00-02;10;13;23;SEC_124
2006;407;50-64;77;60;137;SEC_407
2006;533;25-34;106;140;246;SEC_533
2006;245;50-64;79;65;144;SEC_245
2006;127;00-02;9;12;21;SEC_127
2006;429;50-64;57;59;116;SEC_429
2006;603;03-11;27;24;51;SEC_603
2006;221;65-74;70;63;133;SEC_221
2006;623;18-24;46;57;103;SEC_623
2006;245;16-17;10;6;16;SEC_245
2006;202;75 i +;34;30;64;SEC_202
2006;435;65-74;58;36;94;SEC_435
2006;107;16-17;9;17;26;SEC_107
2006;605;16-17;3;2;5;SEC_605
2006;501;35-49;103;98;201;SEC_501
2006;629;65-74;39;41;80;SEC_629
2006;624;65-74;52;62;114;SEC_624
2006;135;00-02;16;22;38;SEC_135
2006;601;03-11;36;39;75;SEC_601
2006;243;65-74;98;72;170;SEC_243
2006;426;00-02;13;24;37;SEC_426
2006;115;03-11;45;43;88;SEC_115
2006;202;00-02;9;8;17;SEC_202
2006;527;18-24;62;47;109;SEC_527
2006;139;12-15;13;15;28;SEC_139
2006;233;16-17;6;11;17;SEC_233
2006;404;35-49;145;170;315;SEC_404
2006;106;03-11;68;55;123;SEC_106
2006;429;25-34;55;64;119;SEC_429
2006;534;35-49;124;96;220;SEC_534
2006;515;75 i +;24;13;37;SEC_515
2006;630;18-24;42;38;80;SEC_630
2006;405;12-15;9;8;17;SEC_405
2006;627;16-17;7;14;21;SEC_627
2006;613;25-34;114;120;234;SEC_613
2006;125;16-17;15;13;28;SEC_125
2006;310;00-02;14;18;32;SEC_310
2006;121;00-02;9;13;22;SEC_121
2006;224;65-74;30;17;47;SEC_224
2006;209;16-17;11;12;23;SEC_209
2006;206;18-24;42;41;83;SEC_206
2006;627;00-02;10;8;18;SEC_627
2006;249;12-15;22;17;39;SEC_249
2006;245;03-11;43;37;80;SEC_245
2006;321;75 i +;111;59;170;SEC_321
2006;323;12-15;56;53;109;SEC_323
2006;518;00-02;11;19;30;SEC_518
2006;440;18-24;35;23;58;SEC_440
2006;123;65-74;56;58;114;SEC_123
2006;438;50-64;73;59;132;SEC_438
2006;123;75 i +;83;58;141;SEC_123
2006;410;35-49;157;161;318;SEC_410
2006;127;12-15;11;14;25;SEC_127
2006;140;03-11;35;41;76;SEC_140
2006;413;35-49;62;90;152;SEC_413
2006;207;50-64;65;51;116;SEC_207
2006;229;03-11;38;28;66;SEC_229
2006;412;25-34;136;187;323;SEC_412
2006;434;03-11;23;17;40;SEC_434
2006;131;12-15;16;19;35;SEC_131
2006;508;00-02;8;15;23;SEC_508
2006;601;16-17;11;14;25;SEC_601
2006;615;12-15;5;11;16;SEC_615
2006;515;03-11;23;23;46;SEC_515
2006;604;00-02;10;7;17;SEC_604
2006;403;12-15;15;15;30;SEC_403
2006;129;00-02;19;16;35;SEC_129
2006;534;25-34;97;128;225;SEC_534
2006;246;35-49;122;135;257;SEC_246
2006;427;35-49;103;114;217;SEC_427
2006;206;16-17;7;5;12;SEC_206
2006;513;50-64;53;44;97;SEC_513
2006;613;65-74;79;87;166;SEC_613
2006;433;35-49;122;154;276;SEC_433
2006;101;65-74;50;52;102;SEC_101
2006;438;75 i +;28;20;48;SEC_438
2006;223;03-11;43;45;88;SEC_223
2006;439;00-02;12;21;33;SEC_439
2006;411;75 i +;81;61;142;SEC_411
2006;518;25-34;103;106;209;SEC_518
2006;107;18-24;72;71;143;SEC_107
2006;536;18-24;24;28;52;SEC_536
2006;226;18-24;59;53;112;SEC_226
2006;625;75 i +;33;20;53;SEC_625
2006;610;03-11;47;54;101;SEC_610
2006;312;65-74;79;81;160;SEC_312
2006;620;16-17;5;11;16;SEC_620
2006;249;25-34;107;97;204;SEC_249
2006;240;25-34;67;72;139;SEC_240
2006;426;18-24;58;46;104;SEC_426
2006;131;03-11;37;56;93;SEC_131
2006;531;12-15;19;20;39;SEC_531
2006;403;00-02;7;16;23;SEC_403
2006;618;00-02;7;10;17;SEC_618
2006;106;12-15;21;27;48;SEC_106
2006;523;12-15;12;23;35;SEC_523
2006;533;12-15;11;11;22;SEC_533
2006;247;75 i +;78;36;114;SEC_247
2006;138;50-64;92;88;180;SEC_138
2006;607;50-64;92;59;151;SEC_607
2006;603;16-17;3;4;7;SEC_603
2006;512;35-49;96;107;203;SEC_512
2006;402;65-74;54;52;106;SEC_402
2006;312;18-24;59;61;120;SEC_312
2006;510;35-49;116;131;247;SEC_510
2006;515;35-49;76;77;153;SEC_515
2006;607;03-11;38;36;74;SEC_607
2006;518;18-24;55;56;111;SEC_518
2006;125;03-11;39;52;91;SEC_125
2006;501;50-64;161;161;322;SEC_501
2006;242;25-34;95;108;203;SEC_242
2006;321;65-74;77;77;154;SEC_321
2006;530;03-11;39;52;91;SEC_530
2006;420;75 i +;68;35;103;SEC_420
2006;419;16-17;5;7;12;SEC_419
2006;509;03-11;32;37;69;SEC_509
2006;234;18-24;27;39;66;SEC_234
2006;619;00-02;19;14;33;SEC_619
2006;426;75 i +;54;32;86;SEC_426
2006;203;12-15;8;15;23;SEC_203
2006;629;18-24;24;23;47;SEC_629
2006;322;00-02;25;14;39;SEC_322
2006;235;65-74;73;67;140;SEC_235
2006;505;12-15;15;11;26;SEC_505
2006;612;50-64;120;92;212;SEC_612
2006;245;65-74;53;49;102;SEC_245
2006;436;16-17;8;9;17;SEC_436
2006;227;16-17;1;0;1;SEC_227
2006;408;18-24;47;53;100;SEC_408
2006;404;16-17;15;13;28;SEC_404
2006;206;03-11;21;27;48;SEC_206
2006;233;65-74;54;50;104;SEC_233
2006;234;00-02;12;12;24;SEC_234
2006;130;18-24;29;17;46;SEC_130
2006;128;18-24;31;32;63;SEC_128
2006;524;00-02;18;27;45;SEC_524
2006;214;25-34;89;104;193;SEC_214
2006;109;35-49;131;115;246;SEC_109
2006;629;03-11;22;18;40;SEC_629
2006;245;18-24;37;52;89;SEC_245
2006;308;16-17;9;15;24;SEC_308
2006;249;50-64;87;83;170;SEC_249
2006;619;75 i +;57;41;98;SEC_619
2006;417;00-02;7;9;16;SEC_417
2006;243;03-11;44;54;98;SEC_243
2006;121;75 i +;71;44;115;SEC_121
2006;630;00-02;10;10;20;SEC_630
2006;113;50-64;195;198;393;SEC_113
2006;247;50-64;105;107;212;SEC_247
2006;426;65-74;45;36;81;SEC_426
2006;227;50-64;58;57;115;SEC_227
2006;316;03-11;42;61;103;SEC_316
2006;317;12-15;16;21;37;SEC_317
2006;437;00-02;13;11;24;SEC_437
2006;216;18-24;55;62;117;SEC_216
2006;424;03-11;20;27;47;SEC_424
2006;240;35-49;82;92;174;SEC_240
2006;241;18-24;32;38;70;SEC_241
2006;107;35-49;179;178;357;SEC_107
2006;519;00-02;10;17;27;SEC_519
2006;521;18-24;37;28;65;SEC_521
2006;318;25-34;57;62;119;SEC_318
2006;324;75 i +;48;22;70;SEC_324
2006;603;75 i +;20;17;37;SEC_603
2006;217;65-74;25;23;48;SEC_217
2006;310;12-15;12;12;24;SEC_310
2006;324;25-34;84;99;183;SEC_324
2006;316;65-74;53;58;111;SEC_316
2006;437;25-34;84;108;192;SEC_437
2006;324;65-74;40;33;73;SEC_324
2006;428;03-11;28;21;49;SEC_428
2006;440;65-74;71;76;147;SEC_440
2006;110;12-15;11;23;34;SEC_110
2006;304;35-49;154;175;329;SEC_304
2006;122;75 i +;45;28;73;SEC_122
2006;119;50-64;194;169;363;SEC_119
2006;210;16-17;8;5;13;SEC_210
2006;430;50-64;58;64;122;SEC_430
2006;212;75 i +;69;40;109;SEC_212
2006;538;18-24;47;51;98;SEC_538
2006;409;75 i +;26;23;49;SEC_409
2006;122;03-11;31;36;67;SEC_122
2006;106;35-49;197;183;380;SEC_106
2006;608;75 i +;40;25;65;SEC_608
2006;135;50-64;148;151;299;SEC_135
2006;411;18-24;33;41;74;SEC_411
2006;205;35-49;95;102;197;SEC_205
2006;323;65-74;85;69;154;SEC_323
2006;135;25-34;117;140;257;SEC_135
2006;501;12-15;15;18;33;SEC_501
2006;325;12-15;32;32;64;SEC_325
2006;622;00-02;9;7;16;SEC_622
2006;130;65-74;84;61;145;SEC_130
2006;606;25-34;93;121;214;SEC_606
2006;522;75 i +;40;20;60;SEC_522
2006;408;25-34;96;99;195;SEC_408
2006;532;12-15;24;24;48;SEC_532
2006;429;65-74;41;26;67;SEC_429
2006;605;03-11;13;16;29;SEC_605
2006;108;75 i +;101;62;163;SEC_108
2006;203;18-24;49;42;91;SEC_203
2006;207;00-02;14;6;20;SEC_207
2006;439;12-15;17;20;37;SEC_439
2006;503;12-15;12;19;31;SEC_503
2006;413;75 i +;41;26;67;SEC_413
2006;138;12-15;12;11;23;SEC_138
2006;138;18-24;32;49;81;SEC_138
2006;422;12-15;19;21;40;SEC_422
2006;229;18-24;34;33;67;SEC_229
2006;631;00-02;10;10;20;SEC_631
2006;533;35-49;97;141;238;SEC_533
2006;607;65-74;103;111;214;SEC_607
2006;525;35-49;106;101;207;SEC_525
2006;532;75 i +;76;52;128;SEC_532
2006;305;16-17;15;18;33;SEC_305
2006;110;00-02;15;7;22;SEC_110
2006;240;16-17;7;2;9;SEC_240
2006;406;00-02;17;23;40;SEC_406
2006;220;50-64;64;51;115;SEC_220
2006;605;25-34;58;73;131;SEC_605
2006;504;25-34;92;110;202;SEC_504
2006;525;25-34;94;120;214;SEC_525
2006;303;00-02;19;16;35;SEC_303
2006;106;18-24;111;91;202;SEC_106
2006;301;65-74;126;113;239;SEC_301
2006;521;75 i +;46;30;76;SEC_521
2006;224;25-34;58;52;110;SEC_224
2006;431;16-17;12;14;26;SEC_431
2006;431;12-15;22;31;53;SEC_431
2006;439;50-64;61;46;107;SEC_439
2006;312;35-49;176;208;384;SEC_312
2006;236;25-34;92;104;196;SEC_236
2006;319;25-34;191;189;380;SEC_319
2006;120;00-02;11;37;48;SEC_120
2006;322;50-64;104;97;201;SEC_322
2006;212;18-24;66;84;150;SEC_212
2006;401;16-17;14;21;35;SEC_401
2006;504;00-02;7;13;20;SEC_504
2006;622;75 i +;40;8;48;SEC_622
2006;303;16-17;9;11;20;SEC_303
2006;129;35-49;118;144;262;SEC_129
2006;507;35-49;89;107;196;SEC_507
2006;240;50-64;50;36;86;SEC_240
2006;428;25-34;64;100;164;SEC_428
2006;207;65-74;40;30;70;SEC_207
2006;324;03-11;46;50;96;SEC_324
2006;307;00-02;8;14;22;SEC_307
2006;427;00-02;18;22;40;SEC_427
2006;614;16-17;9;8;17;SEC_614
2006;503;03-11;26;29;55;SEC_503
2006;208;12-15;20;23;43;SEC_208
2006;422;18-24;60;57;117;SEC_422
2006;435;50-64;70;67;137;SEC_435
2006;615;03-11;35;20;55;SEC_615
2006;314;16-17;16;45;61;SEC_314
2006;437;50-64;70;53;123;SEC_437
2006;421;50-64;108;90;198;SEC_421
2006;417;12-15;12;5;17;SEC_417
2006;302;18-24;58;56;114;SEC_302
2006;617;75 i +;34;28;62;SEC_617
2006;114;03-11;57;61;118;SEC_114
2006;118;18-24;86;78;164;SEC_118
2006;607;25-34;77;107;184;SEC_607
2006;411;12-15;16;9;25;SEC_411
2006;519;16-17;7;4;11;SEC_519
2006;424;65-74;41;30;71;SEC_424
2006;217;16-17;7;9;16;SEC_217
2006;632;35-49;86;95;181;SEC_632
2006;420;00-02;32;27;59;SEC_420
2006;616;25-34;214;230;444;SEC_616
2006;523;00-02;19;18;37;SEC_523
2006;123;03-11;42;50;92;SEC_123
2006;418;50-64;105;90;195;SEC_418
2006;128;16-17;8;14;22;SEC_128
2006;627;03-11;34;24;58;SEC_627
2006;114;50-64;189;164;353;SEC_114
2006;304;25-34;148;150;298;SEC_304
2006;106;50-64;242;237;479;SEC_106
2006;532;03-11;48;31;79;SEC_532
2006;631;75 i +;44;23;67;SEC_631
2006;219;03-11;56;45;101;SEC_219
2006;237;00-02;21;24;45;SEC_237
2006;435;18-24;50;71;121;SEC_435
2006;616;12-15;65;71;136;SEC_616
2006;425;00-02;11;12;23;SEC_425
2006;305;25-34;109;122;231;SEC_305
2006;320;35-49;120;140;260;SEC_320
2006;524;25-34;157;157;314;SEC_524
2006;132;12-15;34;42;76;SEC_132
2006;504;65-74;86;87;173;SEC_504
2006;419;75 i +;44;29;73;SEC_419
2006;123;25-34;128;101;229;SEC_123
2006;219;50-64;93;72;165;SEC_219
2006;440;75 i +;58;38;96;SEC_440
2006;127;65-74;40;38;78;SEC_127
2006;426;12-15;12;24;36;SEC_426
2006;623;25-34;134;154;288;SEC_623
2006;617;00-02;5;12;17;SEC_617
2006;515;00-02;8;13;21;SEC_515
2006;317;65-74;34;26;60;SEC_317
2006;309;25-34;107;119;226;SEC_309
2006;620;50-64;73;75;148;SEC_620
2006;102;25-34;119;126;245;SEC_102
2006;415;35-49;85;116;201;SEC_415
2006;301;03-11;93;91;184;SEC_301
2006;112;65-74;64;50;114;SEC_112
2006;243;50-64;110;98;208;SEC_243
2006;131;65-74;57;59;116;SEC_131
2006;312;16-17;16;12;28;SEC_312
2006;504;12-15;11;9;20;SEC_504
2006;404;25-34;117;130;247;SEC_404
2006;429;75 i +;36;22;58;SEC_429
2006;308;25-34;179;164;343;SEC_308
2006;620;18-24;25;22;47;SEC_620
2006;615;35-49;62;77;139;SEC_615
2006;248;35-49;153;185;338;SEC_248
2006;217;35-49;77;107;184;SEC_217
2006;117;18-24;102;100;202;SEC_117
2006;512;50-64;68;64;132;SEC_512
2006;315;00-02;27;23;50;SEC_315
2006;234;75 i +;76;45;121;SEC_234
2006;426;25-34;116;156;272;SEC_426
2006;105;16-17;17;16;33;SEC_105
2006;517;25-34;125;162;287;SEC_517
2006;205;18-24;48;45;93;SEC_205
2006;440;35-49;76;89;165;SEC_440
2006;249;16-17;8;10;18;SEC_249
2006;231;50-64;85;61;146;SEC_231
2006;244;35-49;89;91;180;SEC_244
2006;613;50-64;164;119;283;SEC_613
2006;135;65-74;75;59;134;SEC_135
2006;124;16-17;9;9;18;SEC_124
2006;219;18-24;50;56;106;SEC_219
2006;427;75 i +;54;42;96;SEC_427
2006;510;16-17;7;11;18;SEC_510
2006;430;00-02;21;18;39;SEC_430
2006;202;50-64;61;63;124;SEC_202
2006;530;25-34;124;163;287;SEC_530
2006;215;65-74;50;29;79;SEC_215
2006;209;50-64;70;64;134;SEC_209
2006;110;18-24;68;48;116;SEC_110
2006;536;00-02;10;11;21;SEC_536
2006;627;25-34;88;75;163;SEC_627
2006;249;00-02;23;23;46;SEC_249
2006;311;12-15;12;23;35;SEC_311
2006;225;16-17;4;4;8;SEC_225
2006;104;75 i +;77;41;118;SEC_104
2006;209;12-15;10;15;25;SEC_209
2006;128;25-34;94;98;192;SEC_128
2006;538;65-74;81;68;149;SEC_538
2006;609;12-15;10;11;21;SEC_609
2006;240;03-11;23;30;53;SEC_240
2006;402;00-02;10;10;20;SEC_402
2006;215;35-49;129;116;245;SEC_215
2006;417;18-24;40;31;71;SEC_417
2006;140;18-24;37;39;76;SEC_140
2006;102;75 i +;81;49;130;SEC_102
2006;631;18-24;34;25;59;SEC_631
2006;323;18-24;123;134;257;SEC_323
2006;442;03-11;27;23;50;SEC_442
2006;509;65-74;41;39;80;SEC_509
2006;616;16-17;34;38;72;SEC_616
2006;504;50-64;129;92;221;SEC_504
2006;303;18-24;44;44;88;SEC_303
2006;521;50-64;167;137;304;SEC_521
2006;507;00-02;16;12;28;SEC_507
2006;110;03-11;32;34;66;SEC_110
2006;623;16-17;8;7;15;SEC_623
2006;325;18-24;57;58;115;SEC_325
2006;519;35-49;70;99;169;SEC_519
2006;302;03-11;32;47;79;SEC_302
2006;210;65-74;65;53;118;SEC_210
2006;432;16-17;12;13;25;SEC_432
2006;212;03-11;53;59;112;SEC_212
2006;205;12-15;14;12;26;SEC_205
2006;223;00-02;18;20;38;SEC_223
2006;504;35-49;94;99;193;SEC_504
2006;502;00-02;13;18;31;SEC_502
2006;114;75 i +;72;40;112;SEC_114
2006;520;75 i +;52;29;81;SEC_520
2006;620;35-49;63;57;120;SEC_620
2006;426;16-17;7;2;9;SEC_426
2006;238;03-11;34;31;65;SEC_238
2006;514;16-17;4;3;7;SEC_514
2006;603;25-34;56;59;115;SEC_603
2006;533;18-24;62;44;106;SEC_533
2006;205;03-11;30;27;57;SEC_205
2006;513;16-17;3;6;9;SEC_513
2006;108;03-11;55;43;98;SEC_108
2006;507;18-24;40;37;77;SEC_507
2006;249;35-49;128;138;266;SEC_249
2006;304;03-11;51;55;106;SEC_304
2006;405;50-64;66;58;124;SEC_405
2006;432;75 i +;59;39;98;SEC_432
2006;517;75 i +;47;24;71;SEC_517
2006;302;12-15;20;23;43;SEC_302
2006;525;50-64;68;65;133;SEC_525
2006;506;12-15;32;44;76;SEC_506
2006;623;03-11;54;51;105;SEC_623
2006;226;16-17;4;12;16;SEC_226
2006;506;35-49;181;186;367;SEC_506
2006;529;00-02;19;20;39;SEC_529
2006;415;16-17;9;8;17;SEC_415
2006;407;16-17;6;15;21;SEC_407
