AnyPadro;Seccio;GrupEdat;Dones;Homes;Total;IdSeccio
2004;424;00-02;4;10;14;SEC_424
2004;120;18-24;72;81;153;SEC_120
2004;125;16-17;10;14;24;SEC_125
2004;119;12-15;17;23;40;SEC_119
2004;101;16-17;20;10;30;SEC_101
2004;304;50-64;116;97;213;SEC_304
2004;131;18-24;72;61;133;SEC_131
2004;110;18-24;57;53;110;SEC_110
2004;629;12-15;9;8;17;SEC_629
2004;303;18-24;47;47;94;SEC_303
2004;211;65-74;80;44;124;SEC_211
2004;409;00-02;7;7;14;SEC_409
2004;136;16-17;9;8;17;SEC_136
2004;230;00-02;14;6;20;SEC_230
2004;442;00-02;9;6;15;SEC_442
2004;311;65-74;84;54;138;SEC_311
2004;128;50-64;101;79;180;SEC_128
2004;622;25-34;78;93;171;SEC_622
2004;602;18-24;22;23;45;SEC_602
2004;620;35-49;58;62;120;SEC_620
2004;108;35-49;168;151;319;SEC_108
2004;102;16-17;17;14;31;SEC_102
2004;433;25-34;120;129;249;SEC_433
2004;306;50-64;144;130;274;SEC_306
2004;237;12-15;15;21;36;SEC_237
2004;241;50-64;51;51;102;SEC_241
2004;602;16-17;5;4;9;SEC_602
2004;202;16-17;7;3;10;SEC_202
2004;132;00-02;34;19;53;SEC_132
2004;504;12-15;9;14;23;SEC_504
2004;419;50-64;73;69;142;SEC_419
2004;408;25-34;72;86;158;SEC_408
2004;310;18-24;60;44;104;SEC_310
2004;229;00-02;7;11;18;SEC_229
2004;119;50-64;190;179;369;SEC_119
2004;207;50-64;62;57;119;SEC_207
2004;235;12-15;21;20;41;SEC_235
2004;618;35-49;67;65;132;SEC_618
2004;417;50-64;56;46;102;SEC_417
2004;522;75 i +;35;21;56;SEC_522
2004;318;35-49;120;108;228;SEC_318
2004;535;00-02;12;10;22;SEC_535
2004;626;00-02;11;14;25;SEC_626
2004;313;00-02;34;25;59;SEC_313
2004;114;25-34;157;143;300;SEC_114
2004;406;16-17;15;9;24;SEC_406
2004;421;16-17;6;5;11;SEC_421
2004;614;65-74;61;56;117;SEC_614
2004;320;50-64;102;97;199;SEC_320
2004;507;35-49;89;90;179;SEC_507
2004;503;16-17;14;8;22;SEC_503
2004;519;16-17;3;3;6;SEC_519
2004;217;35-49;78;89;167;SEC_217
2004;209;75 i +;86;53;139;SEC_209
2004;243;65-74;104;83;187;SEC_243
2004;537;18-24;58;66;124;SEC_537
2004;619;00-02;11;17;28;SEC_619
2004;509;35-49;92;99;191;SEC_509
2004;206;50-64;65;61;126;SEC_206
2004;130;65-74;93;69;162;SEC_130
2004;412;35-49;172;179;351;SEC_412
2004;122;00-02;13;13;26;SEC_122
2004;421;03-11;33;41;74;SEC_421
2004;611;35-49;166;198;364;SEC_611
2004;416;65-74;54;53;107;SEC_416
2004;210;35-49;72;84;156;SEC_210
2004;232;00-02;10;16;26;SEC_232
2004;310;16-17;6;11;17;SEC_310
2004;632;03-11;42;38;80;SEC_632
2004;613;03-11;39;35;74;SEC_613
2004;238;12-15;12;11;23;SEC_238
2004;126;16-17;8;8;16;SEC_126
2004;618;12-15;9;13;22;SEC_618
2004;411;25-34;74;73;147;SEC_411
2004;536;12-15;15;10;25;SEC_536
2004;419;12-15;13;13;26;SEC_419
2004;530;03-11;43;53;96;SEC_530
2004;631;35-49;89;91;180;SEC_631
2004;236;03-11;40;27;67;SEC_236
2004;627;75 i +;35;16;51;SEC_627
2004;201;25-34;51;58;109;SEC_201
2004;409;12-15;8;11;19;SEC_409
2004;525;50-64;81;70;151;SEC_525
2004;231;03-11;39;35;74;SEC_231
2004;239;00-02;13;10;23;SEC_239
2004;133;65-74;44;35;79;SEC_133
2004;414;50-64;68;65;133;SEC_414
2004;130;75 i +;63;44;107;SEC_130
2004;202;12-15;7;12;19;SEC_202
2004;312;65-74;73;65;138;SEC_312
2004;139;35-49;80;114;194;SEC_139
2004;419;75 i +;39;27;66;SEC_419
2004;618;75 i +;25;14;39;SEC_618
2004;114;12-15;21;13;34;SEC_114
2004;504;35-49;85;94;179;SEC_504
2004;611;65-74;87;103;190;SEC_611
2004;219;75 i +;86;49;135;SEC_219
2004;309;50-64;71;70;141;SEC_309
2004;426;75 i +;51;34;85;SEC_426
2004;618;50-64;68;55;123;SEC_618
2004;503;00-02;8;7;15;SEC_503
2004;129;25-34;130;123;253;SEC_129
2004;622;75 i +;42;15;57;SEC_622
2004;216;50-64;150;126;276;SEC_216
2004;631;00-02;10;8;18;SEC_631
2004;524;18-24;66;57;123;SEC_524
2004;211;50-64;73;77;150;SEC_211
2004;524;50-64;101;87;188;SEC_524
2004;322;25-34;158;171;329;SEC_322
2004;322;12-15;16;16;32;SEC_322
2004;438;00-02;7;14;21;SEC_438
2004;613;00-02;14;15;29;SEC_613
2004;438;25-34;82;88;170;SEC_438
2004;516;12-15;13;14;27;SEC_516
2004;111;35-49;95;86;181;SEC_111
2004;322;03-11;49;38;87;SEC_322
2004;238;35-49;90;103;193;SEC_238
2004;137;25-34;141;152;293;SEC_137
2004;432;65-74;62;63;125;SEC_432
2004;125;65-74;51;58;109;SEC_125
2004;107;16-17;14;13;27;SEC_107
2004;424;18-24;31;39;70;SEC_424
2004;237;03-11;43;37;80;SEC_237
2004;221;03-11;47;36;83;SEC_221
2004;630;16-17;9;7;16;SEC_630
2004;415;03-11;23;27;50;SEC_415
2004;607;25-34;80;109;189;SEC_607
2004;217;18-24;22;28;50;SEC_217
2004;236;75 i +;76;45;121;SEC_236
2004;241;12-15;22;14;36;SEC_241
2004;611;50-64;188;145;333;SEC_611
2004;301;00-02;49;44;93;SEC_301
2004;121;75 i +;63;37;100;SEC_121
2004;522;16-17;9;15;24;SEC_522
2004;624;50-64;171;158;329;SEC_624
2004;502;03-11;41;45;86;SEC_502
2004;437;75 i +;34;19;53;SEC_437
2004;632;16-17;18;9;27;SEC_632
2004;533;03-11;36;23;59;SEC_533
2004;311;75 i +;88;49;137;SEC_311
2004;533;25-34;96;128;224;SEC_533
2004;108;75 i +;90;54;144;SEC_108
2004;133;16-17;12;7;19;SEC_133
2004;620;03-11;18;27;45;SEC_620
2004;518;18-24;39;55;94;SEC_518
2004;523;35-49;152;145;297;SEC_523
2004;603;35-49;55;56;111;SEC_603
2004;438;16-17;12;7;19;SEC_438
2004;506;03-11;65;72;137;SEC_506
2004;302;12-15;16;13;29;SEC_302
2004;535;25-34;69;84;153;SEC_535
2004;417;12-15;9;6;15;SEC_417
2004;617;12-15;24;17;41;SEC_617
2004;320;25-34;106;117;223;SEC_320
2004;608;65-74;69;55;124;SEC_608
2004;619;65-74;98;85;183;SEC_619
2004;116;18-24;70;58;128;SEC_116
2004;615;12-15;7;9;16;SEC_615
2004;618;65-74;22;25;47;SEC_618
2004;530;50-64;107;90;197;SEC_530
2004;130;25-34;101;99;200;SEC_130
2004;106;35-49;216;195;411;SEC_106
2004;138;03-11;25;19;44;SEC_138
2004;509;18-24;39;31;70;SEC_509
2004;119;35-49;125;115;240;SEC_119
2004;103;35-49;90;78;168;SEC_103
2004;239;12-15;19;21;40;SEC_239
2004;124;16-17;8;5;13;SEC_124
2004;324;12-15;13;18;31;SEC_324
2004;436;65-74;38;22;60;SEC_436
2004;226;75 i +;77;51;128;SEC_226
2004;203;03-11;24;36;60;SEC_203
2004;222;35-49;97;105;202;SEC_222
2004;244;75 i +;47;32;79;SEC_244
2004;431;65-74;73;65;138;SEC_431
2004;235;03-11;53;44;97;SEC_235
2004;221;12-15;24;22;46;SEC_221
2004;314;75 i +;92;44;136;SEC_314
2004;118;18-24;100;99;199;SEC_118
2004;506;25-34;147;150;297;SEC_506
2004;438;65-74;55;57;112;SEC_438
2004;243;16-17;13;12;25;SEC_243
2004;240;35-49;87;80;167;SEC_240
2004;617;18-24;44;43;87;SEC_617
2004;519;03-11;31;33;64;SEC_519
2004;112;12-15;29;44;73;SEC_112
2004;515;18-24;19;21;40;SEC_515
2004;315;00-02;18;20;38;SEC_315
2004;130;18-24;30;31;61;SEC_130
2004;315;35-49;191;174;365;SEC_315
2004;413;75 i +;38;21;59;SEC_413
2004;131;00-02;13;22;35;SEC_131
2004;324;50-64;68;77;145;SEC_324
2004;205;50-64;92;78;170;SEC_205
2004;438;50-64;83;70;153;SEC_438
2004;209;25-34;84;80;164;SEC_209
2004;203;65-74;44;39;83;SEC_203
2004;617;00-02;8;16;24;SEC_617
2004;140;35-49;91;97;188;SEC_140
2004;135;16-17;22;14;36;SEC_135
2004;426;00-02;18;20;38;SEC_426
2004;218;35-49;89;92;181;SEC_218
2004;127;03-11;25;26;51;SEC_127
2004;421;25-34;104;119;223;SEC_421
2004;502;25-34;151;159;310;SEC_502
2004;435;25-34;85;103;188;SEC_435
2004;125;12-15;30;21;51;SEC_125
2004;522;00-02;22;14;36;SEC_522
2004;513;75 i +;43;21;64;SEC_513
2004;302;00-02;7;20;27;SEC_302
2004;110;16-17;13;10;23;SEC_110
2004;216;18-24;68;60;128;SEC_216
2004;420;25-34;131;186;317;SEC_420
2004;504;65-74;86;87;173;SEC_504
2004;525;00-02;11;6;17;SEC_525
2004;603;50-64;78;61;139;SEC_603
2004;129;75 i +;41;20;61;SEC_129
2004;418;65-74;72;54;126;SEC_418
2004;202;50-64;63;64;127;SEC_202
2004;123;00-02;16;14;30;SEC_123
2004;124;18-24;46;43;89;SEC_124
2004;405;65-74;90;87;177;SEC_405
2004;609;12-15;19;7;26;SEC_609
2004;431;16-17;12;15;27;SEC_431
2004;231;16-17;6;7;13;SEC_231
2004;238;25-34;87;85;172;SEC_238
2004;233;16-17;8;8;16;SEC_233
2004;126;50-64;141;127;268;SEC_126
2004;538;16-17;9;7;16;SEC_538
2004;530;12-15;25;27;52;SEC_530
2004;134;75 i +;66;31;97;SEC_134
2004;405;03-11;21;25;46;SEC_405
2004;306;00-02;20;17;37;SEC_306
2004;407;65-74;76;58;134;SEC_407
2004;617;03-11;30;39;69;SEC_617
2004;225;75 i +;50;30;80;SEC_225
2004;427;16-17;6;8;14;SEC_427
2004;429;03-11;10;22;32;SEC_429
2004;535;35-49;103;105;208;SEC_535
2004;212;50-64;122;109;231;SEC_212
2004;217;00-02;9;9;18;SEC_217
2004;311;50-64;128;100;228;SEC_311
2004;132;03-11;70;83;153;SEC_132
2004;207;12-15;9;7;16;SEC_207
2004;244;35-49;77;88;165;SEC_244
2004;138;65-74;34;36;70;SEC_138
2004;119;03-11;25;32;57;SEC_119
2004;504;25-34;109;142;251;SEC_504
2004;429;00-02;5;8;13;SEC_429
2004;233;03-11;19;39;58;SEC_233
2004;507;00-02;11;12;23;SEC_507
2004;307;00-02;10;14;24;SEC_307
2004;411;75 i +;75;55;130;SEC_411
2004;110;12-15;15;25;40;SEC_110
2004;226;18-24;41;48;89;SEC_226
2004;110;25-34;112;134;246;SEC_110
2004;439;35-49;119;137;256;SEC_439
2004;525;65-74;75;55;130;SEC_525
2004;532;12-15;18;26;44;SEC_532
2004;617;16-17;6;8;14;SEC_617
2004;534;03-11;32;31;63;SEC_534
2004;526;12-15;11;19;30;SEC_526
2004;301;65-74;115;125;240;SEC_301
2004;503;18-24;42;53;95;SEC_503
2004;442;75 i +;32;22;54;SEC_442
2004;222;50-64;81;71;152;SEC_222
2004;431;25-34;162;219;381;SEC_431
2004;128;35-49;89;104;193;SEC_128
2004;610;35-49;99;98;197;SEC_610
2004;220;65-74;63;44;107;SEC_220
2004;619;75 i +;49;42;91;SEC_619
2004;406;75 i +;46;39;85;SEC_406
2004;521;65-74;59;58;117;SEC_521
2004;229;18-24;29;32;61;SEC_229
2004;521;18-24;45;45;90;SEC_521
2004;514;16-17;17;10;27;SEC_514
2004;314;16-17;20;24;44;SEC_314
2004;117;16-17;20;21;41;SEC_117
2004;132;50-64;207;223;430;SEC_132
2004;613;18-24;40;41;81;SEC_613
2004;440;25-34;85;96;181;SEC_440
2004;241;75 i +;61;31;92;SEC_241
2004;119;65-74;67;51;118;SEC_119
2004;429;25-34;39;56;95;SEC_429
2004;404;65-74;88;70;158;SEC_404
2004;424;50-64;61;50;111;SEC_424
2004;511;16-17;3;5;8;SEC_511
2004;613;12-15;11;16;27;SEC_613
2004;249;03-11;31;34;65;SEC_249
2004;510;75 i +;56;30;86;SEC_510
2004;510;25-34;86;106;192;SEC_510
2004;238;75 i +;74;32;106;SEC_238
2004;117;25-34;185;192;377;SEC_117
2004;127;35-49;110;110;220;SEC_127
2004;105;35-49;157;125;282;SEC_105
2004;115;50-64;119;128;247;SEC_115
2004;532;16-17;16;14;30;SEC_532
2004;138;75 i +;30;16;46;SEC_138
2004;528;03-11;46;43;89;SEC_528
2004;308;16-17;19;22;41;SEC_308
2004;117;00-02;22;29;51;SEC_117
2004;321;35-49;288;278;566;SEC_321
2004;137;75 i +;55;30;85;SEC_137
2004;113;12-15;31;32;63;SEC_113
2004;247;65-74;71;62;133;SEC_247
2004;503;12-15;10;18;28;SEC_503
2004;534;25-34;100;142;242;SEC_534
2004;239;25-34;95;134;229;SEC_239
2004;214;18-24;35;37;72;SEC_214
2004;627;12-15;12;25;37;SEC_627
2004;524;65-74;77;58;135;SEC_524
2004;126;00-02;16;14;30;SEC_126
2004;508;18-24;34;37;71;SEC_508
2004;113;25-34;126;140;266;SEC_113
2004;440;00-02;11;9;20;SEC_440
2004;509;00-02;8;12;20;SEC_509
2004;405;35-49;70;82;152;SEC_405
2004;245;03-11;39;33;72;SEC_245
2004;108;03-11;54;48;102;SEC_108
2004;441;16-17;32;27;59;SEC_441
2004;631;25-34;107;128;235;SEC_631
2004;615;25-34;83;92;175;SEC_615
2004;317;18-24;48;54;102;SEC_317
2004;310;35-49;102;105;207;SEC_310
2004;121;25-34;84;84;168;SEC_121
2004;240;16-17;4;4;8;SEC_240
2004;608;16-17;7;8;15;SEC_608
2004;424;25-34;65;77;142;SEC_424
2004;138;00-02;7;6;13;SEC_138
2004;232;25-34;95;109;204;SEC_232
2004;513;50-64;67;52;119;SEC_513
2004;212;35-49;148;160;308;SEC_212
2004;121;50-64;42;43;85;SEC_121
2004;620;00-02;1;7;8;SEC_620
2004;307;18-24;68;67;135;SEC_307
2004;227;16-17;1;2;3;SEC_227
2004;137;00-02;22;19;41;SEC_137
2004;246;03-11;31;40;71;SEC_246
2004;111;75 i +;47;33;80;SEC_111
2004;313;18-24;109;81;190;SEC_313
2004;129;35-49;117;116;233;SEC_129
2004;246;35-49;100;143;243;SEC_246
2004;524;16-17;10;13;23;SEC_524
2004;518;35-49;112;127;239;SEC_518
2004;205;35-49;89;98;187;SEC_205
2004;426;35-49;105;116;221;SEC_426
2004;319;00-02;33;26;59;SEC_319
2004;321;12-15;47;56;103;SEC_321
2004;429;75 i +;31;21;52;SEC_429
2004;621;16-17;14;14;28;SEC_621
2004;423;00-02;13;9;22;SEC_423
2004;215;25-34;83;87;170;SEC_215
2004;405;00-02;9;12;21;SEC_405
2004;608;75 i +;39;19;58;SEC_608
2004;216;75 i +;63;43;106;SEC_216
2004;210;50-64;95;80;175;SEC_210
2004;130;16-17;6;3;9;SEC_130
2004;608;25-34;73;89;162;SEC_608
2004;249;00-02;18;16;34;SEC_249
2004;442;25-34;50;65;115;SEC_442
2004;416;25-34;67;89;156;SEC_416
2004;234;65-74;65;37;102;SEC_234
2004;604;75 i +;26;14;40;SEC_604
2004;410;12-15;16;20;36;SEC_410
2004;314;25-34;205;219;424;SEC_314
2004;521;25-34;85;110;195;SEC_521
2004;619;16-17;15;9;24;SEC_619
2004;609;00-02;12;7;19;SEC_609
2004;409;65-74;41;33;74;SEC_409
2004;624;35-49;80;104;184;SEC_624
2004;431;00-02;28;25;53;SEC_431
2004;138;35-49;90;79;169;SEC_138
2004;138;18-24;40;54;94;SEC_138
2004;218;65-74;36;25;61;SEC_218
2004;506;65-74;84;84;168;SEC_506
2004;213;25-34;94;101;195;SEC_213
2004;512;16-17;4;8;12;SEC_512
2004;115;65-74;70;44;114;SEC_115
2004;605;75 i +;31;21;52;SEC_605
2004;533;75 i +;33;28;61;SEC_533
2004;238;00-02;10;11;21;SEC_238
2004;431;18-24;77;83;160;SEC_431
2004;132;25-34;176;214;390;SEC_132
2004;116;03-11;53;43;96;SEC_116
2004;420;16-17;8;16;24;SEC_420
2004;111;03-11;16;27;43;SEC_111
2004;318;12-15;23;22;45;SEC_318
2004;208;50-64;199;155;354;SEC_208
2004;420;18-24;71;74;145;SEC_420
2004;216;35-49;138;116;254;SEC_216
2004;405;18-24;31;29;60;SEC_405
2004;205;03-11;31;23;54;SEC_205
2004;117;18-24;109;111;220;SEC_117
2004;301;12-15;35;41;76;SEC_301
2004;215;03-11;30;34;64;SEC_215
2004;511;03-11;27;24;51;SEC_511
2004;318;00-02;4;12;16;SEC_318
2004;314;00-02;23;32;55;SEC_314
2004;609;18-24;34;26;60;SEC_609
2004;413;35-49;57;75;132;SEC_413
2004;536;18-24;37;40;77;SEC_536
2004;601;65-74;75;86;161;SEC_601
2004;223;16-17;5;7;12;SEC_223
2004;506;35-49;183;186;369;SEC_506
2004;101;65-74;45;43;88;SEC_101
2004;226;65-74;74;49;123;SEC_226
2004;517;75 i +;50;23;73;SEC_517
2004;507;65-74;36;34;70;SEC_507
2004;204;00-02;9;4;13;SEC_204
2004;244;03-11;17;21;38;SEC_244
2004;441;00-02;24;20;44;SEC_441
2004;508;16-17;6;4;10;SEC_508
2004;307;12-15;12;32;44;SEC_307
2004;621;65-74;51;47;98;SEC_621
2004;611;18-24;77;56;133;SEC_611
2004;621;35-49;132;118;250;SEC_621
2004;506;12-15;32;44;76;SEC_506
2004;415;00-02;10;12;22;SEC_415
2004;440;35-49;74;94;168;SEC_440
2004;120;65-74;46;48;94;SEC_120
2004;617;65-74;65;53;118;SEC_617
2004;523;18-24;62;68;130;SEC_523
2004;324;35-49;99;113;212;SEC_324
2004;628;18-24;48;41;89;SEC_628
2004;226;03-11;38;36;74;SEC_226
2004;515;25-34;56;76;132;SEC_515
2004;410;03-11;46;72;118;SEC_410
2004;528;50-64;112;93;205;SEC_528
2004;630;03-11;21;32;53;SEC_630
2004;226;25-34;119;120;239;SEC_226
2004;225;25-34;39;53;92;SEC_225
2004;530;00-02;17;15;32;SEC_530
2004;513;65-74;58;46;104;SEC_513
2004;419;03-11;44;44;88;SEC_419
2004;502;18-24;81;69;150;SEC_502
2004;132;75 i +;63;40;103;SEC_132
2004;435;00-02;14;16;30;SEC_435
2004;625;50-64;164;179;343;SEC_625
2004;108;25-34;105;105;210;SEC_108
2004;604;18-24;35;36;71;SEC_604
2004;126;35-49;71;75;146;SEC_126
2004;308;25-34;184;178;362;SEC_308
2004;401;03-11;49;45;94;SEC_401
2004;524;03-11;54;55;109;SEC_524
2004;103;12-15;15;7;22;SEC_103
2004;408;65-74;58;49;107;SEC_408
2004;523;12-15;19;21;40;SEC_523
2004;537;75 i +;64;38;102;SEC_537
2004;406;65-74;77;78;155;SEC_406
2004;534;16-17;8;11;19;SEC_534
2004;225;00-02;0;2;2;SEC_225
2004;516;65-74;46;32;78;SEC_516
2004;432;00-02;10;9;19;SEC_432
2004;201;16-17;7;5;12;SEC_201
2004;221;18-24;42;59;101;SEC_221
2004;536;75 i +;45;39;84;SEC_536
2004;616;12-15;68;75;143;SEC_616
2004;412;65-74;95;100;195;SEC_412
2004;428;25-34;57;68;125;SEC_428
2004;232;16-17;9;9;18;SEC_232
2004;101;12-15;17;29;46;SEC_101
2004;139;16-17;5;7;12;SEC_139
2004;530;25-34;131;178;309;SEC_530
2004;132;35-49;245;243;488;SEC_132
2004;134;65-74;44;39;83;SEC_134
2004;416;12-15;8;17;25;SEC_416
2004;422;16-17;11;13;24;SEC_422
2004;242;25-34;87;115;202;SEC_242
2004;207;75 i +;65;28;93;SEC_207
2004;428;75 i +;24;24;48;SEC_428
2004;411;18-24;47;50;97;SEC_411
2004;513;16-17;6;4;10;SEC_513
2004;316;50-64;269;301;570;SEC_316
2004;235;35-49;146;157;303;SEC_235
2004;522;18-24;53;48;101;SEC_522
2004;438;03-11;27;32;59;SEC_438
2004;431;12-15;25;20;45;SEC_431
2004;407;35-49;115;102;217;SEC_407
2004;110;00-02;12;9;21;SEC_110
2004;236;00-02;22;11;33;SEC_236
2004;218;25-34;63;81;144;SEC_218
2004;130;35-49;106;124;230;SEC_130
2004;311;16-17;12;13;25;SEC_311
2004;417;25-34;59;79;138;SEC_417
2004;605;35-49;50;50;100;SEC_605
2004;127;65-74;45;39;84;SEC_127
2004;131;35-49;153;150;303;SEC_131
2004;120;25-34;150;152;302;SEC_120
2004;433;65-74;53;44;97;SEC_433
2004;224;18-24;26;30;56;SEC_224
2004;233;75 i +;64;25;89;SEC_233
2004;511;25-34;61;72;133;SEC_511
2004;227;03-11;27;24;51;SEC_227
2004;420;03-11;48;53;101;SEC_420
2004;527;12-15;23;14;37;SEC_527
2004;106;65-74;65;39;104;SEC_106
2004;248;03-11;42;33;75;SEC_248
2004;632;18-24;34;55;89;SEC_632
2004;527;03-11;41;26;67;SEC_527
2004;248;65-74;61;56;117;SEC_248
2004;126;03-11;34;30;64;SEC_126
2004;223;35-49;129;165;294;SEC_223
2004;122;03-11;33;32;65;SEC_122
2004;401;12-15;26;29;55;SEC_401
2004;317;12-15;15;19;34;SEC_317
2004;615;35-49;58;71;129;SEC_615
2004;239;50-64;91;80;171;SEC_239
2004;325;75 i +;156;83;239;SEC_325
2004;413;12-15;9;9;18;SEC_413
2004;612;18-24;39;38;77;SEC_612
2004;606;35-49;118;122;240;SEC_606
2004;528;16-17;19;8;27;SEC_528
2004;102;75 i +;75;41;116;SEC_102
2004;128;75 i +;45;28;73;SEC_128
2004;222;12-15;20;19;39;SEC_222
2004;418;16-17;5;15;20;SEC_418
2004;514;03-11;31;31;62;SEC_514
2004;631;12-15;21;15;36;SEC_631
2004;426;16-17;11;9;20;SEC_426
2004;224;03-11;17;22;39;SEC_224
2004;222;16-17;10;12;22;SEC_222
2004;531;65-74;50;48;98;SEC_531
2004;532;03-11;55;26;81;SEC_532
2004;616;16-17;38;39;77;SEC_616
2004;101;00-02;38;34;72;SEC_101
2004;136;03-11;40;46;86;SEC_136
2004;531;35-49;90;113;203;SEC_531
2004;603;03-11;24;25;49;SEC_603
2004;236;16-17;15;5;20;SEC_236
2004;317;50-64;69;79;148;SEC_317
2004;603;12-15;8;12;20;SEC_603
2004;433;35-49;126;127;253;SEC_433
2004;123;16-17;9;7;16;SEC_123
2004;623;65-74;56;64;120;SEC_623
2004;501;35-49;108;87;195;SEC_501
2004;140;50-64;107;97;204;SEC_140
2004;224;65-74;37;22;59;SEC_224
2004;213;50-64;95;91;186;SEC_213
2004;238;03-11;24;25;49;SEC_238
2004;410;75 i +;92;78;170;SEC_410
2004;526;75 i +;39;18;57;SEC_526
2004;411;65-74;81;57;138;SEC_411
2004;512;50-64;74;75;149;SEC_512
2004;625;16-17;17;26;43;SEC_625
2004;528;75 i +;52;41;93;SEC_528
2004;128;65-74;46;52;98;SEC_128
2004;129;16-17;9;9;18;SEC_129
2004;139;12-15;16;13;29;SEC_139
2004;440;75 i +;60;39;99;SEC_440
2004;311;18-24;49;46;95;SEC_311
2004;104;12-15;14;9;23;SEC_104
2004;320;65-74;31;23;54;SEC_320
2004;213;12-15;18;14;32;SEC_213
2004;133;25-34;88;110;198;SEC_133
2004;302;35-49;130;136;266;SEC_302
2004;112;00-02;23;15;38;SEC_112
2004;114;18-24;74;76;150;SEC_114
2004;506;00-02;12;20;32;SEC_506
2004;313;75 i +;72;37;109;SEC_313
2004;535;65-74;41;52;93;SEC_535
2004;306;16-17;27;18;45;SEC_306
2004;430;50-64;74;58;132;SEC_430
2004;228;35-49;62;90;152;SEC_228
2004;435;18-24;46;54;100;SEC_435
2004;509;65-74;42;37;79;SEC_509
2004;316;25-34;130;148;278;SEC_316
2004;625;12-15;33;24;57;SEC_625
2004;629;25-34;49;50;99;SEC_629
2004;115;18-24;64;65;129;SEC_115
2004;607;50-64;117;83;200;SEC_607
2004;134;18-24;55;59;114;SEC_134
2004;402;35-49;79;97;176;SEC_402
2004;410;65-74;129;114;243;SEC_410
2004;423;12-15;16;15;31;SEC_423
2004;630;18-24;63;48;111;SEC_630
2004;434;16-17;11;5;16;SEC_434
2004;137;03-11;54;60;114;SEC_137
2004;409;03-11;26;18;44;SEC_409
2004;433;16-17;14;8;22;SEC_433
2004;508;25-34;65;59;124;SEC_508
2004;510;50-64;109;92;201;SEC_510
2004;324;18-24;46;43;89;SEC_324
2004;601;00-02;18;15;33;SEC_601
2004;602;25-34;57;64;121;SEC_602
2004;528;00-02;16;16;32;SEC_528
2004;604;16-17;2;5;7;SEC_604
2004;611;25-34;179;216;395;SEC_611
2004;324;75 i +;49;25;74;SEC_324
2004;616;18-24;151;150;301;SEC_616
2004;624;18-24;48;46;94;SEC_624
2004;313;25-34;199;186;385;SEC_313
2004;613;25-34;128;143;271;SEC_613
2004;212;75 i +;63;40;103;SEC_212
2004;112;35-49;208;175;383;SEC_112
2004;440;50-64;138;117;255;SEC_440
2004;204;16-17;4;3;7;SEC_204
2004;526;50-64;58;54;112;SEC_526
2004;319;65-74;50;32;82;SEC_319
2004;442;03-11;25;23;48;SEC_442
2004;504;50-64;142;108;250;SEC_504
2004;321;16-17;14;23;37;SEC_321
2004;622;03-11;24;42;66;SEC_622
2004;412;12-15;21;25;46;SEC_412
2004;609;50-64;122;106;228;SEC_609
2004;625;00-02;12;16;28;SEC_625
2004;221;75 i +;39;34;73;SEC_221
2004;404;50-64;117;111;228;SEC_404
2004;131;65-74;55;49;104;SEC_131
2004;616;25-34;229;267;496;SEC_616
2004;247;35-49;154;166;320;SEC_247
2004;323;16-17;34;32;66;SEC_323
2004;225;50-64;56;41;97;SEC_225
2004;231;75 i +;93;42;135;SEC_231
2004;313;16-17;18;12;30;SEC_313
2004;510;65-74;57;54;111;SEC_510
2004;138;12-15;14;16;30;SEC_138
2004;135;18-24;76;97;173;SEC_135
2004;306;65-74;94;73;167;SEC_306
2004;223;65-74;72;60;132;SEC_223
2004;411;35-49;97;104;201;SEC_411
2004;612;65-74;61;60;121;SEC_612
2004;421;00-02;13;14;27;SEC_421
2004;415;35-49;80;94;174;SEC_415
2004;245;00-02;12;17;29;SEC_245
2004;602;50-64;63;53;116;SEC_602
2004;215;00-02;13;11;24;SEC_215
2004;417;35-49;74;84;158;SEC_417
2004;115;12-15;19;32;51;SEC_115
2004;135;50-64;154;163;317;SEC_135
2004;222;18-24;49;54;103;SEC_222
2004;509;25-34;82;98;180;SEC_509
2004;140;00-02;12;15;27;SEC_140
2004;530;18-24;56;59;115;SEC_530
2004;125;03-11;37;49;86;SEC_125
2004;137;65-74;51;32;83;SEC_137
2004;308;18-24;87;83;170;SEC_308
2004;437;50-64;73;51;124;SEC_437
2004;408;18-24;41;40;81;SEC_408
2004;610;00-02;19;16;35;SEC_610
2004;432;75 i +;56;40;96;SEC_432
2004;124;00-02;11;11;22;SEC_124
2004;421;18-24;38;39;77;SEC_421
2004;246;75 i +;73;40;113;SEC_246
2004;127;25-34;77;83;160;SEC_127
2004;429;50-64;53;61;114;SEC_429
2004;520;18-24;34;34;68;SEC_520
2004;527;65-74;61;44;105;SEC_527
2004;247;25-34;118;157;275;SEC_247
2004;304;16-17;10;11;21;SEC_304
2004;519;00-02;12;6;18;SEC_519
2004;623;25-34;153;160;313;SEC_623
2004;301;50-64;211;196;407;SEC_301
2004;305;18-24;85;79;164;SEC_305
2004;615;03-11;26;25;51;SEC_615
2004;246;50-64;68;59;127;SEC_246
2004;529;35-49;136;129;265;SEC_529
2004;247;50-64;95;96;191;SEC_247
2004;513;03-11;28;26;54;SEC_513
2004;518;00-02;20;20;40;SEC_518
2004;132;18-24;109;111;220;SEC_132
2004;107;18-24;89;90;179;SEC_107
2004;133;75 i +;56;35;91;SEC_133
2004;242;65-74;92;57;149;SEC_242
2004;404;12-15;24;30;54;SEC_404
2004;624;25-34;108;157;265;SEC_624
2004;505;25-34;127;137;264;SEC_505
2004;538;35-49;126;116;242;SEC_538
2004;129;18-24;57;51;108;SEC_129
2004;406;12-15;28;18;46;SEC_406
2004;419;16-17;10;6;16;SEC_419
2004;517;35-49;156;160;316;SEC_517
2004;233;35-49;93;110;203;SEC_233
2004;621;50-64;222;227;449;SEC_621
2004;229;16-17;10;6;16;SEC_229
2004;432;25-34;96;112;208;SEC_432
2004;608;35-49;93;78;171;SEC_608
2004;322;75 i +;46;36;82;SEC_322
2004;246;12-15;18;20;38;SEC_246
2004;501;65-74;33;33;66;SEC_501
2004;106;12-15;28;32;60;SEC_106
2004;247;03-11;43;41;84;SEC_247
2004;426;50-64;84;66;150;SEC_426
2004;234;25-34;93;104;197;SEC_234
2004;114;35-49;159;155;314;SEC_114
2004;113;00-02;18;21;39;SEC_113
2004;234;75 i +;81;42;123;SEC_234
2004;135;25-34;136;145;281;SEC_135
2004;502;65-74;71;66;137;SEC_502
2004;520;03-11;25;36;61;SEC_520
2004;518;25-34;118;104;222;SEC_518
2004;604;35-49;83;87;170;SEC_604
2004;140;65-74;66;52;118;SEC_140
2004;627;03-11;31;25;56;SEC_627
2004;422;75 i +;69;44;113;SEC_422
2004;124;50-64;74;67;141;SEC_124
2004;405;25-34;80;85;165;SEC_405
2004;245;35-49;125;139;264;SEC_245
2004;502;35-49;148;142;290;SEC_502
2004;309;18-24;35;31;66;SEC_309
2004;102;25-34;145;153;298;SEC_102
2004;608;50-64;79;72;151;SEC_608
2004;442;65-74;27;28;55;SEC_442
2004;614;18-24;31;34;65;SEC_614
2004;323;50-64;301;340;641;SEC_323
2004;623;18-24;65;82;147;SEC_623
2004;402;50-64;73;68;141;SEC_402
2004;134;25-34;114;101;215;SEC_134
2004;629;50-64;55;46;101;SEC_629
2004;201;65-74;50;48;98;SEC_201
2004;434;12-15;13;17;30;SEC_434
2004;211;75 i +;82;45;127;SEC_211
2004;437;03-11;31;38;69;SEC_437
2004;414;16-17;4;9;13;SEC_414
2004;322;50-64;103;93;196;SEC_322
2004;223;18-24;45;60;105;SEC_223
2004;434;03-11;25;22;47;SEC_434
2004;422;65-74;66;56;122;SEC_422
2004;136;12-15;17;20;37;SEC_136
2004;205;00-02;11;9;20;SEC_205
2004;133;12-15;12;15;27;SEC_133
2004;632;00-02;18;13;31;SEC_632
2004;234;16-17;6;7;13;SEC_234
2004;208;65-74;140;128;268;SEC_208
2004;201;35-49;61;63;124;SEC_201
2004;110;65-74;66;41;107;SEC_110
2004;403;12-15;11;18;29;SEC_403
2004;610;25-34;106;116;222;SEC_610
2004;629;75 i +;29;15;44;SEC_629
2004;601;12-15;17;24;41;SEC_601
2004;305;25-34;115;125;240;SEC_305
2004;533;16-17;15;10;25;SEC_533
2004;315;18-24;66;79;145;SEC_315
2004;234;18-24;26;40;66;SEC_234
2004;626;16-17;8;5;13;SEC_626
2004;136;65-74;58;43;101;SEC_136
2004;137;16-17;12;14;26;SEC_137
2004;303;00-02;10;14;24;SEC_303
2004;244;16-17;5;4;9;SEC_244
2004;115;16-17;7;7;14;SEC_115
2004;522;03-11;28;37;65;SEC_522
2004;236;25-34;107;133;240;SEC_236
2004;243;25-34;155;121;276;SEC_243
2004;605;25-34;62;67;129;SEC_605
2004;303;16-17;7;9;16;SEC_303
2004;628;50-64;145;125;270;SEC_628
2004;232;03-11;34;25;59;SEC_232
2004;412;25-34;137;174;311;SEC_412
2004;402;03-11;33;30;63;SEC_402
2004;623;75 i +;53;32;85;SEC_623
2004;622;35-49;95;85;180;SEC_622
2004;412;75 i +;71;45;116;SEC_412
2004;130;12-15;13;22;35;SEC_130
2004;527;16-17;9;10;19;SEC_527
2004;408;16-17;11;7;18;SEC_408
2004;439;00-02;14;28;42;SEC_439
2004;319;50-64;120;129;249;SEC_319
2004;405;75 i +;46;33;79;SEC_405
2004;530;35-49;148;175;323;SEC_530
2004;506;18-24;80;100;180;SEC_506
2004;225;65-74;34;24;58;SEC_225
2004;511;50-64;50;44;94;SEC_511
2004;429;65-74;54;23;77;SEC_429
2004;414;75 i +;55;38;93;SEC_414
2004;401;50-64;88;92;180;SEC_401
2004;624;00-02;16;12;28;SEC_624
2004;114;50-64;190;182;372;SEC_114
2004;607;03-11;34;43;77;SEC_607
2004;626;25-34;71;94;165;SEC_626
2004;232;35-49;107;109;216;SEC_232
2004;431;03-11;54;69;123;SEC_431
2004;242;00-02;14;8;22;SEC_242
2004;128;25-34;107;112;219;SEC_128
2004;325;65-74;119;86;205;SEC_325
2004;601;50-64;164;140;304;SEC_601
2004;532;18-24;61;60;121;SEC_532
2004;612;50-64;146;118;264;SEC_612
2004;212;25-34;136;170;306;SEC_212
2004;606;50-64;101;61;162;SEC_606
2004;534;50-64;91;84;175;SEC_534
2004;239;35-49;113;124;237;SEC_239
2004;244;12-15;11;8;19;SEC_244
2004;240;12-15;7;15;22;SEC_240
2004;209;35-49;114;124;238;SEC_209
2004;611;03-11;62;62;124;SEC_611
2004;404;00-02;18;19;37;SEC_404
2004;304;00-02;20;16;36;SEC_304
2004;632;50-64;90;85;175;SEC_632
2004;606;65-74;70;73;143;SEC_606
2004;245;18-24;42;51;93;SEC_245
2004;134;12-15;24;17;41;SEC_134
2004;504;03-11;24;28;52;SEC_504
2004;416;03-11;36;34;70;SEC_416
2004;119;25-34;92;117;209;SEC_119
2004;241;16-17;5;7;12;SEC_241
2004;441;18-24;106;113;219;SEC_441
2004;310;25-34;95;111;206;SEC_310
2004;128;16-17;7;7;14;SEC_128
2004;519;75 i +;20;23;43;SEC_519
2004;518;03-11;41;34;75;SEC_518
2004;102;50-64;200;179;379;SEC_102
2004;113;18-24;88;81;169;SEC_113
2004;413;50-64;43;37;80;SEC_413
2004;243;03-11;52;54;106;SEC_243
2004;317;25-34;133;140;273;SEC_317
2004;409;16-17;6;9;15;SEC_409
2004;308;75 i +;82;46;128;SEC_308
2004;110;03-11;28;32;60;SEC_110
2004;538;75 i +;72;37;109;SEC_538
2004;411;50-64;110;89;199;SEC_411
2004;403;65-74;78;84;162;SEC_403
2004;208;25-34;140;118;258;SEC_208
2004;426;25-34;112;146;258;SEC_426
2004;111;16-17;9;7;16;SEC_111
2004;239;16-17;0;9;9;SEC_239
2004;519;25-34;63;70;133;SEC_519
2004;523;50-64;117;112;229;SEC_523
2004;535;12-15;16;22;38;SEC_535
2004;612;12-15;14;12;26;SEC_612
2004;325;18-24;75;69;144;SEC_325
2004;502;16-17;15;19;34;SEC_502
2004;630;75 i +;29;20;49;SEC_630
2004;118;12-15;37;26;63;SEC_118
2004;620;12-15;14;17;31;SEC_620
2004;320;18-24;29;29;58;SEC_320
2004;537;65-74;83;61;144;SEC_537
2004;519;50-64;46;38;84;SEC_519
2004;103;50-64;62;62;124;SEC_103
2004;425;16-17;8;10;18;SEC_425
2004;508;35-49;58;87;145;SEC_508
2004;127;12-15;18;16;34;SEC_127
2004;612;75 i +;41;22;63;SEC_612
2004;435;16-17;18;14;32;SEC_435
2004;223;03-11;45;46;91;SEC_223
2004;111;25-34;85;110;195;SEC_111
2004;535;16-17;13;8;21;SEC_535
2004;615;18-24;31;23;54;SEC_615
2004;107;50-64;176;164;340;SEC_107
2004;227;35-49;76;74;150;SEC_227
2004;514;65-74;55;43;98;SEC_514
2004;136;00-02;19;18;37;SEC_136
2004;209;65-74;68;47;115;SEC_209
2004;534;75 i +;55;27;82;SEC_534
2004;605;18-24;24;22;46;SEC_605
2004;412;18-24;79;92;171;SEC_412
2004;102;35-49;151;163;314;SEC_102
2004;433;75 i +;42;22;64;SEC_433
2004;626;35-49;96;99;195;SEC_626
2004;632;35-49;95;90;185;SEC_632
2004;127;00-02;13;12;25;SEC_127
2004;517;00-02;20;17;37;SEC_517
2004;238;18-24;27;35;62;SEC_238
2004;524;00-02;19;17;36;SEC_524
2004;420;65-74;85;65;150;SEC_420
2004;308;03-11;81;98;179;SEC_308
2004;213;00-02;9;17;26;SEC_213
2004;404;35-49;137;153;290;SEC_404
2004;315;25-34;176;181;357;SEC_315
2004;509;03-11;36;45;81;SEC_509
2004;134;00-02;12;18;30;SEC_134
2004;629;65-74;41;37;78;SEC_629
2004;537;03-11;45;47;92;SEC_537
2004;310;75 i +;36;23;59;SEC_310
2004;537;12-15;26;16;42;SEC_537
2004;125;35-49;146;153;299;SEC_125
2004;122;16-17;7;8;15;SEC_122
2004;124;03-11;18;27;45;SEC_124
2004;526;00-02;17;8;25;SEC_526
2004;403;35-49;93;104;197;SEC_403
2004;426;18-24;59;51;110;SEC_426
2004;420;50-64;109;85;194;SEC_420
2004;512;25-34;80;100;180;SEC_512
2004;235;25-34;158;175;333;SEC_235
2004;407;00-02;11;15;26;SEC_407
2004;440;03-11;32;35;67;SEC_440
2004;230;16-17;5;9;14;SEC_230
2004;518;65-74;82;80;162;SEC_518
2004;236;18-24;47;44;91;SEC_236
2004;512;00-02;10;11;21;SEC_512
2004;103;16-17;7;3;10;SEC_103
2004;310;00-02;14;20;34;SEC_310
2004;305;65-74;63;59;122;SEC_305
2004;404;75 i +;65;31;96;SEC_404
2004;109;18-24;51;40;91;SEC_109
2004;629;35-49;64;65;129;SEC_629
2004;614;35-49;92;89;181;SEC_614
2004;423;25-34;80;111;191;SEC_423
2004;402;12-15;14;8;22;SEC_402
2004;418;18-24;61;65;126;SEC_418
2004;212;00-02;18;21;39;SEC_212
2004;505;75 i +;47;39;86;SEC_505
2004;313;35-49;207;190;397;SEC_313
2004;439;75 i +;45;23;68;SEC_439
2004;114;65-74;77;72;149;SEC_114
2004;124;75 i +;31;22;53;SEC_124
2004;420;35-49;157;170;327;SEC_420
2004;233;25-34;83;116;199;SEC_233
2004;607;35-49;131;110;241;SEC_607
2004;314;50-64;210;218;428;SEC_314
2004;212;65-74;81;61;142;SEC_212
2004;518;12-15;18;21;39;SEC_518
2004;123;12-15;33;27;60;SEC_123
2004;103;75 i +;42;21;63;SEC_103
2004;242;35-49;118;116;234;SEC_242
2004;126;12-15;10;6;16;SEC_126
2004;537;50-64;142;121;263;SEC_537
2004;601;16-17;8;6;14;SEC_601
2004;628;12-15;20;10;30;SEC_628
2004;101;50-64;116;138;254;SEC_101
2004;501;18-24;51;70;121;SEC_501
2004;319;75 i +;35;22;57;SEC_319
2004;317;35-49;100;115;215;SEC_317
2004;121;16-17;3;6;9;SEC_121
2004;301;18-24;86;107;193;SEC_301
2004;232;12-15;13;14;27;SEC_232
2004;427;75 i +;41;40;81;SEC_427
2004;422;35-49;110;134;244;SEC_422
2004;609;75 i +;29;21;50;SEC_609
2004;305;00-02;15;17;32;SEC_305
2004;136;75 i +;63;34;97;SEC_136
2004;113;75 i +;45;24;69;SEC_113
2004;117;12-15;40;25;65;SEC_117
2004;106;18-24;117;102;219;SEC_106
2004;536;50-64;87;70;157;SEC_536
2004;230;75 i +;54;25;79;SEC_230
2004;242;75 i +;65;56;121;SEC_242
2004;318;03-11;33;44;77;SEC_318
2004;104;25-34;77;80;157;SEC_104
2004;207;18-24;27;22;49;SEC_207
2004;134;03-11;55;50;105;SEC_134
2004;411;00-02;5;6;11;SEC_411
2004;228;50-64;58;55;113;SEC_228
2004;121;03-11;34;44;78;SEC_121
2004;223;12-15;21;26;47;SEC_223
2004;605;65-74;54;55;109;SEC_605
2004;410;00-02;15;22;37;SEC_410
2004;416;16-17;9;5;14;SEC_416
2004;437;18-24;41;42;83;SEC_437
2004;508;65-74;32;30;62;SEC_508
2004;439;50-64;69;57;126;SEC_439
2004;515;50-64;46;42;88;SEC_515
2004;531;18-24;32;38;70;SEC_531
2004;309;16-17;7;8;15;SEC_309
2004;119;18-24;65;59;124;SEC_119
2004;123;25-34;121;112;233;SEC_123
2004;312;16-17;17;11;28;SEC_312
2004;229;50-64;61;45;106;SEC_229
2004;425;50-64;82;78;160;SEC_425
2004;428;00-02;14;7;21;SEC_428
2004;322;00-02;15;23;38;SEC_322
2004;412;50-64;194;169;363;SEC_412
2004;109;65-74;52;38;90;SEC_109
2004;523;03-11;38;41;79;SEC_523
2004;521;00-02;8;15;23;SEC_521
2004;440;12-15;5;9;14;SEC_440
2004;121;12-15;10;15;25;SEC_121
2004;535;18-24;53;59;112;SEC_535
2004;501;03-11;38;32;70;SEC_501
2004;320;03-11;35;37;72;SEC_320
2004;130;50-64;71;59;130;SEC_130
2004;239;18-24;47;39;86;SEC_239
2004;622;00-02;9;11;20;SEC_622
2004;242;12-15;12;14;26;SEC_242
2004;628;75 i +;41;23;64;SEC_628
2004;414;00-02;18;19;37;SEC_414
2004;426;03-11;31;37;68;SEC_426
2004;217;50-64;37;34;71;SEC_217
2004;230;18-24;37;35;72;SEC_230
2004;227;00-02;15;14;29;SEC_227
2004;307;16-17;11;16;27;SEC_307
2004;133;50-64;96;86;182;SEC_133
2004;513;35-49;83;96;179;SEC_513
2004;244;50-64;55;41;96;SEC_244
2004;432;35-49;112;124;236;SEC_432
2004;423;65-74;69;64;133;SEC_423
2004;513;25-34;70;62;132;SEC_513
2004;202;25-34;87;99;186;SEC_202
2004;422;03-11;31;41;72;SEC_422
2004;501;75 i +;16;7;23;SEC_501
2004;223;50-64;92;82;174;SEC_223
2004;223;25-34;109;124;233;SEC_223
2004;435;65-74;75;37;112;SEC_435
2004;514;50-64;53;46;99;SEC_514
2004;423;75 i +;49;33;82;SEC_423
2004;529;65-74;83;81;164;SEC_529
2004;249;25-34;103;125;228;SEC_249
2004;523;16-17;8;15;23;SEC_523
2004;524;12-15;22;22;44;SEC_524
2004;301;75 i +;84;44;128;SEC_301
2004;603;75 i +;24;13;37;SEC_603
2004;415;25-34;75;111;186;SEC_415
2004;522;12-15;12;10;22;SEC_522
2004;232;75 i +;66;35;101;SEC_232
2004;536;35-49;92;104;196;SEC_536
2004;105;00-02;17;13;30;SEC_105
2004;216;65-74;75;65;140;SEC_216
2004;220;00-02;14;10;24;SEC_220
2004;111;18-24;39;34;73;SEC_111
2004;412;00-02;21;18;39;SEC_412
2004;226;12-15;10;17;27;SEC_226
2004;423;50-64;80;82;162;SEC_423
2004;120;50-64;155;149;304;SEC_120
2004;135;35-49;188;166;354;SEC_135
2004;239;75 i +;88;57;145;SEC_239
2004;629;18-24;22;30;52;SEC_629
2004;103;25-34;76;72;148;SEC_103
2004;249;12-15;12;18;30;SEC_249
2004;117;03-11;94;77;171;SEC_117
2004;321;03-11;85;92;177;SEC_321
2004;325;16-17;12;12;24;SEC_325
2004;421;75 i +;65;37;102;SEC_421
2004;208;16-17;15;9;24;SEC_208
2004;218;50-64;83;68;151;SEC_218
2004;213;18-24;51;51;102;SEC_213
2004;531;03-11;24;35;59;SEC_531
2004;233;00-02;17;9;26;SEC_233
2004;102;18-24;62;61;123;SEC_102
2004;428;50-64;36;34;70;SEC_428
2004;419;18-24;41;37;78;SEC_419
2004;227;50-64;69;57;126;SEC_227
2004;623;50-64;221;185;406;SEC_623
2004;115;25-34;112;129;241;SEC_115
2004;221;25-34;104;110;214;SEC_221
2004;437;12-15;15;21;36;SEC_437
2004;528;12-15;19;12;31;SEC_528
2004;627;65-74;39;36;75;SEC_627
2004;521;50-64;172;159;331;SEC_521
2004;234;03-11;31;24;55;SEC_234
2004;533;35-49;100;130;230;SEC_533
2004;215;12-15;10;12;22;SEC_215
2004;533;50-64;73;57;130;SEC_533
2004;436;12-15;12;30;42;SEC_436
2004;205;25-34;62;70;132;SEC_205
2004;512;03-11;29;36;65;SEC_512
2004;226;00-02;10;12;22;SEC_226
2004;133;00-02;12;16;28;SEC_133
2004;302;75 i +;48;31;79;SEC_302
2004;532;00-02;20;24;44;SEC_532
2004;112;50-64;159;156;315;SEC_112
2004;437;00-02;16;16;32;SEC_437
2004;224;00-02;10;6;16;SEC_224
2004;520;35-49;82;77;159;SEC_520
2004;224;35-49;86;85;171;SEC_224
2004;536;03-11;26;28;54;SEC_536
2004;629;03-11;17;20;37;SEC_629
2004;514;25-34;73;81;154;SEC_514
2004;403;25-34;71;90;161;SEC_403
2004;620;18-24;32;25;57;SEC_620
2004;408;00-02;8;12;20;SEC_408
2004;244;25-34;78;63;141;SEC_244
2004;404;25-34;126;147;273;SEC_404
2004;309;35-49;108;93;201;SEC_309
2004;503;25-34;73;78;151;SEC_503
2004;606;75 i +;54;24;78;SEC_606
2004;424;16-17;5;4;9;SEC_424
2004;116;12-15;21;31;52;SEC_116
2004;325;25-34;119;144;263;SEC_325
2004;530;16-17;10;12;22;SEC_530
2004;229;35-49;82;92;174;SEC_229
2004;604;03-11;27;23;50;SEC_604
2004;311;00-02;19;22;41;SEC_311
2004;229;25-34;75;88;163;SEC_229
2004;630;12-15;15;17;32;SEC_630
2004;213;16-17;17;9;26;SEC_213
2004;320;35-49;108;107;215;SEC_320
2004;631;65-74;52;52;104;SEC_631
2004;109;03-11;37;43;80;SEC_109
2004;316;65-74;43;43;86;SEC_316
2004;402;18-24;35;32;67;SEC_402
2004;607;75 i +;35;23;58;SEC_607
2004;612;00-02;15;11;26;SEC_612
2004;431;50-64;121;109;230;SEC_431
2004;312;25-34;184;191;375;SEC_312
2004;227;65-74;42;36;78;SEC_227
2004;122;18-24;40;32;72;SEC_122
2004;207;16-17;6;8;14;SEC_207
2004;512;35-49;93;117;210;SEC_512
2004;319;12-15;15;23;38;SEC_319
2004;237;18-24;58;53;111;SEC_237
2004;625;35-49;151;121;272;SEC_625
2004;306;25-34;136;161;297;SEC_306
2004;301;16-17;23;15;38;SEC_301
2004;238;16-17;3;5;8;SEC_238
2004;109;00-02;11;8;19;SEC_109
2004;121;18-24;33;20;53;SEC_121
2004;602;65-74;40;49;89;SEC_602
2004;516;75 i +;26;16;42;SEC_516
2004;603;65-74;22;23;45;SEC_603
2004;411;03-11;27;21;48;SEC_411
2004;113;16-17;24;20;44;SEC_113
2004;228;75 i +;44;27;71;SEC_228
2004;207;65-74;44;31;75;SEC_207
2004;501;12-15;17;18;35;SEC_501
2004;525;75 i +;41;29;70;SEC_525
2004;604;12-15;16;15;31;SEC_604
2004;425;00-02;11;15;26;SEC_425
2004;316;03-11;55;73;128;SEC_316
2004;433;50-64;70;78;148;SEC_433
2004;314;03-11;85;91;176;SEC_314
2004;514;75 i +;29;15;44;SEC_514
2004;512;65-74;51;52;103;SEC_512
2004;505;03-11;30;22;52;SEC_505
2004;505;12-15;12;15;27;SEC_505
2004;117;65-74;71;62;133;SEC_117
2004;623;35-49;120;113;233;SEC_623
2004;211;12-15;24;17;41;SEC_211
2004;434;65-74;39;23;62;SEC_434
2004;222;03-11;41;28;69;SEC_222
2004;511;12-15;12;10;22;SEC_511
2004;210;00-02;6;9;15;SEC_210
2004;613;50-64;180;147;327;SEC_613
2004;248;16-17;7;10;17;SEC_248
2004;624;65-74;47;45;92;SEC_624
2004;204;35-49;54;65;119;SEC_204
2004;136;25-34;121;136;257;SEC_136
2004;131;50-64;172;189;361;SEC_131
2004;135;03-11;58;46;104;SEC_135
2004;229;75 i +;52;26;78;SEC_229
2004;613;35-49;86;101;187;SEC_613
2004;521;75 i +;44;27;71;SEC_521
2004;503;75 i +;32;15;47;SEC_503
2004;202;18-24;39;41;80;SEC_202
2004;405;50-64;89;63;152;SEC_405
2004;626;75 i +;30;28;58;SEC_626
2004;319;35-49;179;189;368;SEC_319
2004;314;35-49;296;293;589;SEC_314
2004;135;12-15;26;23;49;SEC_135
2004;615;16-17;5;8;13;SEC_615
2004;402;16-17;2;5;7;SEC_402
2004;217;03-11;20;15;35;SEC_217
2004;512;75 i +;50;27;77;SEC_512
2004;105;25-34;131;121;252;SEC_105
2004;305;16-17;19;19;38;SEC_305
2004;308;35-49;230;237;467;SEC_308
2004;533;18-24;41;48;89;SEC_533
2004;219;35-49;149;143;292;SEC_219
2004;121;35-49;88;107;195;SEC_121
2004;111;12-15;21;13;34;SEC_111
2004;117;35-49;242;231;473;SEC_117
2004;321;25-34;176;181;357;SEC_321
2004;220;25-34;99;90;189;SEC_220
2004;616;50-64;228;232;460;SEC_616
2004;417;65-74;38;29;67;SEC_417
2004;140;12-15;7;9;16;SEC_140
2004;508;00-02;10;3;13;SEC_508
2004;230;35-49;96;117;213;SEC_230
2004;321;75 i +;93;57;150;SEC_321
2004;430;35-49;103;109;212;SEC_430
2004;325;35-49;203;173;376;SEC_325
2004;626;65-74;63;61;124;SEC_626
2004;208;03-11;35;44;79;SEC_208
2004;621;12-15;22;20;42;SEC_621
2004;231;35-49;126;116;242;SEC_231
2004;420;00-02;24;27;51;SEC_420
2004;203;00-02;15;20;35;SEC_203
2004;435;35-49;95;120;215;SEC_435
2004;612;25-34;98;122;220;SEC_612
2004;235;50-64;107;96;203;SEC_235
2004;314;12-15;36;67;103;SEC_314
2004;224;25-34;66;70;136;SEC_224
2004;106;50-64;221;237;458;SEC_106
2004;439;25-34;107;161;268;SEC_439
2004;603;25-34;59;71;130;SEC_603
2004;438;75 i +;30;15;45;SEC_438
2004;230;65-74;44;44;88;SEC_230
2004;105;18-24;57;67;124;SEC_105
2004;625;03-11;36;44;80;SEC_625
2004;534;18-24;50;42;92;SEC_534
2004;309;25-34;78;107;185;SEC_309
2004;301;03-11;84;101;185;SEC_301
2004;218;75 i +;36;21;57;SEC_218
2004;621;25-34;135;157;292;SEC_621
2004;425;12-15;13;20;33;SEC_425
2004;241;65-74;52;40;92;SEC_241
2004;524;25-34;156;168;324;SEC_524
2004;127;75 i +;31;23;54;SEC_127
2004;517;50-64;91;77;168;SEC_517
2004;428;35-49;74;83;157;SEC_428
2004;527;18-24;58;58;116;SEC_527
2004;304;65-74;78;62;140;SEC_304
2004;214;35-49;77;97;174;SEC_214
2004;611;00-02;30;24;54;SEC_611
2004;244;65-74;39;24;63;SEC_244
2004;604;25-34;50;75;125;SEC_604
2004;424;65-74;39;34;73;SEC_424
2004;208;12-15;22;22;44;SEC_208
2004;511;18-24;26;36;62;SEC_511
2004;529;50-64;101;84;185;SEC_529
2004;427;35-49;88;107;195;SEC_427
2004;219;65-74;67;50;117;SEC_219
2004;104;75 i +;72;44;116;SEC_104
2004;214;03-11;34;28;62;SEC_214
2004;418;25-34;120;156;276;SEC_418
2004;433;12-15;16;21;37;SEC_433
2004;237;50-64;114;109;223;SEC_237
2004;220;18-24;42;43;85;SEC_220
2004;425;75 i +;60;39;99;SEC_425
2004;324;25-34;96;104;200;SEC_324
2004;534;35-49;104;90;194;SEC_534
2004;243;18-24;52;47;99;SEC_243
2004;409;35-49;78;80;158;SEC_409
2004;211;25-34;134;183;317;SEC_211
2004;137;50-64;169;143;312;SEC_137
2004;631;18-24;52;38;90;SEC_631
2004;520;16-17;5;9;14;SEC_520
2004;517;12-15;20;31;51;SEC_517
2004;233;12-15;13;14;27;SEC_233
2004;401;75 i +;64;37;101;SEC_401
2004;433;00-02;19;21;40;SEC_433
2004;603;18-24;18;19;37;SEC_603
2004;237;25-34;139;152;291;SEC_237
2004;217;25-34;59;58;117;SEC_217
2004;439;65-74;65;66;131;SEC_439
2004;608;12-15;16;19;35;SEC_608
2004;614;50-64;125;108;233;SEC_614
2004;218;00-02;8;8;16;SEC_218
2004;307;25-34;114;108;222;SEC_307
2004;401;16-17;13;11;24;SEC_401
2004;517;03-11;39;68;107;SEC_517
2004;245;75 i +;69;32;101;SEC_245
2004;222;65-74;39;38;77;SEC_222
2004;521;03-11;24;27;51;SEC_521
2004;204;03-11;17;12;29;SEC_204
2004;217;16-17;4;6;10;SEC_217
2004;442;12-15;14;13;27;SEC_442
2004;405;12-15;11;5;16;SEC_405
2004;419;35-49;79;119;198;SEC_419
2004;114;00-02;21;21;42;SEC_114
2004;108;12-15;19;20;39;SEC_108
2004;632;25-34;88;111;199;SEC_632
2004;430;65-74;50;45;95;SEC_430
2004;514;35-49;75;91;166;SEC_514
2004;101;03-11;77;59;136;SEC_101
2004;319;25-34;174;178;352;SEC_319
2004;120;03-11;77;71;148;SEC_120
2004;402;65-74;57;56;113;SEC_402
2004;417;00-02;6;15;21;SEC_417
2004;129;65-74;41;55;96;SEC_129
2004;119;16-17;8;11;19;SEC_119
2004;125;00-02;14;24;38;SEC_125
2004;531;16-17;6;9;15;SEC_531
2004;104;18-24;23;23;46;SEC_104
2004;532;50-64;133;113;246;SEC_532
2004;218;03-11;27;22;49;SEC_218
2004;617;50-64;104;86;190;SEC_617
2004;127;16-17;8;10;18;SEC_127
2004;519;18-24;50;32;82;SEC_519
2004;318;65-74;26;25;51;SEC_318
2004;209;03-11;32;30;62;SEC_209
2004;106;03-11;57;54;111;SEC_106
2004;436;03-11;46;40;86;SEC_436
2004;536;25-34;66;85;151;SEC_536
2004;203;75 i +;45;31;76;SEC_203
2004;504;18-24;38;43;81;SEC_504
2004;401;35-49;146;146;292;SEC_401
2004;317;16-17;5;10;15;SEC_317
2004;239;03-11;38;36;74;SEC_239
2004;431;75 i +;83;42;125;SEC_431
2004;422;18-24;41;46;87;SEC_422
2004;206;18-24;45;36;81;SEC_206
2004;102;00-02;20;26;46;SEC_102
2004;418;03-11;42;35;77;SEC_418
2004;621;00-02;17;17;34;SEC_621
2004;320;12-15;13;13;26;SEC_320
2004;118;75 i +;50;24;74;SEC_118
2004;424;12-15;8;8;16;SEC_424
2004;301;35-49;265;246;511;SEC_301
2004;631;03-11;33;44;77;SEC_631
2004;425;65-74;62;45;107;SEC_425
2004;616;35-49;293;302;595;SEC_616
2004;305;35-49;214;197;411;SEC_305
2004;510;16-17;10;8;18;SEC_510
2004;103;65-74;48;37;85;SEC_103
2004;211;03-11;42;54;96;SEC_211
2004;620;50-64;83;76;159;SEC_620
2004;323;12-15;59;55;114;SEC_323
2004;437;25-34;96;105;201;SEC_437
2004;119;00-02;8;17;25;SEC_119
2004;206;12-15;15;17;32;SEC_206
2004;101;75 i +;33;23;56;SEC_101
2004;105;03-11;37;43;80;SEC_105
2004;107;00-02;19;31;50;SEC_107
2004;626;03-11;34;39;73;SEC_626
2004;207;03-11;11;24;35;SEC_207
2004;417;16-17;7;3;10;SEC_417
2004;210;65-74;77;61;138;SEC_210
2004;632;65-74;59;52;111;SEC_632
2004;410;25-34;131;158;289;SEC_410
2004;203;50-64;62;56;118;SEC_203
2004;618;00-02;14;11;25;SEC_618
2004;608;03-11;26;27;53;SEC_608
2004;229;03-11;39;32;71;SEC_229
2004;424;75 i +;23;15;38;SEC_424
2004;221;65-74;80;69;149;SEC_221
2004;512;18-24;27;47;74;SEC_512
2004;207;35-49;75;67;142;SEC_207
2004;116;16-17;11;10;21;SEC_116
2004;403;00-02;7;2;9;SEC_403
2004;113;50-64;151;172;323;SEC_113
2004;128;03-11;21;26;47;SEC_128
2004;205;65-74;65;58;123;SEC_205
2004;628;16-17;7;17;24;SEC_628
2004;322;35-49;113;119;232;SEC_322
2004;309;03-11;24;44;68;SEC_309
2004;515;03-11;20;23;43;SEC_515
2004;408;12-15;14;11;25;SEC_408
2004;529;00-02;8;14;22;SEC_529
2004;609;03-11;29;39;68;SEC_609
2004;317;75 i +;63;27;90;SEC_317
2004;103;03-11;28;30;58;SEC_103
2004;401;25-34;87;100;187;SEC_401
2004;423;18-24;40;33;73;SEC_423
2004;103;18-24;30;29;59;SEC_103
2004;440;65-74;61;60;121;SEC_440
2004;612;03-11;35;44;79;SEC_612
2004;318;16-17;11;12;23;SEC_318
2004;310;12-15;14;18;32;SEC_310
2004;508;12-15;9;11;20;SEC_508
2004;512;12-15;15;13;28;SEC_512
2004;309;75 i +;25;14;39;SEC_309
2004;630;35-49;83;91;174;SEC_630
2004;217;65-74;35;30;65;SEC_217
2004;438;35-49;106;101;207;SEC_438
2004;620;75 i +;15;7;22;SEC_620
2004;404;18-24;59;63;122;SEC_404
2004;627;50-64;144;161;305;SEC_627
2004;528;35-49;137;133;270;SEC_528
2004;236;12-15;20;20;40;SEC_236
2004;109;50-64;106;117;223;SEC_109
2004;609;25-34;81;99;180;SEC_609
2004;116;35-49;145;144;289;SEC_116
2004;430;03-11;31;42;73;SEC_430
2004;427;12-15;13;20;33;SEC_427
2004;536;65-74;66;59;125;SEC_536
2004;215;65-74;56;23;79;SEC_215
2004;415;12-15;6;14;20;SEC_415
2004;101;25-34;195;199;394;SEC_101
2004;114;16-17;12;7;19;SEC_114
2004;233;18-24;38;31;69;SEC_233
2004;228;16-17;4;7;11;SEC_228
2004;238;50-64;69;61;130;SEC_238
2004;523;75 i +;99;46;145;SEC_523
2004;108;00-02;16;8;24;SEC_108
2004;237;00-02;23;27;50;SEC_237
2004;227;12-15;10;5;15;SEC_227
2004;621;03-11;50;57;107;SEC_621
2004;625;65-74;49;50;99;SEC_625
2004;306;35-49;166;180;346;SEC_306
2004;434;35-49;70;73;143;SEC_434
2004;105;65-74;38;33;71;SEC_105
2004;128;00-02;11;11;22;SEC_128
2004;228;12-15;10;8;18;SEC_228
2004;248;18-24;53;52;105;SEC_248
2004;310;50-64;83;92;175;SEC_310
2004;616;65-74;53;59;112;SEC_616
2004;302;03-11;38;47;85;SEC_302
2004;522;35-49;92;100;192;SEC_522
2004;205;75 i +;55;27;82;SEC_205
2004;618;18-24;20;22;42;SEC_618
2004;109;25-34;88;80;168;SEC_109
2004;208;18-24;73;81;154;SEC_208
2004;532;65-74;81;73;154;SEC_532
2004;311;35-49;134;150;284;SEC_311
2004;109;35-49;130;115;245;SEC_109
2004;305;50-64;134;144;278;SEC_305
2004;508;75 i +;39;26;65;SEC_508
2004;414;35-49;106;105;211;SEC_414
2004;234;12-15;12;19;31;SEC_234
2004;125;25-34;146;167;313;SEC_125
2004;417;18-24;26;26;52;SEC_417
2004;607;65-74;82;93;175;SEC_607
2004;524;35-49;133;140;273;SEC_524
2004;515;16-17;11;12;23;SEC_515
2004;242;50-64;98;96;194;SEC_242
2004;206;65-74;66;54;120;SEC_206
2004;321;18-24;118;114;232;SEC_321
2004;406;50-64;132;122;254;SEC_406
2004;525;35-49;103;98;201;SEC_525
2004;304;18-24;39;45;84;SEC_304
2004;118;03-11;63;70;133;SEC_118
2004;318;18-24;50;44;94;SEC_318
2004;520;75 i +;49;35;84;SEC_520
2004;518;16-17;10;5;15;SEC_518
2004;619;12-15;15;25;40;SEC_619
2004;230;12-15;20;15;35;SEC_230
2004;229;65-74;48;40;88;SEC_229
2004;511;65-74;60;42;102;SEC_511
2004;535;50-64;146;130;276;SEC_535
2004;106;16-17;24;17;41;SEC_106
2004;233;65-74;48;42;90;SEC_233
2004;616;03-11;129;156;285;SEC_616
2004;235;18-24;55;69;124;SEC_235
2004;313;12-15;40;31;71;SEC_313
2004;210;75 i +;87;44;131;SEC_210
2004;613;75 i +;43;18;61;SEC_613
2004;132;16-17;27;18;45;SEC_132
2004;139;25-34;103;96;199;SEC_139
2004;121;00-02;16;9;25;SEC_121
2004;312;75 i +;60;30;90;SEC_312
2004;109;75 i +;60;36;96;SEC_109
2004;211;00-02;23;16;39;SEC_211
2004;628;35-49;83;92;175;SEC_628
2004;220;35-49;112;111;223;SEC_220
2004;601;25-34;127;147;274;SEC_601
2004;401;18-24;57;70;127;SEC_401
2004;422;25-34;109;130;239;SEC_422
2004;405;16-17;8;3;11;SEC_405
2004;429;35-49;57;68;125;SEC_429
2004;302;50-64;193;182;375;SEC_302
2004;442;18-24;28;19;47;SEC_442
2004;302;65-74;59;45;104;SEC_302
2004;435;50-64;81;77;158;SEC_435
2004;316;35-49;298;221;519;SEC_316
2004;419;00-02;15;18;33;SEC_419
2004;415;16-17;5;4;9;SEC_415
2004;113;65-74;47;30;77;SEC_113
2004;244;18-24;24;22;46;SEC_244
2004;318;25-34;68;85;153;SEC_318
2004;201;75 i +;40;25;65;SEC_201
2004;619;25-34;92;121;213;SEC_619
2004;317;65-74;41;25;66;SEC_317
2004;139;75 i +;27;13;40;SEC_139
2004;119;75 i +;61;50;111;SEC_119
2004;117;75 i +;64;35;99;SEC_117
2004;401;65-74;95;66;161;SEC_401
2004;311;03-11;38;51;89;SEC_311
2004;525;16-17;10;11;21;SEC_525
2004;241;00-02;7;9;16;SEC_241
2004;116;00-02;13;19;32;SEC_116
2004;538;25-34;109;115;224;SEC_538
2004;604;50-64;75;57;132;SEC_604
2004;242;16-17;6;7;13;SEC_242
2004;430;12-15;8;17;25;SEC_430
2004;206;16-17;9;7;16;SEC_206
2004;505;18-24;55;37;92;SEC_505
2004;611;12-15;33;25;58;SEC_611
2004;134;50-64;117;111;228;SEC_134
2004;139;03-11;34;45;79;SEC_139
2004;231;18-24;40;34;74;SEC_231
2004;201;00-02;9;9;18;SEC_201
2004;529;16-17;12;11;23;SEC_529
2004;522;50-64;57;56;113;SEC_522
2004;131;12-15;19;14;33;SEC_131
2004;616;00-02;39;41;80;SEC_616
2004;112;18-24;79;71;150;SEC_112
2004;304;75 i +;107;48;155;SEC_304
2004;204;25-34;45;66;111;SEC_204
2004;140;18-24;40;40;80;SEC_140
2004;322;18-24;56;58;114;SEC_322
2004;302;18-24;60;63;123;SEC_302
2004;231;00-02;16;14;30;SEC_231
2004;532;75 i +;81;50;131;SEC_532
2004;303;65-74;126;134;260;SEC_303
2004;214;50-64;55;42;97;SEC_214
2004;102;65-74;92;87;179;SEC_102
2004;105;50-64;114;118;232;SEC_105
2004;224;16-17;1;3;4;SEC_224
2004;235;00-02;28;25;53;SEC_235
2004;538;18-24;41;52;93;SEC_538
2004;131;25-34;133;152;285;SEC_131
2004;231;25-34;99;107;206;SEC_231
2004;115;75 i +;58;44;102;SEC_115
2004;106;25-34;169;195;364;SEC_106
2004;248;12-15;18;18;36;SEC_248
2004;248;00-02;17;10;27;SEC_248
2004;422;00-02;8;16;24;SEC_422
2004;240;00-02;12;13;25;SEC_240
2004;246;25-34;128;130;258;SEC_246
2004;441;65-74;84;76;160;SEC_441
2004;124;35-49;95;85;180;SEC_124
2004;309;65-74;31;22;53;SEC_309
2004;428;18-24;25;27;52;SEC_428
2004;516;16-17;6;2;8;SEC_516
2004;406;25-34;107;139;246;SEC_406
2004;235;75 i +;85;43;128;SEC_235
2004;232;65-74;63;50;113;SEC_232
2004;108;16-17;12;14;26;SEC_108
2004;123;50-64;108;107;215;SEC_123
2004;303;03-11;35;45;80;SEC_303
2004;538;03-11;35;51;86;SEC_538
2004;219;03-11;64;45;109;SEC_219
2004;235;16-17;11;9;20;SEC_235
2004;418;75 i +;61;39;100;SEC_418
2004;432;50-64;161;150;311;SEC_432
2004;246;18-24;55;37;92;SEC_246
2004;138;25-34;64;57;121;SEC_138
2004;122;50-64;99;72;171;SEC_122
2004;243;12-15;25;37;62;SEC_243
2004;506;75 i +;65;41;106;SEC_506
2004;307;35-49;162;128;290;SEC_307
2004;429;16-17;6;5;11;SEC_429
2004;325;12-15;29;27;56;SEC_325
2004;505;50-64;210;174;384;SEC_505
2004;518;75 i +;57;32;89;SEC_518
2004;111;00-02;9;10;19;SEC_111
2004;430;75 i +;61;38;99;SEC_430
2004;303;75 i +;82;60;142;SEC_303
2004;113;03-11;43;66;109;SEC_113
2004;108;50-64;120;111;231;SEC_108
2004;623;16-17;10;9;19;SEC_623
2004;625;18-24;89;92;181;SEC_625
2004;414;65-74;57;52;109;SEC_414
2004;323;18-24;134;170;304;SEC_323
2004;307;50-64;202;192;394;SEC_307
2004;107;65-74;107;79;186;SEC_107
2004;213;75 i +;47;25;72;SEC_213
2004;501;00-02;13;19;32;SEC_501
2004;606;03-11;37;46;83;SEC_606
2004;131;16-17;16;10;26;SEC_131
2004;605;16-17;3;4;7;SEC_605
2004;616;75 i +;41;24;65;SEC_616
2004;502;00-02;15;26;41;SEC_502
2004;243;35-49;181;189;370;SEC_243
2004;409;25-34;79;98;177;SEC_409
2004;627;25-34;99;82;181;SEC_627
2004;104;03-11;30;38;68;SEC_104
2004;204;12-15;9;11;20;SEC_204
2004;221;50-64;90;88;178;SEC_221
2004;211;16-17;16;11;27;SEC_211
2004;134;35-49;149;142;291;SEC_134
2004;619;35-49;141;134;275;SEC_619
2004;406;18-24;71;53;124;SEC_406
2004;537;16-17;7;8;15;SEC_537
2004;122;75 i +;43;19;62;SEC_122
2004;139;18-24;38;44;82;SEC_139
2004;602;75 i +;19;13;32;SEC_602
2004;407;25-34;76;120;196;SEC_407
2004;107;25-34;165;216;381;SEC_107
2004;205;18-24;54;45;99;SEC_205
2004;511;75 i +;48;34;82;SEC_511
2004;608;18-24;33;36;69;SEC_608
2004;101;18-24;65;63;128;SEC_101
2004;510;18-24;45;49;94;SEC_510
2004;112;65-74;60;56;116;SEC_112
2004;112;16-17;14;15;29;SEC_112
2004;409;18-24;26;34;60;SEC_409
2004;302;16-17;11;7;18;SEC_302
2004;210;25-34;72;78;150;SEC_210
2004;222;75 i +;41;18;59;SEC_222
2004;313;03-11;61;62;123;SEC_313
2004;319;18-24;72;79;151;SEC_319
2004;202;65-74;42;38;80;SEC_202
2004;202;35-49;79;81;160;SEC_202
2004;316;16-17;40;33;73;SEC_316
2004;124;12-15;14;23;37;SEC_124
2004;140;75 i +;51;34;85;SEC_140
2004;618;03-11;20;29;49;SEC_618
2004;403;75 i +;62;37;99;SEC_403
2004;220;12-15;12;18;30;SEC_220
2004;609;65-74;44;40;84;SEC_609
2004;122;25-34;85;97;182;SEC_122
2004;432;18-24;64;67;131;SEC_432
2004;403;50-64;134;102;236;SEC_403
2004;240;18-24;33;35;68;SEC_240
2004;135;65-74;64;56;120;SEC_135
2004;136;35-49;119;125;244;SEC_136
2004;436;16-17;11;12;23;SEC_436
2004;611;16-17;16;14;30;SEC_611
2004;622;12-15;15;17;32;SEC_622
2004;308;65-74;83;85;168;SEC_308
2004;402;00-02;8;9;17;SEC_402
2004;136;18-24;64;53;117;SEC_136
2004;521;35-49;77;79;156;SEC_521
2004;249;18-24;46;45;91;SEC_249
2004;140;03-11;33;37;70;SEC_140
2004;428;03-11;20;20;40;SEC_428
2004;210;12-15;9;8;17;SEC_210
2004;609;16-17;5;10;15;SEC_609
2004;225;35-49;50;64;114;SEC_225
2004;202;75 i +;36;26;62;SEC_202
2004;219;16-17;10;12;22;SEC_219
2004;213;65-74;49;42;91;SEC_213
2004;203;25-34;93;89;182;SEC_203
2004;208;35-49;190;196;386;SEC_208
2004;420;75 i +;76;39;115;SEC_420
2004;628;65-74;47;55;102;SEC_628
2004;209;16-17;7;12;19;SEC_209
2004;441;50-64;215;208;423;SEC_441
2004;309;00-02;12;16;28;SEC_309
2004;622;18-24;38;43;81;SEC_622
2004;612;16-17;7;7;14;SEC_612
2004;208;00-02;21;16;37;SEC_208
2004;308;50-64;198;182;380;SEC_308
2004;106;75 i +;49;28;77;SEC_106
2004;318;50-64;83;87;170;SEC_318
2004;631;16-17;6;8;14;SEC_631
2004;515;65-74;36;24;60;SEC_515
2004;602;00-02;7;4;11;SEC_602
2004;231;12-15;12;10;22;SEC_231
2004;538;65-74;87;85;172;SEC_538
2004;507;18-24;40;45;85;SEC_507
2004;307;03-11;47;40;87;SEC_307
2004;409;75 i +;23;17;40;SEC_409
2004;624;75 i +;38;18;56;SEC_624
2004;324;65-74;45;30;75;SEC_324
2004;136;50-64;113;117;230;SEC_136
2004;430;16-17;5;10;15;SEC_430
2004;118;35-49;203;156;359;SEC_118
2004;121;65-74;75;50;125;SEC_121
2004;537;35-49;129;130;259;SEC_537
2004;606;12-15;15;23;38;SEC_606
2004;528;25-34;110;135;245;SEC_528
2004;628;00-02;6;13;19;SEC_628
2004;626;50-64;110;92;202;SEC_626
2004;425;25-34;85;80;165;SEC_425
2004;204;75 i +;43;21;64;SEC_204
2004;215;35-49;105;105;210;SEC_215
2004;627;18-24;65;72;137;SEC_627
2004;247;16-17;16;13;29;SEC_247
2004;204;50-64;39;39;78;SEC_204
2004;215;50-64;74;61;135;SEC_215
2004;205;16-17;6;10;16;SEC_205
2004;614;75 i +;32;19;51;SEC_614
2004;412;16-17;11;16;27;SEC_412
2004;520;12-15;16;14;30;SEC_520
2004;525;25-34;96;107;203;SEC_525
2004;209;18-24;32;40;72;SEC_209
2004;437;16-17;7;11;18;SEC_437
2004;604;00-02;7;9;16;SEC_604
2004;109;16-17;12;10;22;SEC_109
2004;440;18-24;42;28;70;SEC_440
2004;413;25-34;62;63;125;SEC_413
2004;520;00-02;7;12;19;SEC_520
2004;137;18-24;68;60;128;SEC_137
2004;515;00-02;9;8;17;SEC_515
2004;421;50-64;125;92;217;SEC_421
2004;415;65-74;28;25;53;SEC_415
2004;517;16-17;12;6;18;SEC_517
2004;221;16-17;8;12;20;SEC_221
2004;621;18-24;70;94;164;SEC_621
2004;131;75 i +;53;35;88;SEC_131
2004;527;75 i +;59;31;90;SEC_527
2004;221;35-49;118;121;239;SEC_221
2004;135;75 i +;49;36;85;SEC_135
2004;426;12-15;10;15;25;SEC_426
2004;220;50-64;65;44;109;SEC_220
2004;531;50-64;84;79;163;SEC_531
2004;421;12-15;14;15;29;SEC_421
2004;536;00-02;11;14;25;SEC_536
2004;533;00-02;8;12;20;SEC_533
2004;219;18-24;46;61;107;SEC_219
2004;535;75 i +;48;28;76;SEC_535
2004;424;03-11;20;19;39;SEC_424
2004;114;75 i +;67;34;101;SEC_114
2004;441;35-49;225;227;452;SEC_441
2004;517;18-24;67;69;136;SEC_517
2004;608;00-02;10;9;19;SEC_608
2004;207;00-02;6;10;16;SEC_207
2004;430;25-34;86;119;205;SEC_430
2004;248;35-49;128;159;287;SEC_248
2004;209;50-64;70;68;138;SEC_209
2004;422;12-15;17;19;36;SEC_422
2004;613;65-74;77;77;154;SEC_613
2004;506;50-64;259;225;484;SEC_506
2004;606;00-02;15;11;26;SEC_606
2004;529;12-15;16;30;46;SEC_529
2004;538;50-64;117;79;196;SEC_538
2004;605;00-02;9;5;14;SEC_605
2004;105;16-17;9;15;24;SEC_105
2004;631;50-64;170;143;313;SEC_631
2004;618;16-17;12;6;18;SEC_618
2004;115;35-49;149;152;301;SEC_115
2004;303;35-49;113;136;249;SEC_303
2004;116;50-64;196;162;358;SEC_116
2004;216;00-02;24;16;40;SEC_216
2004;208;75 i +;132;83;215;SEC_208
2004;419;25-34;83;108;191;SEC_419
2004;416;18-24;36;26;62;SEC_416
2004;231;50-64;84;63;147;SEC_231
2004;526;16-17;4;7;11;SEC_526
2004;424;35-49;53;62;115;SEC_424
2004;624;03-11;29;34;63;SEC_624
2004;429;12-15;9;13;22;SEC_429
2004;413;03-11;21;20;41;SEC_413
2004;514;18-24;35;32;67;SEC_514
2004;202;03-11;21;29;50;SEC_202
2004;323;65-74;84;51;135;SEC_323
2004;509;50-64;70;65;135;SEC_509
2004;618;25-34;50;51;101;SEC_618
2004;629;00-02;13;7;20;SEC_629
2004;504;00-02;8;13;21;SEC_504
2004;438;18-24;38;36;74;SEC_438
2004;614;00-02;8;14;22;SEC_614
2004;531;75 i +;46;29;75;SEC_531
2004;216;16-17;10;7;17;SEC_216
2004;602;03-11;15;23;38;SEC_602
2004;234;50-64;67;54;121;SEC_234
2004;514;00-02;14;16;30;SEC_514
2004;231;65-74;74;54;128;SEC_231
2004;538;12-15;11;16;27;SEC_538
2004;516;25-34;64;75;139;SEC_516
2004;517;25-34;124;148;272;SEC_517
2004;503;50-64;111;112;223;SEC_503
2004;302;25-34;144;174;318;SEC_302
2004;223;00-02;11;20;31;SEC_223
2004;127;50-64;55;52;107;SEC_127
2004;601;35-49;119;136;255;SEC_601
2004;607;18-24;38;44;82;SEC_607
2004;439;16-17;3;7;10;SEC_439
2004;404;16-17;14;11;25;SEC_404
2004;321;00-02;24;29;53;SEC_321
2004;312;03-11;50;64;114;SEC_312
2004;507;25-34;84;105;189;SEC_507
2004;110;75 i +;48;29;77;SEC_110
2004;226;16-17;11;13;24;SEC_226
2004;533;12-15;18;11;29;SEC_533
2004;409;50-64;58;62;120;SEC_409
2004;402;75 i +;36;25;61;SEC_402
2004;535;03-11;21;33;54;SEC_535
2004;509;12-15;10;8;18;SEC_509
2004;417;75 i +;36;20;56;SEC_417
2004;108;18-24;60;48;108;SEC_108
2004;206;03-11;22;28;50;SEC_206
2004;407;03-11;32;31;63;SEC_407
2004;212;16-17;11;10;21;SEC_212
2004;623;00-02;19;24;43;SEC_623
2004;406;03-11;34;42;76;SEC_406
2004;201;18-24;21;28;49;SEC_201
2004;626;18-24;32;34;66;SEC_626
2004;316;00-02;9;15;24;SEC_316
2004;323;00-02;42;36;78;SEC_323
2004;610;75 i +;50;37;87;SEC_610
2004;306;75 i +;90;61;151;SEC_306
2004;430;00-02;20;9;29;SEC_430
2004;212;12-15;25;20;45;SEC_212
2004;610;65-74;65;71;136;SEC_610
2004;415;75 i +;42;25;67;SEC_415
2004;516;35-49;78;88;166;SEC_516
2004;241;25-34;70;78;148;SEC_241
2004;103;00-02;12;6;18;SEC_103
2004;237;75 i +;66;30;96;SEC_237
2004;434;00-02;9;6;15;SEC_434
2004;437;65-74;54;50;104;SEC_437
2004;237;16-17;16;12;28;SEC_237
2004;626;12-15;20;11;31;SEC_626
2004;522;65-74;39;42;81;SEC_522
2004;220;75 i +;45;37;82;SEC_220
2004;219;12-15;18;19;37;SEC_219
2004;418;00-02;13;14;27;SEC_418
2004;218;16-17;2;11;13;SEC_218
2004;245;25-34;116;124;240;SEC_245
2004;249;75 i +;64;39;103;SEC_249
2004;314;65-74;67;71;138;SEC_314
2004;432;03-11;30;38;68;SEC_432
2004;523;65-74;89;78;167;SEC_523
2004;303;25-34;161;170;331;SEC_303
2004;439;12-15;15;23;38;SEC_439
2004;630;50-64;135;114;249;SEC_630
2004;621;75 i +;43;19;62;SEC_621
2004;227;75 i +;45;27;72;SEC_227
2004;603;16-17;2;11;13;SEC_603
2004;602;12-15;8;9;17;SEC_602
2004;218;18-24;29;28;57;SEC_218
2004;228;00-02;4;7;11;SEC_228
2004;104;50-64;67;62;129;SEC_104
2004;441;12-15;36;54;90;SEC_441
2004;113;35-49;184;155;339;SEC_113
2004;533;65-74;71;56;127;SEC_533
2004;628;03-11;34;42;76;SEC_628
2004;436;18-24;50;54;104;SEC_436
2004;138;16-17;8;10;18;SEC_138
2004;609;35-49;74;72;146;SEC_609
2004;613;16-17;12;6;18;SEC_613
2004;320;16-17;13;7;20;SEC_320
2004;224;12-15;12;10;22;SEC_224
2004;126;18-24;35;31;66;SEC_126
2004;125;75 i +;49;30;79;SEC_125
2004;631;75 i +;38;23;61;SEC_631
2004;605;12-15;10;6;16;SEC_605
2004;225;03-11;8;16;24;SEC_225
2004;318;75 i +;19;14;33;SEC_318
2004;627;16-17;6;17;23;SEC_627
2004;407;75 i +;56;43;99;SEC_407
2004;617;25-34;97;113;210;SEC_617
2004;232;50-64;94;85;179;SEC_232
2004;403;16-17;9;4;13;SEC_403
2004;215;16-17;8;11;19;SEC_215
2004;108;65-74;75;63;138;SEC_108
2004;413;16-17;4;4;8;SEC_413
2004;240;25-34;78;80;158;SEC_240
2004;232;18-24;51;49;100;SEC_232
2004;610;18-24;52;49;101;SEC_610
2004;427;03-11;38;47;85;SEC_427
2004;248;50-64;78;77;155;SEC_248
2004;422;50-64;83;69;152;SEC_422
2004;128;18-24;39;34;73;SEC_128
2004;520;25-34;77;84;161;SEC_520
2004;416;35-49;76;83;159;SEC_416
2004;617;35-49;90;101;191;SEC_617
2004;602;35-49;54;58;112;SEC_602
2004;118;16-17;22;21;43;SEC_118
2004;305;03-11;73;53;126;SEC_305
2004;129;50-64;117;109;226;SEC_129
2004;632;12-15;10;19;29;SEC_632
2004;538;00-02;15;18;33;SEC_538
2004;622;50-64;91;86;177;SEC_622
2004;441;75 i +;81;61;142;SEC_441
2004;516;50-64;53;48;101;SEC_516
2004;423;16-17;5;11;16;SEC_423
2004;440;16-17;3;7;10;SEC_440
2004;107;12-15;19;31;50;SEC_107
2004;225;12-15;7;12;19;SEC_225
2004;243;00-02;17;22;39;SEC_243
2004;104;00-02;8;11;19;SEC_104
2004;214;65-74;41;32;73;SEC_214
2004;425;35-49;91;112;203;SEC_425
2004;537;25-34;114;131;245;SEC_537
2004;214;16-17;5;4;9;SEC_214
2004;203;12-15;12;14;26;SEC_203
2004;238;65-74;47;42;89;SEC_238
2004;118;00-02;28;16;44;SEC_118
2004;241;18-24;38;23;61;SEC_241
2004;233;50-64;68;60;128;SEC_233
2004;234;35-49;103;110;213;SEC_234
2004;245;65-74;57;56;113;SEC_245
2004;607;00-02;15;15;30;SEC_607
2004;202;00-02;14;10;24;SEC_202
2004;102;12-15;24;28;52;SEC_102
2004;630;25-34;83;101;184;SEC_630
2004;404;03-11;60;53;113;SEC_404
2004;115;03-11;48;52;100;SEC_115
2004;516;18-24;24;35;59;SEC_516
2004;527;50-64;65;60;125;SEC_527
2004;112;75 i +;66;26;92;SEC_112
2004;603;00-02;6;8;14;SEC_603
2004;137;12-15;27;18;45;SEC_137
2004;125;50-64;186;166;352;SEC_125
2004;230;25-34;90;86;176;SEC_230
2004;434;18-24;24;27;51;SEC_434
2004;632;75 i +;30;14;44;SEC_632
2004;528;18-24;47;55;102;SEC_528
2004;504;16-17;6;10;16;SEC_504
2004;131;03-11;40;52;92;SEC_131
2004;247;00-02;18;17;35;SEC_247
2004;427;25-34;100;125;225;SEC_427
2004;521;16-17;9;6;15;SEC_521
2004;517;65-74;64;64;128;SEC_517
2004;402;25-34;97;90;187;SEC_402
2004;313;50-64;195;181;376;SEC_313
2004;247;12-15;21;24;45;SEC_247
2004;537;00-02;15;11;26;SEC_537
2004;201;03-11;23;32;55;SEC_201
2004;212;03-11;47;60;107;SEC_212
2004;244;00-02;9;7;16;SEC_244
2004;104;16-17;4;5;9;SEC_104
2004;416;00-02;17;14;31;SEC_416
2004;439;18-24;45;61;106;SEC_439
2004;514;12-15;9;5;14;SEC_514
2004;204;18-24;27;31;58;SEC_204
2004;529;25-34;124;133;257;SEC_529
2004;433;03-11;49;56;105;SEC_433
2004;420;12-15;21;19;40;SEC_420
2004;120;75 i +;60;26;86;SEC_120
2004;308;00-02;26;39;65;SEC_308
2004;301;25-34;296;288;584;SEC_301
2004;625;25-34;106;100;206;SEC_625
2004;416;50-64;56;53;109;SEC_416
2004;605;03-11;11;20;31;SEC_605
2004;521;12-15;12;12;24;SEC_521
2004;237;65-74;85;67;152;SEC_237
2004;221;00-02;5;13;18;SEC_221
2004;213;35-49;107;114;221;SEC_213
2004;501;50-64;167;179;346;SEC_501
2004;527;35-49;133;144;277;SEC_527
2004;132;12-15;35;44;79;SEC_132
2004;416;75 i +;43;27;70;SEC_416
2004;217;12-15;8;8;16;SEC_217
2004;505;16-17;10;7;17;SEC_505
2004;428;12-15;13;10;23;SEC_428
2004;625;75 i +;25;17;42;SEC_625
2004;104;65-74;64;38;102;SEC_104
2004;323;35-49;377;358;735;SEC_323
2004;313;65-74;87;79;166;SEC_313
2004;223;75 i +;70;33;103;SEC_223
2004;129;03-11;39;33;72;SEC_129
2004;526;65-74;30;35;65;SEC_526
2004;114;03-11;49;56;105;SEC_114
2004;133;35-49;97;96;193;SEC_133
2004;116;25-34;133;150;283;SEC_116
2004;242;03-11;27;28;55;SEC_242
2004;525;03-11;31;35;66;SEC_525
2004;216;25-34;101;123;224;SEC_216
2004;410;50-64;191;164;355;SEC_410
2004;532;35-49;139;138;277;SEC_532
2004;607;16-17;7;11;18;SEC_607
2004;129;12-15;16;18;34;SEC_129
2004;110;35-49;115;91;206;SEC_110
2004;501;25-34;95;130;225;SEC_501
2004;324;00-02;21;18;39;SEC_324
2004;211;35-49;173;177;350;SEC_211
2004;502;75 i +;80;46;126;SEC_502
2004;441;25-34;131;162;293;SEC_441
2004;410;16-17;10;11;21;SEC_410
2004;317;00-02;18;10;28;SEC_317
2004;526;18-24;26;33;59;SEC_526
2004;418;35-49;134;155;289;SEC_418
2004;415;18-24;46;34;80;SEC_415
2004;418;12-15;19;18;37;SEC_418
2004;203;18-24;38;41;79;SEC_203
2004;421;35-49;106;126;232;SEC_421
2004;605;50-64;90;60;150;SEC_605
2004;501;16-17;10;5;15;SEC_501
2004;515;12-15;14;16;30;SEC_515
2004;511;00-02;12;19;31;SEC_511
2004;201;12-15;10;7;17;SEC_201
2004;228;18-24;32;30;62;SEC_228
2004;516;00-02;8;6;14;SEC_516
2004;414;18-24;29;44;73;SEC_414
2004;214;75 i +;30;17;47;SEC_214
2004;426;65-74;43;37;80;SEC_426
2004;513;18-24;36;21;57;SEC_513
2004;139;00-02;13;17;30;SEC_139
2004;619;18-24;56;69;125;SEC_619
2004;111;65-74;55;41;96;SEC_111
2004;620;16-17;8;7;15;SEC_620
2004;518;50-64;93;63;156;SEC_518
2004;407;50-64;79;79;158;SEC_407
2004;247;75 i +;71;33;104;SEC_247
2004;123;18-24;55;47;102;SEC_123
2004;315;12-15;26;35;61;SEC_315
2004;503;03-11;23;29;52;SEC_503
2004;239;65-74;87;64;151;SEC_239
2004;507;50-64;86;90;176;SEC_507
2004;502;50-64;149;153;302;SEC_502
2004;306;03-11;66;55;121;SEC_306
2004;323;25-34;288;308;596;SEC_323
2004;629;16-17;11;2;13;SEC_629
2004;230;50-64;51;45;96;SEC_230
2004;622;65-74;37;23;60;SEC_622
2004;510;00-02;12;5;17;SEC_510
2004;406;00-02;14;20;34;SEC_406
2004;325;00-02;24;26;50;SEC_325
2004;140;25-34;112;112;224;SEC_140
2004;601;75 i +;67;35;102;SEC_601
2004;315;03-11;44;58;102;SEC_315
2004;240;03-11;25;34;59;SEC_240
2004;413;65-74;40;32;72;SEC_413
2004;304;25-34;128;132;260;SEC_304
2004;628;25-34;86;109;195;SEC_628
2004;310;65-74;37;28;65;SEC_310
2004;319;03-11;57;73;130;SEC_319
2004;526;25-34;75;105;180;SEC_526
2004;227;18-24;22;28;50;SEC_227
2004;622;16-17;10;9;19;SEC_622
2004;234;00-02;13;14;27;SEC_234
2004;307;75 i +;82;47;129;SEC_307
2004;427;50-64;76;58;134;SEC_427
2004;623;12-15;14;20;34;SEC_623
2004;430;18-24;51;42;93;SEC_430
2004;241;03-11;29;28;57;SEC_241
2004;249;35-49;124;134;258;SEC_249
2004;507;16-17;12;7;19;SEC_507
2004;206;25-34;79;104;183;SEC_206
2004;417;03-11;25;16;41;SEC_417
2004;532;25-34;135;164;299;SEC_532
2004;230;03-11;30;55;85;SEC_230
2004;410;18-24;73;64;137;SEC_410
2004;118;50-64;211;217;428;SEC_118
2004;506;16-17;18;20;38;SEC_506
2004;434;25-34;53;53;106;SEC_434
2004;112;25-34;135;139;274;SEC_112
2004;243;75 i +;83;59;142;SEC_243
2004;139;65-74;33;28;61;SEC_139
2004;120;35-49;223;226;449;SEC_120
2004;508;03-11;15;22;37;SEC_508
2004;245;12-15;21;16;37;SEC_245
2004;122;35-49;82;95;177;SEC_122
2004;222;00-02;14;8;22;SEC_222
2004;442;50-64;64;52;116;SEC_442
2004;126;25-34;109;110;219;SEC_126
2004;130;03-11;40;37;77;SEC_130
2004;128;12-15;14;25;39;SEC_128
2004;442;35-49;74;63;137;SEC_442
2004;502;12-15;28;17;45;SEC_502
2004;307;65-74;66;57;123;SEC_307
2004;425;18-24;39;36;75;SEC_425
2004;321;65-74;86;74;160;SEC_321
2004;312;00-02;14;21;35;SEC_312
2004;431;35-49;149;168;317;SEC_431
2004;206;00-02;5;13;18;SEC_206
2004;623;03-11;49;52;101;SEC_623
2004;509;75 i +;29;17;46;SEC_509
2004;245;50-64;83;67;150;SEC_245
2004;106;00-02;30;16;46;SEC_106
2004;536;16-17;8;6;14;SEC_536
2004;246;65-74;66;56;122;SEC_246
2004;624;16-17;10;6;16;SEC_624
2004;515;35-49;79;73;152;SEC_515
2004;218;12-15;9;11;20;SEC_218
2004;115;00-02;13;13;26;SEC_115
2004;130;00-02;16;13;29;SEC_130
2004;604;65-74;41;33;74;SEC_604
2004;224;50-64;36;44;80;SEC_224
2004;507;03-11;19;32;51;SEC_507
2004;225;16-17;6;5;11;SEC_225
2004;520;50-64;80;76;156;SEC_520
2004;225;18-24;22;29;51;SEC_225
2004;519;12-15;4;15;19;SEC_519
2004;306;18-24;83;69;152;SEC_306
2004;229;12-15;12;13;25;SEC_229
2004;226;50-64;91;91;182;SEC_226
2004;219;00-02;12;15;27;SEC_219
2004;323;03-11;132;137;269;SEC_323
2004;436;25-34;110;127;237;SEC_436
2004;116;75 i +;65;42;107;SEC_116
2004;505;65-74;68;70;138;SEC_505
2004;215;18-24;39;34;73;SEC_215
2004;403;18-24;52;43;95;SEC_403
2004;209;12-15;20;23;43;SEC_209
2004;433;18-24;56;46;102;SEC_433
2004;132;65-74;87;80;167;SEC_132
2004;126;75 i +;52;26;78;SEC_126
2004;509;16-17;6;9;15;SEC_509
2004;615;65-74;51;59;110;SEC_615
2004;316;75 i +;66;29;95;SEC_316
2004;427;18-24;32;32;64;SEC_427
2004;139;50-64;92;85;177;SEC_139
2004;220;03-11;31;23;54;SEC_220
2004;126;65-74;62;58;120;SEC_126
2004;611;75 i +;67;37;104;SEC_611
2004;527;25-34;113;125;238;SEC_527
2004;610;12-15;17;19;36;SEC_610
2004;438;12-15;16;15;31;SEC_438
2004;610;16-17;6;10;16;SEC_610
2004;423;35-49;104;110;214;SEC_423
2004;528;65-74;62;60;122;SEC_528
2004;320;00-02;26;17;43;SEC_320
2004;206;75 i +;65;31;96;SEC_206
2004;614;03-11;39;34;73;SEC_614
2004;610;50-64;192;148;340;SEC_610
2004;138;50-64;96;89;185;SEC_138
2004;630;00-02;14;10;24;SEC_630
2004;125;18-24;56;70;126;SEC_125
2004;529;18-24;50;52;102;SEC_529
2004;314;18-24;135;125;260;SEC_314
2004;614;25-34;78;104;182;SEC_614
2004;311;25-34;121;155;276;SEC_311
2004;411;12-15;19;9;28;SEC_411
2004;322;65-74;52;48;100;SEC_322
2004;228;25-34;82;105;187;SEC_228
2004;219;25-34;112;118;230;SEC_219
2004;435;12-15;23;15;38;SEC_435
2004;240;65-74;65;48;113;SEC_240
2004;249;65-74;73;47;120;SEC_249
2004;315;16-17;8;12;20;SEC_315
2004;615;50-64;148;109;257;SEC_615
2004;436;75 i +;31;21;52;SEC_436
2004;534;65-74;61;54;115;SEC_534
2004;133;18-24;39;34;73;SEC_133
2004;432;16-17;13;13;26;SEC_432
2004;428;16-17;8;2;10;SEC_428
2004;210;16-17;3;5;8;SEC_210
2004;107;75 i +;68;32;100;SEC_107
2004;323;75 i +;51;24;75;SEC_323
2004;228;03-11;22;20;42;SEC_228
2004;505;35-49;104;104;208;SEC_505
2004;303;50-64;177;128;305;SEC_303
2004;134;16-17;8;20;28;SEC_134
2004;421;65-74;90;72;162;SEC_421
2004;308;12-15;25;27;52;SEC_308
2004;523;00-02;23;17;40;SEC_523
2004;216;12-15;12;20;32;SEC_216
2004;127;18-24;45;36;81;SEC_127
2004;624;12-15;18;19;37;SEC_624
2004;505;00-02;17;12;29;SEC_505
2004;206;35-49;96;104;200;SEC_206
2004;237;35-49;147;185;332;SEC_237
2004;224;75 i +;30;14;44;SEC_224
2004;118;65-74;48;48;96;SEC_118
2004;504;75 i +;59;43;102;SEC_504
2004;530;65-74;102;79;181;SEC_530
2004;315;75 i +;59;33;92;SEC_315
2004;216;03-11;49;39;88;SEC_216
2004;511;35-49;72;77;149;SEC_511
2004;213;03-11;22;38;60;SEC_213
2004;209;00-02;15;14;29;SEC_209
2004;219;50-64;95;86;181;SEC_219
2004;310;03-11;31;31;62;SEC_310
2004;413;18-24;23;25;48;SEC_413
2004;324;16-17;10;10;20;SEC_324
2004;312;50-64;195;146;341;SEC_312
2004;241;35-49;107;87;194;SEC_241
2004;435;03-11;38;43;81;SEC_435
2004;529;03-11;49;39;88;SEC_529
2004;317;03-11;58;50;108;SEC_317
2004;249;50-64;85;75;160;SEC_249
2004;619;50-64;146;135;281;SEC_619
2004;212;18-24;67;62;129;SEC_212
2004;217;75 i +;42;15;57;SEC_217
2004;439;03-11;40;47;87;SEC_439
2004;112;03-11;64;58;122;SEC_112
2004;527;00-02;22;15;37;SEC_527
2004;305;75 i +;94;46;140;SEC_305
2004;246;16-17;3;14;17;SEC_246
2004;123;75 i +;82;48;130;SEC_123
2004;436;50-64;59;63;122;SEC_436
2004;513;12-15;14;11;25;SEC_513
2004;524;75 i +;69;31;100;SEC_524
2004;617;75 i +;28;22;50;SEC_617
2004;418;50-64;114;100;214;SEC_418
2004;109;12-15;16;17;33;SEC_109
2004;523;25-34;131;118;249;SEC_523
2004;324;03-11;41;44;85;SEC_324
2004;515;75 i +;26;13;39;SEC_515
2004;401;00-02;13;14;27;SEC_401
2004;627;35-49;111;89;200;SEC_627
2004;436;00-02;14;22;36;SEC_436
2004;203;16-17;2;9;11;SEC_203
2004;408;75 i +;40;22;62;SEC_408
2004;210;18-24;30;32;62;SEC_210
2004;304;03-11;41;48;89;SEC_304
2004;432;12-15;22;26;48;SEC_432
2004;110;50-64;187;167;354;SEC_110
2004;203;35-49;102;119;221;SEC_203
2004;601;03-11;42;45;87;SEC_601
2004;510;03-11;43;45;88;SEC_510
2004;503;35-49;98;79;177;SEC_503
2004;118;25-34;165;182;347;SEC_118
2004;407;12-15;12;21;33;SEC_407
2004;204;65-74;42;28;70;SEC_204
2004;124;25-34;81;63;144;SEC_124
2004;510;35-49;101;127;228;SEC_510
2004;627;00-02;14;11;25;SEC_627
2004;520;65-74;51;49;100;SEC_520
2004;207;25-34;52;58;110;SEC_207
2004;105;75 i +;58;24;82;SEC_105
2004;410;35-49;149;159;308;SEC_410
2004;247;18-24;56;56;112;SEC_247
2004;427;00-02;11;15;26;SEC_427
2004;534;00-02;13;19;32;SEC_534
2004;248;75 i +;75;35;110;SEC_248
2004;525;18-24;44;54;98;SEC_525
2004;614;16-17;4;16;20;SEC_614
2004;133;03-11;23;39;62;SEC_133
2004;305;12-15;32;25;57;SEC_305
2004;220;16-17;5;7;12;SEC_220
2004;507;75 i +;36;20;56;SEC_507
2004;210;03-11;29;21;50;SEC_210
2004;102;03-11;59;61;120;SEC_102
2004;205;12-15;16;19;35;SEC_205
2004;516;03-11;22;31;53;SEC_516
2004;135;00-02;17;21;38;SEC_135
2004;319;16-17;12;6;18;SEC_319
2004;415;50-64;52;57;109;SEC_415
2004;227;25-34;84;63;147;SEC_227
2004;240;50-64;49;47;96;SEC_240
2004;120;12-15;36;38;74;SEC_120
2004;612;35-49;75;84;159;SEC_612
2004;240;75 i +;48;32;80;SEC_240
2004;519;35-49;71;79;150;SEC_519
2004;408;03-11;27;38;65;SEC_408
2004;428;65-74;41;23;64;SEC_428
2004;406;35-49;140;132;272;SEC_406
2004;243;50-64;110;90;200;SEC_243
2004;427;65-74;66;33;99;SEC_427
2004;510;12-15;14;18;32;SEC_510
2004;316;18-24;178;189;367;SEC_316
2004;419;65-74;44;37;81;SEC_419
2004;513;00-02;12;10;22;SEC_513
2004;507;12-15;20;15;35;SEC_507
2004;137;35-49;164;162;326;SEC_137
2004;519;65-74;47;36;83;SEC_519
2004;620;65-74;32;42;74;SEC_620
2004;531;25-34;100;105;205;SEC_531
2004;246;00-02;16;17;33;SEC_246
2004;606;25-34;94;99;193;SEC_606
2004;522;25-34;100;101;201;SEC_522
2004;215;75 i +;74;45;119;SEC_215
2004;503;65-74;34;23;57;SEC_503
2004;123;35-49;143;158;301;SEC_123
2004;442;16-17;8;8;16;SEC_442
2004;615;00-02;11;2;13;SEC_615
2004;312;12-15;32;26;58;SEC_312
2004;228;65-74;43;37;80;SEC_228
2004;316;12-15;46;52;98;SEC_316
2004;214;12-15;12;4;16;SEC_214
2004;101;35-49;201;183;384;SEC_101
2004;429;18-24;28;34;62;SEC_429
2004;124;65-74;41;41;82;SEC_124
2004;111;50-64;106;85;191;SEC_111
2004;140;16-17;4;6;10;SEC_140
2004;435;75 i +;99;50;149;SEC_435
2004;412;03-11;47;42;89;SEC_412
2004;211;18-24;56;59;115;SEC_211
2004;236;50-64;93;76;169;SEC_236
2004;606;16-17;12;12;24;SEC_606
2004;117;50-64;206;215;421;SEC_117
2004;610;03-11;41;46;87;SEC_610
2004;437;35-49;102;103;205;SEC_437
2004;312;18-24;55;56;111;SEC_312
2004;236;65-74;72;58;130;SEC_236
2004;201;50-64;69;47;116;SEC_201
2004;408;35-49;103;119;222;SEC_408
2004;320;75 i +;31;13;44;SEC_320
2004;249;16-17;8;12;20;SEC_249
2004;226;35-49;123;140;263;SEC_226
2004;414;25-34;87;95;182;SEC_414
2004;606;18-24;44;38;82;SEC_606
2004;525;12-15;10;14;24;SEC_525
2004;434;50-64;45;46;91;SEC_434
2004;441;03-11;66;48;114;SEC_441
2004;407;18-24;37;55;92;SEC_407
2004;630;65-74;31;30;61;SEC_630
2004;322;16-17;10;11;21;SEC_322
2004;529;75 i +;77;48;125;SEC_529
2004;248;25-34;111;125;236;SEC_248
2004;122;12-15;14;7;21;SEC_122
2004;614;12-15;11;17;28;SEC_614
2004;303;12-15;17;18;35;SEC_303
2004;414;12-15;14;15;29;SEC_414
2004;235;65-74;85;68;153;SEC_235
2004;534;12-15;13;7;20;SEC_534
2004;312;35-49;175;220;395;SEC_312
2004;531;00-02;14;11;25;SEC_531
2004;615;75 i +;21;15;36;SEC_615
2004;408;50-64;79;61;140;SEC_408
2004;413;00-02;5;6;11;SEC_413
2004;120;00-02;15;25;40;SEC_120
2004;116;65-74;61;70;131;SEC_116
2004;236;35-49;127;134;261;SEC_236
2004;601;18-24;54;66;120;SEC_601
2004;222;25-34;91;132;223;SEC_222
2004;315;50-64;130;147;277;SEC_315
2004;407;16-17;7;11;18;SEC_407
2004;620;25-34;45;40;85;SEC_620
2004;242;18-24;45;48;93;SEC_242
2004;425;03-11;25;31;56;SEC_425
2004;315;65-74;58;43;101;SEC_315
2004;414;03-11;39;36;75;SEC_414
2004;122;65-74;56;61;117;SEC_122
2004;107;35-49;194;170;364;SEC_107
2004;508;50-64;50;49;99;SEC_508
2004;309;12-15;15;12;27;SEC_309
2004;531;12-15;13;15;28;SEC_531
2004;104;35-49;86;105;191;SEC_104
2004;304;35-49;134;180;314;SEC_304
2004;214;00-02;10;12;22;SEC_214
2004;436;35-49;92;111;203;SEC_436
2004;526;03-11;27;30;57;SEC_526
2004;325;50-64;203;184;387;SEC_325
2004;434;75 i +;60;25;85;SEC_434
2004;107;03-11;54;54;108;SEC_107
2004;526;35-49;74;91;165;SEC_526
2004;311;12-15;13;24;37;SEC_311
2004;607;12-15;19;13;32;SEC_607
2004;423;03-11;36;31;67;SEC_423
2004;530;75 i +;90;44;134;SEC_530
2004;411;16-17;6;2;8;SEC_411
2004;304;12-15;15;19;34;SEC_304
2004;403;03-11;23;17;40;SEC_403
2004;306;12-15;23;29;52;SEC_306
2004;619;03-11;41;43;84;SEC_619
2004;325;03-11;68;66;134;SEC_325
2004;120;16-17;22;24;46;SEC_120
2004;129;00-02;14;18;32;SEC_129
2004;123;65-74;63;64;127;SEC_123
2004;321;50-64;272;276;548;SEC_321
2004;245;16-17;10;17;27;SEC_245
2004;105;12-15;25;40;65;SEC_105
2004;214;25-34;102;112;214;SEC_214
2004;123;03-11;36;59;95;SEC_123
