AnyPadro;Seccio;GrupEdat;Dones;Homes;Total;IdSeccio
2016;611;12-15;42;29;71;SEC_611
2016;531;12-15;19;14;33;SEC_531
2016;410;35-49;171;161;332;SEC_410
2016;313;03-11;78;81;159;SEC_313
2016;106;50-64;225;165;390;SEC_106
2016;422;25-34;89;89;178;SEC_422
2016;301;35-49;417;420;837;SEC_301
2016;406;25-34;92;89;181;SEC_406
2016;239;18-24;36;35;71;SEC_239
2016;212;18-24;54;52;106;SEC_212
2016;217;75 i +;64;41;105;SEC_217
2016;303;25-34;105;93;198;SEC_303
2016;401;65-74;46;40;86;SEC_401
2016;503;75 i +;41;20;61;SEC_503
2016;537;12-15;25;10;35;SEC_537
2016;441;75 i +;114;71;185;SEC_441
2016;108;50-64;145;132;277;SEC_108
2016;121;50-64;73;85;158;SEC_121
2016;208;00-02;8;23;31;SEC_208
2016;320;18-24;5;3;8;SEC_320
2016;321;00-02;21;33;54;SEC_321
2016;110;65-74;115;94;209;SEC_110
2016;404;00-02;16;15;31;SEC_404
2016;133;12-15;11;13;24;SEC_133
2016;532;16-17;14;13;27;SEC_532
2016;404;12-15;21;19;40;SEC_404
2016;427;50-64;148;127;275;SEC_427
2016;316;35-49;162;160;322;SEC_316
2016;510;00-02;20;12;32;SEC_510
2016;323;03-11;71;93;164;SEC_323
2016;616;25-34;100;125;225;SEC_616
2016;312;25-34;164;155;319;SEC_312
2016;312;18-24;77;51;128;SEC_312
2016;301;03-11;153;165;318;SEC_301
2016;138;35-49;83;66;149;SEC_138
2016;111;03-11;33;27;60;SEC_111
2016;435;25-34;93;87;180;SEC_435
2016;525;00-02;15;24;39;SEC_525
2016;308;25-34;102;99;201;SEC_308
2016;528;50-64;105;80;185;SEC_528
2016;209;50-64;102;91;193;SEC_209
2016;523;03-11;57;51;108;SEC_523
2016;504;35-49;127;128;255;SEC_504
2016;409;12-15;25;28;53;SEC_409
2016;533;03-11;91;89;180;SEC_533
2016;321;25-34;129;128;257;SEC_321
2016;613;00-02;12;12;24;SEC_613
2016;307;75 i +;91;65;156;SEC_307
2016;319;50-64;145;136;281;SEC_319
2016;321;65-74;167;150;317;SEC_321
2016;309;25-34;88;82;170;SEC_309
2016;627;50-64;115;78;193;SEC_627
2016;318;16-17;8;6;14;SEC_318
2016;204;25-34;133;117;250;SEC_204
2016;313;75 i +;96;69;165;SEC_313
2016;505;35-49;135;128;263;SEC_505
2016;403;12-15;21;9;30;SEC_403
2016;107;50-64;161;125;286;SEC_107
2016;617;12-15;14;20;34;SEC_617
2016;511;03-11;84;104;188;SEC_511
2016;310;18-24;25;29;54;SEC_310
2016;106;18-24;41;45;86;SEC_106
2016;242;18-24;50;30;80;SEC_242
2016;116;03-11;60;46;106;SEC_116
2016;106;75 i +;69;40;109;SEC_106
2016;426;18-24;48;39;87;SEC_426
2016;621;18-24;52;41;93;SEC_621
2016;136;12-15;21;23;44;SEC_136
2016;112;03-11;65;66;131;SEC_112
2016;505;16-17;5;4;9;SEC_505
2016;315;18-24;54;63;117;SEC_315
2016;321;03-11;65;71;136;SEC_321
2016;118;65-74;131;133;264;SEC_118
2016;137;18-24;49;49;98;SEC_137
2016;625;03-11;32;36;68;SEC_625
2016;103;16-17;6;11;17;SEC_103
2016;110;25-34;55;60;115;SEC_110
2016;416;25-34;119;101;220;SEC_416
2016;525;65-74;41;34;75;SEC_525
2016;119;25-34;70;62;132;SEC_119
2016;126;65-74;93;74;167;SEC_126
2016;436;50-64;144;136;280;SEC_436
2016;204;50-64;141;136;277;SEC_204
2016;240;35-49;215;203;418;SEC_240
2016;510;65-74;63;46;109;SEC_510
2016;523;18-24;46;54;100;SEC_523
2016;102;35-49;165;172;337;SEC_102
2016;615;50-64;47;46;93;SEC_615
2016;609;65-74;85;65;150;SEC_609
2016;514;12-15;25;26;51;SEC_514
2016;136;16-17;11;10;21;SEC_136
2016;617;25-34;51;52;103;SEC_617
2016;440;65-74;74;58;132;SEC_440
2016;425;03-11;42;45;87;SEC_425
2016;501;35-49;105;123;228;SEC_501
2016;632;50-64;74;66;140;SEC_632
2016;314;18-24;60;88;148;SEC_314
2016;501;25-34;39;42;81;SEC_501
2016;630;03-11;21;32;53;SEC_630
2016;326;18-24;19;21;40;SEC_326
2016;407;03-11;49;41;90;SEC_407
2016;248;18-24;37;49;86;SEC_248
2016;508;65-74;55;40;95;SEC_508
2016;535;12-15;10;20;30;SEC_535
2016;529;75 i +;96;56;152;SEC_529
2016;621;65-74;136;135;271;SEC_621
2016;223;50-64;112;105;217;SEC_223
2016;433;00-02;27;37;64;SEC_433
2016;248;03-11;54;64;118;SEC_248
2016;619;18-24;33;42;75;SEC_619
2016;601;18-24;59;55;114;SEC_601
2016;440;25-34;66;70;136;SEC_440
2016;514;03-11;57;72;129;SEC_514
2016;231;12-15;21;31;52;SEC_231
2016;431;75 i +;94;38;132;SEC_431
2016;107;00-02;25;12;37;SEC_107
2016;202;16-17;19;19;38;SEC_202
2016;514;50-64;129;109;238;SEC_514
2016;116;00-02;17;13;30;SEC_116
2016;236;18-24;48;40;88;SEC_236
2016;126;12-15;22;19;41;SEC_126
2016;504;65-74;91;64;155;SEC_504
2016;316;75 i +;79;49;128;SEC_316
2016;411;03-11;31;32;63;SEC_411
2016;405;25-34;134;100;234;SEC_405
2016;506;00-02;11;15;26;SEC_506
2016;105;18-24;30;29;59;SEC_105
2016;422;65-74;53;31;84;SEC_422
2016;622;18-24;17;34;51;SEC_622
2016;112;16-17;17;12;29;SEC_112
2016;529;65-74;45;36;81;SEC_529
2016;121;25-34;39;52;91;SEC_121
2016;220;16-17;7;10;17;SEC_220
2016;221;65-74;83;70;153;SEC_221
2016;223;75 i +;59;39;98;SEC_223
2016;534;75 i +;67;51;118;SEC_534
2016;605;16-17;8;9;17;SEC_605
2016;432;16-17;13;11;24;SEC_432
2016;111;65-74;67;52;119;SEC_111
2016;133;25-34;67;54;121;SEC_133
2016;618;50-64;105;93;198;SEC_618
2016;401;35-49;112;111;223;SEC_401
2016;327;18-24;48;44;92;SEC_327
2016;435;50-64;86;90;176;SEC_435
2016;137;12-15;37;23;60;SEC_137
2016;216;03-11;51;71;122;SEC_216
2016;305;18-24;69;62;131;SEC_305
2016;120;25-34;100;109;209;SEC_120
2016;236;16-17;5;8;13;SEC_236
2016;534;50-64;89;80;169;SEC_534
2016;304;50-64;195;181;376;SEC_304
2016;609;50-64;53;55;108;SEC_609
2016;622;35-49;95;108;203;SEC_622
2016;427;18-24;78;80;158;SEC_427
2016;103;35-49;106;117;223;SEC_103
2016;418;16-17;17;14;31;SEC_418
2016;532;00-02;15;22;37;SEC_532
2016;102;12-15;32;31;63;SEC_102
2016;211;35-49;193;198;391;SEC_211
2016;505;65-74;155;107;262;SEC_505
2016;627;12-15;13;11;24;SEC_627
2016;326;16-17;6;5;11;SEC_326
2016;317;18-24;40;49;89;SEC_317
2016;511;16-17;10;25;35;SEC_511
2016;401;03-11;38;59;97;SEC_401
2016;309;16-17;4;14;18;SEC_309
2016;107;25-34;100;114;214;SEC_107
2016;631;50-64;70;70;140;SEC_631
2016;436;12-15;30;36;66;SEC_436
2016;238;16-17;8;14;22;SEC_238
2016;238;25-34;81;86;167;SEC_238
2016;607;35-49;109;132;241;SEC_607
2016;608;75 i +;102;70;172;SEC_608
2016;409;16-17;16;15;31;SEC_409
2016;421;03-11;40;54;94;SEC_421
2016;231;00-02;23;21;44;SEC_231
2016;605;75 i +;115;119;234;SEC_605
2016;517;12-15;39;42;81;SEC_517
2016;131;25-34;76;73;149;SEC_131
2016;136;75 i +;71;40;111;SEC_136
2016;134;00-02;17;18;35;SEC_134
2016;324;03-11;57;60;117;SEC_324
2016;533;16-17;23;13;36;SEC_533
2016;433;12-15;36;38;74;SEC_433
2016;128;25-34;69;78;147;SEC_128
2016;322;03-11;74;65;139;SEC_322
2016;134;03-11;60;53;113;SEC_134
2016;420;35-49;225;284;509;SEC_420
2016;318;00-02;8;13;21;SEC_318
2016;229;50-64;158;150;308;SEC_229
2016;249;03-11;38;52;90;SEC_249
2016;419;65-74;78;55;133;SEC_419
2016;615;65-74;102;56;158;SEC_615
2016;211;65-74;43;37;80;SEC_211
2016;115;65-74;84;75;159;SEC_115
2016;623;25-34;51;62;113;SEC_623
2016;304;75 i +;117;59;176;SEC_304
2016;209;75 i +;78;51;129;SEC_209
2016;530;12-15;24;28;52;SEC_530
2016;233;00-02;17;11;28;SEC_233
2016;632;00-02;11;12;23;SEC_632
2016;120;75 i +;68;45;113;SEC_120
2016;126;16-17;12;9;21;SEC_126
2016;514;18-24;59;58;117;SEC_514
2016;134;18-24;45;46;91;SEC_134
2016;436;25-34;95;106;201;SEC_436
2016;138;50-64;90;76;166;SEC_138
2016;322;18-24;44;50;94;SEC_322
2016;523;65-74;71;54;125;SEC_523
2016;113;03-11;75;88;163;SEC_113
2016;622;12-15;9;12;21;SEC_622
2016;537;25-34;108;89;197;SEC_537
2016;234;65-74;41;26;67;SEC_234
2016;212;03-11;68;68;136;SEC_212
2016;611;25-34;105;107;212;SEC_611
2016;521;50-64;91;70;161;SEC_521
2016;504;00-02;12;16;28;SEC_504
2016;320;03-11;65;70;135;SEC_320
2016;406;50-64;131;125;256;SEC_406
2016;202;00-02;25;31;56;SEC_202
2016;224;16-17;7;13;20;SEC_224
2016;411;16-17;8;7;15;SEC_411
2016;311;65-74;64;45;109;SEC_311
2016;513;12-15;19;29;48;SEC_513
2016;309;18-24;29;30;59;SEC_309
2016;237;50-64;122;110;232;SEC_237
2016;127;03-11;33;29;62;SEC_127
2016;409;18-24;82;73;155;SEC_409
2016;319;16-17;13;15;28;SEC_319
2016;208;12-15;15;29;44;SEC_208
2016;609;75 i +;44;38;82;SEC_609
2016;402;16-17;7;9;16;SEC_402
2016;248;25-34;97;102;199;SEC_248
2016;240;50-64;149;141;290;SEC_240
2016;204;35-49;195;193;388;SEC_204
2016;301;18-24;91;86;177;SEC_301
2016;228;75 i +;139;92;231;SEC_228
2016;118;16-17;19;13;32;SEC_118
2016;238;00-02;13;13;26;SEC_238
2016;243;12-15;21;36;57;SEC_243
2016;528;00-02;16;14;30;SEC_528
2016;105;00-02;15;14;29;SEC_105
2016;245;65-74;50;30;80;SEC_245
2016;407;65-74;49;28;77;SEC_407
2016;432;25-34;71;80;151;SEC_432
2016;308;03-11;96;80;176;SEC_308
2016;214;16-17;32;20;52;SEC_214
2016;310;50-64;93;77;170;SEC_310
2016;405;03-11;77;72;149;SEC_405
2016;607;03-11;38;39;77;SEC_607
2016;426;35-49;117;164;281;SEC_426
2016;316;18-24;70;71;141;SEC_316
2016;310;16-17;6;9;15;SEC_310
2016;602;12-15;23;27;50;SEC_602
2016;204;12-15;28;19;47;SEC_204
2016;518;12-15;21;20;41;SEC_518
2016;118;00-02;13;17;30;SEC_118
2016;124;16-17;5;4;9;SEC_124
2016;608;03-11;48;45;93;SEC_608
2016;518;75 i +;86;58;144;SEC_518
2016;214;35-49;306;304;610;SEC_214
2016;128;16-17;10;8;18;SEC_128
2016;307;35-49;140;135;275;SEC_307
2016;327;50-64;171;127;298;SEC_327
2016;407;12-15;17;23;40;SEC_407
2016;411;18-24;33;24;57;SEC_411
2016;127;00-02;14;6;20;SEC_127
2016;625;12-15;25;25;50;SEC_625
2016;308;12-15;42;46;88;SEC_308
2016;205;65-74;52;37;89;SEC_205
2016;209;03-11;32;37;69;SEC_209
2016;120;65-74;93;86;179;SEC_120
2016;618;35-49;134;122;256;SEC_618
2016;608;35-49;132;178;310;SEC_608
2016;427;35-49;234;232;466;SEC_427
2016;631;18-24;30;28;58;SEC_631
2016;307;12-15;10;16;26;SEC_307
2016;323;18-24;63;60;123;SEC_323
2016;412;35-49;159;182;341;SEC_412
2016;140;12-15;10;21;31;SEC_140
2016;221;75 i +;115;78;193;SEC_221
2016;601;35-49;196;271;467;SEC_601
2016;524;00-02;21;25;46;SEC_524
2016;226;12-15;43;34;77;SEC_226
2016;425;00-02;10;14;24;SEC_425
2016;525;12-15;18;16;34;SEC_525
2016;625;75 i +;67;52;119;SEC_625
2016;238;35-49;132;106;238;SEC_238
2016;307;50-64;160;116;276;SEC_307
2016;419;00-02;32;33;65;SEC_419
2016;624;35-49;106;152;258;SEC_624
2016;304;18-24;79;73;152;SEC_304
2016;114;75 i +;106;73;179;SEC_114
2016;501;00-02;11;8;19;SEC_501
2016;524;12-15;23;18;41;SEC_524
2016;316;00-02;22;25;47;SEC_316
2016;521;35-49;86;102;188;SEC_521
2016;418;75 i +;84;70;154;SEC_418
2016;307;03-11;49;36;85;SEC_307
2016;323;16-17;24;20;44;SEC_323
2016;114;12-15;27;28;55;SEC_114
2016;614;50-64;69;80;149;SEC_614
2016;211;75 i +;77;34;111;SEC_211
2016;610;35-49;128;108;236;SEC_610
2016;410;18-24;60;71;131;SEC_410
2016;318;12-15;6;21;27;SEC_318
2016;506;25-34;97;107;204;SEC_506
2016;615;25-34;40;41;81;SEC_615
2016;122;12-15;20;13;33;SEC_122
2016;414;12-15;23;23;46;SEC_414
2016;212;50-64;112;108;220;SEC_212
2016;510;18-24;41;29;70;SEC_510
2016;308;65-74;121;104;225;SEC_308
2016;607;00-02;14;11;25;SEC_607
2016;319;03-11;90;114;204;SEC_319
2016;214;00-02;43;40;83;SEC_214
2016;618;18-24;41;47;88;SEC_618
2016;538;75 i +;101;59;160;SEC_538
2016;232;16-17;9;9;18;SEC_232
2016;104;18-24;33;29;62;SEC_104
2016;139;75 i +;41;25;66;SEC_139
2016;209;12-15;14;19;33;SEC_209
2016;537;00-02;22;14;36;SEC_537
2016;134;16-17;20;10;30;SEC_134
2016;315;00-02;26;18;44;SEC_315
2016;216;65-74;69;52;121;SEC_216
2016;619;03-11;51;52;103;SEC_619
2016;435;18-24;33;50;83;SEC_435
2016;135;12-15;18;27;45;SEC_135
2016;139;50-64;91;83;174;SEC_139
2016;508;35-49;175;191;366;SEC_508
2016;523;16-17;12;10;22;SEC_523
2016;302;25-34;94;92;186;SEC_302
2016;237;16-17;8;19;27;SEC_237
2016;534;18-24;35;28;63;SEC_534
2016;323;00-02;24;26;50;SEC_323
2016;127;75 i +;41;35;76;SEC_127
2016;131;50-64;130;111;241;SEC_131
2016;609;18-24;28;29;57;SEC_609
2016;523;35-49;186;180;366;SEC_523
2016;416;03-11;62;72;134;SEC_416
2016;518;03-11;54;51;105;SEC_518
2016;212;65-74;63;46;109;SEC_212
2016;534;16-17;4;9;13;SEC_534
2016;208;50-64;167;146;313;SEC_208
2016;426;16-17;15;8;23;SEC_426
2016;611;00-02;24;17;41;SEC_611
2016;537;03-11;44;49;93;SEC_537
2016;409;00-02;33;30;63;SEC_409
2016;437;65-74;81;60;141;SEC_437
2016;403;35-49;122;138;260;SEC_403
2016;520;25-34;51;63;114;SEC_520
2016;402;65-74;38;31;69;SEC_402
2016;311;35-49;183;210;393;SEC_311
2016;231;65-74;40;31;71;SEC_231
2016;616;50-64;232;210;442;SEC_616
2016;532;25-34;112;100;212;SEC_532
2016;132;35-49;222;258;480;SEC_132
2016;623;18-24;41;43;84;SEC_623
2016;507;35-49;103;109;212;SEC_507
2016;422;18-24;50;45;95;SEC_422
2016;205;03-11;32;28;60;SEC_205
2016;420;12-15;39;33;72;SEC_420
2016;312;50-64;154;161;315;SEC_312
2016;309;35-49;162;159;321;SEC_309
2016;202;50-64;134;128;262;SEC_202
2016;324;75 i +;36;24;60;SEC_324
2016;616;35-49;301;277;578;SEC_616
2016;234;12-15;15;7;22;SEC_234
2016;127;12-15;14;12;26;SEC_127
2016;312;65-74;139;80;219;SEC_312
2016;621;00-02;17;20;37;SEC_621
2016;314;03-11;84;96;180;SEC_314
2016;534;12-15;14;18;32;SEC_534
2016;507;03-11;40;32;72;SEC_507
2016;131;00-02;17;14;31;SEC_131
2016;217;03-11;60;52;112;SEC_217
2016;247;12-15;24;20;44;SEC_247
2016;134;75 i +;88;41;129;SEC_134
2016;216;75 i +;87;53;140;SEC_216
2016;510;75 i +;77;43;120;SEC_510
2016;631;16-17;6;10;16;SEC_631
2016;431;00-02;27;28;55;SEC_431
2016;414;75 i +;87;57;144;SEC_414
2016;115;00-02;16;14;30;SEC_115
2016;627;18-24;20;24;44;SEC_627
2016;612;00-02;17;13;30;SEC_612
2016;324;25-34;88;59;147;SEC_324
2016;404;50-64;110;105;215;SEC_404
2016;613;12-15;18;15;33;SEC_613
2016;315;75 i +;61;45;106;SEC_315
2016;606;16-17;10;16;26;SEC_606
2016;326;03-11;68;65;133;SEC_326
2016;226;25-34;127;147;274;SEC_226
2016;117;75 i +;94;56;150;SEC_117
2016;130;03-11;55;41;96;SEC_130
2016;521;18-24;21;25;46;SEC_521
2016;242;00-02;17;15;32;SEC_242
2016;113;50-64;206;145;351;SEC_113
2016;249;18-24;34;42;76;SEC_249
2016;513;75 i +;101;57;158;SEC_513
2016;414;25-34;152;149;301;SEC_414
2016;106;12-15;31;27;58;SEC_106
2016;202;03-11;68;72;140;SEC_202
2016;317;12-15;16;28;44;SEC_317
2016;317;00-02;15;13;28;SEC_317
2016;612;16-17;6;10;16;SEC_612
2016;112;75 i +;78;39;117;SEC_112
2016;322;65-74;57;55;112;SEC_322
2016;120;16-17;19;19;38;SEC_120
2016;232;50-64;98;88;186;SEC_232
2016;411;12-15;17;16;33;SEC_411
2016;609;35-49;109;96;205;SEC_609
2016;113;12-15;20;36;56;SEC_113
2016;435;35-49;122;170;292;SEC_435
2016;617;03-11;36;46;82;SEC_617
2016;120;00-02;27;14;41;SEC_120
2016;535;03-11;33;30;63;SEC_535
2016;605;03-11;76;72;148;SEC_605
2016;538;35-49;164;176;340;SEC_538
2016;625;35-49;109;116;225;SEC_625
2016;308;16-17;25;30;55;SEC_308
2016;224;12-15;21;17;38;SEC_224
2016;248;00-02;16;19;35;SEC_248
2016;433;65-74;63;55;118;SEC_433
2016;131;16-17;8;8;16;SEC_131
2016;420;25-34;139;134;273;SEC_420
2016;402;35-49;127;120;247;SEC_402
2016;247;35-49;170;179;349;SEC_247
2016;425;75 i +;73;49;122;SEC_425
2016;321;16-17;24;27;51;SEC_321
2016;423;25-34;74;70;144;SEC_423
2016;606;03-11;44;51;95;SEC_606
2016;116;35-49;150;158;308;SEC_116
2016;421;16-17;9;11;20;SEC_421
2016;140;03-11;45;57;102;SEC_140
2016;111;35-49;94;89;183;SEC_111
2016;319;25-34;98;99;197;SEC_319
2016;401;12-15;20;20;40;SEC_401
2016;630;16-17;8;5;13;SEC_630
2016;526;12-15;36;32;68;SEC_526
2016;216;18-24;42;43;85;SEC_216
2016;610;50-64;90;86;176;SEC_610
2016;242;35-49;148;152;300;SEC_242
2016;212;00-02;19;21;40;SEC_212
2016;532;35-49;173;187;360;SEC_532
2016;104;35-49;117;109;226;SEC_104
2016;511;00-02;37;43;80;SEC_511
2016;615;18-24;21;21;42;SEC_615
2016;528;65-74;56;47;103;SEC_528
2016;109;75 i +;67;40;107;SEC_109
2016;506;50-64;194;148;342;SEC_506
2016;124;75 i +;44;39;83;SEC_124
2016;123;03-11;47;55;102;SEC_123
2016;431;25-34;123;132;255;SEC_431
2016;630;50-64;81;73;154;SEC_630
2016;118;12-15;27;18;45;SEC_118
2016;505;75 i +;88;84;172;SEC_505
2016;315;50-64;182;160;342;SEC_315
2016;525;75 i +;75;36;111;SEC_525
2016;521;25-34;44;41;85;SEC_521
2016;533;65-74;85;64;149;SEC_533
2016;421;25-34;74;68;142;SEC_421
2016;531;35-49;123;134;257;SEC_531
2016;409;65-74;89;73;162;SEC_409
2016;411;00-02;10;10;20;SEC_411
2016;125;12-15;20;25;45;SEC_125
2016;135;50-64;168;136;304;SEC_135
2016;529;00-02;18;17;35;SEC_529
2016;626;03-11;32;37;69;SEC_626
2016;124;25-34;52;48;100;SEC_124
2016;436;03-11;66;66;132;SEC_436
2016;612;75 i +;82;58;140;SEC_612
2016;239;03-11;28;31;59;SEC_239
2016;435;16-17;8;14;22;SEC_435
2016;502;65-74;93;84;177;SEC_502
2016;437;35-49;195;214;409;SEC_437
2016;137;25-34;105;80;185;SEC_137
2016;426;00-02;14;10;24;SEC_426
2016;504;18-24;25;23;48;SEC_504
2016;508;03-11;63;80;143;SEC_508
2016;521;12-15;11;22;33;SEC_521
2016;103;00-02;12;8;20;SEC_103
2016;209;00-02;13;19;32;SEC_209
2016;514;00-02;12;24;36;SEC_514
2016;315;65-74;81;80;161;SEC_315
2016;214;50-64;180;166;346;SEC_214
2016;140;25-34;70;49;119;SEC_140
2016;122;00-02;19;19;38;SEC_122
2016;433;25-34;120;136;256;SEC_433
2016;242;03-11;45;55;100;SEC_242
2016;615;16-17;8;7;15;SEC_615
2016;613;75 i +;83;67;150;SEC_613
2016;229;18-24;89;79;168;SEC_229
2016;127;50-64;93;77;170;SEC_127
2016;602;16-17;11;16;27;SEC_602
2016;402;18-24;35;22;57;SEC_402
2016;311;12-15;28;29;57;SEC_311
2016;112;50-64;177;152;329;SEC_112
2016;411;35-49;89;100;189;SEC_411
2016;613;16-17;5;11;16;SEC_613
2016;436;00-02;29;18;47;SEC_436
2016;535;50-64;97;80;177;SEC_535
2016;441;25-34;169;150;319;SEC_441
2016;601;65-74;150;105;255;SEC_601
2016;210;50-64;80;76;156;SEC_210
2016;303;18-24;38;48;86;SEC_303
2016;326;50-64;40;62;102;SEC_326
2016;517;65-74;74;55;129;SEC_517
2016;110;75 i +;77;51;128;SEC_110
2016;131;12-15;9;23;32;SEC_131
2016;624;65-74;112;96;208;SEC_624
2016;313;65-74;107;92;199;SEC_313
2016;111;25-34;46;40;86;SEC_111
2016;226;35-49;254;231;485;SEC_226
2016;420;16-17;14;21;35;SEC_420
2016;407;75 i +;94;48;142;SEC_407
2016;110;50-64;117;89;206;SEC_110
2016;425;65-74;44;30;74;SEC_425
2016;245;00-02;14;19;33;SEC_245
2016;617;16-17;8;7;15;SEC_617
2016;606;12-15;19;16;35;SEC_606
2016;433;18-24;90;69;159;SEC_433
2016;525;25-34;79;61;140;SEC_525
2016;109;16-17;11;12;23;SEC_109
2016;506;16-17;17;20;37;SEC_506
2016;430;00-02;17;17;34;SEC_430
2016;508;75 i +;85;49;134;SEC_508
2016;325;50-64;198;151;349;SEC_325
2016;610;00-02;11;9;20;SEC_610
2016;406;16-17;14;15;29;SEC_406
2016;321;50-64;276;244;520;SEC_321
2016;245;03-11;56;58;114;SEC_245
2016;437;12-15;31;31;62;SEC_437
2016;132;12-15;33;32;65;SEC_132
2016;112;65-74;98;82;180;SEC_112
2016;422;50-64;93;99;192;SEC_422
2016;518;65-74;60;37;97;SEC_518
2016;116;16-17;16;13;29;SEC_116
2016;217;65-74;64;55;119;SEC_217
2016;306;18-24;66;49;115;SEC_306
2016;126;00-02;12;15;27;SEC_126
2016;117;65-74;121;103;224;SEC_117
2016;209;65-74;38;37;75;SEC_209
2016;242;12-15;15;14;29;SEC_242
2016;520;03-11;41;25;66;SEC_520
2016;129;18-24;43;28;71;SEC_129
2016;414;65-74;58;53;111;SEC_414
2016;131;35-49;150;170;320;SEC_131
2016;430;12-15;21;16;37;SEC_430
2016;613;18-24;27;42;69;SEC_613
2016;325;35-49;187;187;374;SEC_325
2016;124;65-74;44;29;73;SEC_124
2016;421;00-02;19;14;33;SEC_421
2016;323;65-74;113;127;240;SEC_323
2016;232;65-74;49;35;84;SEC_232
2016;211;03-11;52;63;115;SEC_211
2016;403;50-64;109;102;211;SEC_403
2016;322;12-15;18;30;48;SEC_322
2016;221;50-64;174;165;339;SEC_221
2016;322;75 i +;78;41;119;SEC_322
2016;243;75 i +;105;71;176;SEC_243
2016;123;65-74;69;60;129;SEC_123
2016;521;00-02;7;7;14;SEC_521
2016;123;18-24;36;50;86;SEC_123
2016;124;50-64;89;68;157;SEC_124
2016;440;12-15;16;22;38;SEC_440
2016;623;00-02;11;16;27;SEC_623
2016;616;18-24;80;96;176;SEC_616
2016;122;03-11;40;52;92;SEC_122
2016;627;75 i +;49;36;85;SEC_627
2016;524;25-34;106;100;206;SEC_524
2016;103;18-24;25;23;48;SEC_103
2016;430;35-49;144;184;328;SEC_430
2016;419;16-17;22;20;42;SEC_419
2016;630;75 i +;40;30;70;SEC_630
2016;117;18-24;64;58;122;SEC_117
2016;310;35-49;105;126;231;SEC_310
2016;320;16-17;13;15;28;SEC_320
2016;530;03-11;70;86;156;SEC_530
2016;207;35-49;258;240;498;SEC_207
2016;108;12-15;25;17;42;SEC_108
2016;220;65-74;67;36;103;SEC_220
2016;407;18-24;38;28;66;SEC_407
2016;404;25-34;98;91;189;SEC_404
2016;135;00-02;7;18;25;SEC_135
2016;104;16-17;10;9;19;SEC_104
2016;627;03-11;24;39;63;SEC_627
2016;526;35-49;262;291;553;SEC_526
2016;602;35-49;159;145;304;SEC_602
2016;137;65-74;89;77;166;SEC_137
2016;233;75 i +;61;36;97;SEC_233
2016;624;50-64;78;57;135;SEC_624
2016;116;25-34;59;68;127;SEC_116
2016;319;75 i +;43;33;76;SEC_319
2016;308;00-02;17;22;39;SEC_308
2016;245;75 i +;67;44;111;SEC_245
2016;104;12-15;7;19;26;SEC_104
2016;518;25-34;68;61;129;SEC_518
2016;606;75 i +;82;66;148;SEC_606
2016;318;75 i +;47;27;74;SEC_318
2016;231;03-11;61;75;136;SEC_231
2016;124;00-02;11;11;22;SEC_124
2016;608;00-02;13;11;24;SEC_608
2016;530;16-17;14;19;33;SEC_530
2016;127;18-24;23;26;49;SEC_127
2016;233;16-17;6;12;18;SEC_233
2016;245;25-34;89;78;167;SEC_245
2016;506;65-74;168;138;306;SEC_506
2016;232;18-24;47;47;94;SEC_232
2016;214;65-74;85;58;143;SEC_214
2016;317;16-17;12;10;22;SEC_317
2016;226;75 i +;124;74;198;SEC_226
2016;506;03-11;61;66;127;SEC_506
2016;201;75 i +;64;46;110;SEC_201
2016;426;50-64;69;83;152;SEC_426
2016;503;00-02;5;10;15;SEC_503
2016;106;65-74;124;138;262;SEC_106
2016;423;18-24;44;28;72;SEC_423
2016;102;25-34;62;55;117;SEC_102
2016;106;25-34;96;107;203;SEC_106
2016;437;16-17;18;20;38;SEC_437
2016;237;12-15;22;37;59;SEC_237
2016;612;50-64;65;70;135;SEC_612
2016;621;12-15;17;28;45;SEC_621
2016;312;35-49;222;247;469;SEC_312
2016;409;50-64;175;151;326;SEC_409
2016;207;16-17;15;18;33;SEC_207
2016;537;18-24;55;49;104;SEC_537
2016;139;00-02;8;16;24;SEC_139
2016;414;35-49;247;229;476;SEC_414
2016;529;16-17;10;20;30;SEC_529
2016;502;03-11;75;75;150;SEC_502
2016;318;18-24;21;30;51;SEC_318
2016;618;65-74;106;74;180;SEC_618
2016;226;50-64;165;136;301;SEC_226
2016;101;00-02;39;29;68;SEC_101
2016;421;35-49;161;163;324;SEC_421
2016;517;00-02;31;35;66;SEC_517
2016;314;50-64;272;249;521;SEC_314
2016;420;65-74;87;64;151;SEC_420
2016;505;25-34;58;52;110;SEC_505
2016;422;35-49;136;173;309;SEC_422
2016;313;12-15;39;43;82;SEC_313
2016;133;75 i +;67;32;99;SEC_133
2016;528;18-24;51;45;96;SEC_528
2016;301;16-17;20;18;38;SEC_301
2016;530;75 i +;89;74;163;SEC_530
2016;237;00-02;12;23;35;SEC_237
2016;420;18-24;97;86;183;SEC_420
2016;120;35-49;193;187;380;SEC_120
2016;416;16-17;11;18;29;SEC_416
2016;441;50-64;243;205;448;SEC_441
2016;325;25-34;86;76;162;SEC_325
2016;127;65-74;32;21;53;SEC_127
2016;308;35-49;254;233;487;SEC_308
2016;233;12-15;12;18;30;SEC_233
2016;430;65-74;37;27;64;SEC_430
2016;632;18-24;30;32;62;SEC_632
2016;323;25-34;92;110;202;SEC_323
2016;610;75 i +;82;77;159;SEC_610
2016;220;03-11;84;75;159;SEC_220
2016;125;75 i +;59;64;123;SEC_125
2016;107;16-17;16;7;23;SEC_107
2016;122;35-49;128;120;248;SEC_122
2016;245;35-49;137;164;301;SEC_245
2016;224;50-64;115;94;209;SEC_224
2016;234;03-11;41;39;80;SEC_234
2016;412;16-17;9;14;23;SEC_412
2016;625;25-34;62;70;132;SEC_625
2016;119;18-24;32;33;65;SEC_119
2016;201;00-02;40;48;88;SEC_201
2016;106;00-02;20;23;43;SEC_106
2016;416;35-49;192;188;380;SEC_416
2016;411;75 i +;97;76;173;SEC_411
2016;103;75 i +;52;32;84;SEC_103
2016;503;50-64;118;78;196;SEC_503
2016;611;35-49;237;257;494;SEC_611
2016;217;18-24;63;52;115;SEC_217
2016;314;65-74;129;112;241;SEC_314
2016;532;03-11;72;60;132;SEC_532
2016;508;12-15;22;13;35;SEC_508
2016;622;50-64;90;74;164;SEC_622
2016;507;12-15;13;22;35;SEC_507
2016;138;12-15;11;7;18;SEC_138
2016;304;16-17;42;21;63;SEC_304
2016;601;00-02;20;29;49;SEC_601
2016;624;00-02;20;11;31;SEC_624
2016;102;16-17;15;17;32;SEC_102
2016;616;03-11;115;114;229;SEC_616
2016;105;75 i +;63;42;105;SEC_105
2016;133;50-64;85;74;159;SEC_133
2016;108;25-34;106;87;193;SEC_108
2016;431;35-49;197;234;431;SEC_431
2016;307;00-02;17;12;29;SEC_307
2016;211;12-15;23;37;60;SEC_211
2016;517;03-11;109;95;204;SEC_517
2016;224;00-02;22;23;45;SEC_224
2016;614;12-15;20;13;33;SEC_614
2016;127;16-17;4;3;7;SEC_127
2016;238;12-15;13;12;25;SEC_238
2016;140;75 i +;63;49;112;SEC_140
2016;238;75 i +;57;38;95;SEC_238
2016;320;18-24;35;39;74;SEC_320
2016;221;00-02;29;33;62;SEC_221
2016;630;12-15;15;11;26;SEC_630
2016;305;35-49;176;199;375;SEC_305
2016;409;75 i +;116;83;199;SEC_409
2016;526;18-24;85;73;158;SEC_526
2016;101;12-15;60;53;113;SEC_101
2016;321;35-49;248;211;459;SEC_321
2016;427;65-74;51;30;81;SEC_427
2016;240;25-34;141;134;275;SEC_240
2016;316;12-15;22;30;52;SEC_316
2016;231;75 i +;89;38;127;SEC_231
2016;412;03-11;44;54;98;SEC_412
2016;319;65-74;83;69;152;SEC_319
2016;115;18-24;32;44;76;SEC_115
2016;204;00-02;23;19;42;SEC_204
2016;607;50-64;95;84;179;SEC_607
2016;216;50-64;113;105;218;SEC_216
2016;125;25-34;85;91;176;SEC_125
2016;302;50-64;137;92;229;SEC_302
2016;538;18-24;48;51;99;SEC_538
2016;412;18-24;63;53;116;SEC_412
2016;621;50-64;157;98;255;SEC_621
2016;246;35-49;168;181;349;SEC_246
2016;440;18-24;40;34;74;SEC_440
2016;533;35-49;238;255;493;SEC_533
2016;313;50-64;213;178;391;SEC_313
2016;435;12-15;20;12;32;SEC_435
2016;136;35-49;156;159;315;SEC_136
2016;405;12-15;35;27;62;SEC_405
2016;440;00-02;11;12;23;SEC_440
2016;425;16-17;7;8;15;SEC_425
2016;523;50-64;112;118;230;SEC_523
2016;109;35-49;130;129;259;SEC_109
2016;315;16-17;18;15;33;SEC_315
2016;221;18-24;83;81;164;SEC_221
2016;101;65-74;69;66;135;SEC_101
2016;109;03-11;43;50;93;SEC_109
2016;606;18-24;31;32;63;SEC_606
2016;614;75 i +;72;53;125;SEC_614
2016;115;25-34;61;73;134;SEC_115
2016;323;12-15;36;40;76;SEC_323
2016;631;35-49;140;121;261;SEC_631
2016;507;50-64;83;72;155;SEC_507
2016;534;03-11;38;47;85;SEC_534
2016;135;35-49;163;188;351;SEC_135
2016;213;16-17;7;14;21;SEC_213
2016;323;50-64;206;177;383;SEC_323
2016;237;75 i +;85;46;131;SEC_237
2016;232;00-02;18;18;36;SEC_232
2016;414;00-02;34;32;66;SEC_414
2016;433;03-11;96;102;198;SEC_433
2016;228;16-17;29;27;56;SEC_228
2016;520;18-24;28;29;57;SEC_520
2016;211;00-02;10;33;43;SEC_211
2016;440;35-49;119;116;235;SEC_440
2016;316;03-11;57;67;124;SEC_316
2016;102;00-02;14;17;31;SEC_102
2016;246;12-15;18;19;37;SEC_246
2016;614;25-34;36;58;94;SEC_614
2016;531;18-24;50;45;95;SEC_531
2016;505;18-24;27;19;46;SEC_505
2016;427;00-02;28;32;60;SEC_427
2016;427;03-11;81;102;183;SEC_427
2016;624;75 i +;54;56;110;SEC_624
2016;302;18-24;37;43;80;SEC_302
2016;224;18-24;39;43;82;SEC_224
2016;630;25-34;47;49;96;SEC_630
2016;136;18-24;40;41;81;SEC_136
2016;611;03-11;78;106;184;SEC_611
2016;324;35-49;170;184;354;SEC_324
2016;314;75 i +;91;60;151;SEC_314
2016;125;00-02;25;24;49;SEC_125
2016;110;03-11;42;34;76;SEC_110
2016;612;35-49;108;143;251;SEC_612
2016;113;35-49;211;227;438;SEC_113
2016;132;50-64;232;220;452;SEC_132
2016;441;03-11;78;77;155;SEC_441
2016;208;65-74;113;86;199;SEC_208
2016;326;35-49;208;241;449;SEC_326
2016;302;16-17;4;14;18;SEC_302
2016;102;75 i +;118;84;202;SEC_102
2016;525;35-49;122;136;258;SEC_525
2016;315;35-49;251;244;495;SEC_315
2016;204;18-24;84;69;153;SEC_204
2016;418;25-34;88;102;190;SEC_418
2016;317;75 i +;45;20;65;SEC_317
2016;508;25-34;106;106;212;SEC_508
2016;301;00-02;47;48;95;SEC_301
2016;201;25-34;165;139;304;SEC_201
2016;327;03-11;44;65;109;SEC_327
2016;433;35-49;244;237;481;SEC_433
2016;317;35-49;134;185;319;SEC_317
2016;319;35-49;259;259;518;SEC_319
2016;232;35-49;123;130;253;SEC_232
2016;205;50-64;101;102;203;SEC_205
2016;208;18-24;51;51;102;SEC_208
2016;517;75 i +;100;63;163;SEC_517
2016;511;50-64;193;158;351;SEC_511
2016;526;25-34;156;154;310;SEC_526
2016;214;18-24;95;80;175;SEC_214
2016;425;35-49;125;146;271;SEC_425
2016;422;12-15;13;22;35;SEC_422
2016;524;65-74;48;34;82;SEC_524
2016;223;65-74;60;36;96;SEC_223
2016;233;65-74;39;19;58;SEC_233
2016;320;50-64;11;14;25;SEC_320
2016;524;75 i +;76;37;113;SEC_524
2016;504;03-11;27;49;76;SEC_504
2016;404;35-49;161;177;338;SEC_404
2016;217;35-49;168;206;374;SEC_217
2016;249;75 i +;67;41;108;SEC_249
2016;110;12-15;18;18;36;SEC_110
2016;423;03-11;41;40;81;SEC_423
2016;436;16-17;27;22;49;SEC_436
2016;520;50-64;79;67;146;SEC_520
2016;123;50-64;130;119;249;SEC_123
2016;134;12-15;19;32;51;SEC_134
2016;313;35-49;227;212;439;SEC_313
2016;504;75 i +;93;75;168;SEC_504
2016;505;00-02;11;12;23;SEC_505
2016;119;00-02;11;15;26;SEC_119
2016;321;75 i +;125;83;208;SEC_321
2016;507;00-02;8;9;17;SEC_507
2016;247;25-34;114;98;212;SEC_247
2016;204;65-74;64;42;106;SEC_204
2016;117;35-49;210;212;422;SEC_117
2016;136;00-02;19;12;31;SEC_136
2016;607;16-17;9;8;17;SEC_607
2016;247;65-74;61;40;101;SEC_247
2016;422;00-02;17;13;30;SEC_422
2016;324;00-02;22;19;41;SEC_324
2016;610;03-11;48;44;92;SEC_610
2016;423;16-17;5;7;12;SEC_423
2016;502;16-17;15;18;33;SEC_502
2016;504;25-34;78;63;141;SEC_504
2016;234;16-17;8;9;17;SEC_234
2016;130;25-34;57;62;119;SEC_130
2016;115;03-11;56;54;110;SEC_115
2016;140;50-64;90;75;165;SEC_140
2016;410;16-17;14;21;35;SEC_410
2016;425;50-64;81;87;168;SEC_425
2016;437;25-34;99;133;232;SEC_437
2016;202;65-74;73;51;124;SEC_202
2016;121;18-24;40;27;67;SEC_121
2016;610;16-17;9;18;27;SEC_610
2016;232;03-11;39;52;91;SEC_232
2016;524;18-24;42;57;99;SEC_524
2016;506;75 i +;104;90;194;SEC_506
2016;504;12-15;11;9;20;SEC_504
2016;610;12-15;22;24;46;SEC_610
2016;632;35-49;113;131;244;SEC_632
2016;529;03-11;51;62;113;SEC_529
2016;326;75 i +;4;3;7;SEC_326
2016;420;75 i +;130;86;216;SEC_420
2016;411;65-74;64;44;108;SEC_411
2016;601;12-15;34;38;72;SEC_601
2016;627;16-17;8;4;12;SEC_627
2016;205;00-02;11;13;24;SEC_205
2016;212;25-34;98;101;199;SEC_212
2016;411;25-34;65;53;118;SEC_411
2016;402;50-64;74;70;144;SEC_402
2016;626;35-49;105;99;204;SEC_626
2016;419;12-15;39;44;83;SEC_419
2016;513;35-49;199;200;399;SEC_513
2016;311;18-24;49;52;101;SEC_311
2016;514;16-17;21;18;39;SEC_514
2016;619;25-34;46;71;117;SEC_619
2016;129;16-17;6;11;17;SEC_129
2016;626;18-24;29;32;61;SEC_626
2016;207;25-34;164;125;289;SEC_207
2016;418;12-15;16;30;46;SEC_418
2016;114;50-64;152;127;279;SEC_114
2016;502;75 i +;137;76;213;SEC_502
2016;410;00-02;13;19;32;SEC_410
2016;501;18-24;25;34;59;SEC_501
2016;312;75 i +;89;67;156;SEC_312
2016;538;12-15;26;36;62;SEC_538
2016;130;12-15;20;13;33;SEC_130
2016;213;12-15;15;19;34;SEC_213
2016;231;50-64;92;94;186;SEC_231
2016;111;75 i +;64;41;105;SEC_111
2016;306;75 i +;93;59;152;SEC_306
2016;441;65-74;127;108;235;SEC_441
2016;326;00-02;44;54;98;SEC_326
2016;327;75 i +;32;21;53;SEC_327
2016;431;03-11;95;89;184;SEC_431
2016;613;50-64;67;72;139;SEC_613
2016;622;75 i +;36;18;54;SEC_622
2016;403;16-17;10;9;19;SEC_403
2016;534;25-34;85;63;148;SEC_534
2016;249;12-15;21;15;36;SEC_249
2016;441;35-49;221;239;460;SEC_441
2016;214;12-15;34;48;82;SEC_214
2016;632;75 i +;58;41;99;SEC_632
2016;517;16-17;20;21;41;SEC_517
2016;245;12-15;20;27;47;SEC_245
2016;441;18-24;86;62;148;SEC_441
2016;107;35-49;186;218;404;SEC_107
2016;320;75 i +;60;36;96;SEC_320
2016;535;65-74;100;76;176;SEC_535
2016;207;00-02;29;17;46;SEC_207
2016;320;00-02;7;6;13;SEC_320
2016;139;03-11;34;35;69;SEC_139
2016;302;75 i +;69;51;120;SEC_302
2016;518;35-49;157;156;313;SEC_518
2016;432;50-64;130;104;234;SEC_432
2016;609;00-02;10;10;20;SEC_609
2016;503;18-24;28;25;53;SEC_503
2016;233;18-24;41;40;81;SEC_233
2016;243;35-49;207;200;407;SEC_243
2016;508;50-64;139;125;264;SEC_508
2016;306;00-02;25;29;54;SEC_306
2016;313;18-24;64;62;126;SEC_313
2016;440;16-17;8;3;11;SEC_440
2016;128;18-24;26;20;46;SEC_128
2016;502;50-64;135;128;263;SEC_502
2016;130;16-17;8;7;15;SEC_130
2016;325;75 i +;189;95;284;SEC_325
2016;612;12-15;14;22;36;SEC_612
2016;420;50-64;191;178;369;SEC_420
2016;247;18-24;42;46;88;SEC_247
2016;605;25-34;88;77;165;SEC_605
2016;210;65-74;60;50;110;SEC_210
2016;318;03-11;24;27;51;SEC_318
2016;405;18-24;59;77;136;SEC_405
2016;108;75 i +;93;55;148;SEC_108
2016;129;03-11;35;48;83;SEC_129
2016;421;65-74;74;51;125;SEC_421
2016;416;12-15;30;32;62;SEC_416
2016;609;03-11;41;43;84;SEC_609
2016;503;35-49;88;68;156;SEC_503
2016;113;00-02;20;31;51;SEC_113
2016;116;50-64;144;124;268;SEC_116
2016;621;25-34;68;86;154;SEC_621
2016;236;50-64;81;78;159;SEC_236
2016;525;16-17;8;9;17;SEC_525
2016;137;03-11;73;65;138;SEC_137
2016;123;75 i +;81;65;146;SEC_123
2016;246;16-17;12;13;25;SEC_246
2016;131;18-24;45;36;81;SEC_131
2016;325;16-17;13;14;27;SEC_325
2016;314;16-17;24;14;38;SEC_314
2016;133;65-74;60;43;103;SEC_133
2016;240;00-02;26;25;51;SEC_240
2016;132;25-34;137;145;282;SEC_132
2016;426;65-74;42;40;82;SEC_426
2016;613;03-11;40;50;90;SEC_613
2016;205;16-17;8;11;19;SEC_205
2016;101;75 i +;64;41;105;SEC_101
2016;630;35-49;97;99;196;SEC_630
2016;236;03-11;43;58;101;SEC_236
2016;606;25-34;58;67;125;SEC_606
2016;236;12-15;14;16;30;SEC_236
2016;121;65-74;25;22;47;SEC_121
2016;119;35-49;119;147;266;SEC_119
2016;441;16-17;24;23;47;SEC_441
2016;505;03-11;37;43;80;SEC_505
2016;618;12-15;29;30;59;SEC_618
2016;228;00-02;27;31;58;SEC_228
2016;236;35-49;131;129;260;SEC_236
2016;425;12-15;16;23;39;SEC_425
2016;533;12-15;34;27;61;SEC_533
2016;532;65-74;77;57;134;SEC_532
2016;132;03-11;96;75;171;SEC_132
2016;234;25-34;81;79;160;SEC_234
2016;231;25-34;109;94;203;SEC_231
2016;615;03-11;31;32;63;SEC_615
2016;228;12-15;39;50;89;SEC_228
2016;306;16-17;26;12;38;SEC_306
2016;435;75 i +;67;29;96;SEC_435
2016;118;18-24;64;57;121;SEC_118
2016;602;18-24;43;53;96;SEC_602
2016;103;65-74;38;31;69;SEC_103
2016;613;65-74;136;83;219;SEC_613
2016;220;12-15;29;26;55;SEC_220
2016;426;12-15;11;16;27;SEC_426
2016;139;65-74;58;56;114;SEC_139
2016;533;75 i +;130;82;212;SEC_533
2016;619;50-64;140;135;275;SEC_619
2016;303;03-11;66;49;115;SEC_303
2016;239;50-64;103;90;193;SEC_239
2016;226;03-11;81;79;160;SEC_226
2016;508;18-24;59;64;123;SEC_508
2016;426;03-11;45;44;89;SEC_426
2016;528;25-34;79;73;152;SEC_528
2016;623;75 i +;73;56;129;SEC_623
2016;217;16-17;6;18;24;SEC_217
2016;114;16-17;12;15;27;SEC_114
2016;608;18-24;28;37;65;SEC_608
2016;319;12-15;38;40;78;SEC_319
2016;117;03-11;70;77;147;SEC_117
2016;134;65-74;67;65;132;SEC_134
2016;602;65-74;86;48;134;SEC_602
2016;619;65-74;93;66;159;SEC_619
2016;223;18-24;68;49;117;SEC_223
2016;220;18-24;77;63;140;SEC_220
2016;320;16-17;2;3;5;SEC_320
2016;528;12-15;23;23;46;SEC_528
2016;232;12-15;12;10;22;SEC_232
2016;123;16-17;8;13;21;SEC_123
2016;425;25-34;84;81;165;SEC_425
2016;246;18-24;57;43;100;SEC_246
2016;406;65-74;75;66;141;SEC_406
2016;627;25-34;41;59;100;SEC_627
2016;224;75 i +;70;28;98;SEC_224
2016;614;65-74;92;65;157;SEC_614
2016;626;65-74;74;56;130;SEC_626
2016;110;00-02;8;17;25;SEC_110
2016;204;03-11;54;68;122;SEC_204
2016;520;65-74;46;41;87;SEC_520
2016;210;18-24;30;28;58;SEC_210
2016;123;25-34;86;72;158;SEC_123
2016;135;03-11;46;56;102;SEC_135
2016;104;00-02;11;12;23;SEC_104
2016;220;35-49;236;215;451;SEC_220
2016;505;12-15;16;15;31;SEC_505
2016;312;16-17;6;12;18;SEC_312
2016;623;50-64;114;114;228;SEC_623
2016;224;65-74;52;42;94;SEC_224
2016;236;00-02;9;11;20;SEC_236
2016;217;25-34;118;104;222;SEC_217
2016;412;25-34;105;106;211;SEC_412
2016;422;03-11;60;50;110;SEC_422
2016;248;16-17;4;8;12;SEC_248
2016;436;75 i +;66;43;109;SEC_436
2016;526;50-64;140;132;272;SEC_526
2016;407;25-34;68;80;148;SEC_407
2016;233;50-64;86;72;158;SEC_233
2016;130;65-74;43;31;74;SEC_130
2016;435;03-11;57;73;130;SEC_435
2016;533;25-34;155;122;277;SEC_533
2016;531;65-74;47;28;75;SEC_531
2016;431;16-17;20;16;36;SEC_431
2016;238;50-64;67;65;132;SEC_238
2016;619;12-15;19;18;37;SEC_619
2016;612;65-74;94;64;158;SEC_612
2016;613;35-49;134;155;289;SEC_613
2016;308;75 i +;103;84;187;SEC_308
2016;317;65-74;27;35;62;SEC_317
2016;513;50-64;115;133;248;SEC_513
2016;403;18-24;27;36;63;SEC_403
2016;523;25-34;85;102;187;SEC_523
2016;510;16-17;10;11;21;SEC_510
2016;307;25-34;63;78;141;SEC_307
2016;511;12-15;34;37;71;SEC_511
2016;531;75 i +;50;39;89;SEC_531
2016;228;65-74;96;58;154;SEC_228
2016;125;16-17;13;17;30;SEC_125
2016;508;00-02;22;20;42;SEC_508
2016;217;50-64;132;137;269;SEC_217
2016;427;75 i +;93;51;144;SEC_427
2016;425;18-24;39;38;77;SEC_425
2016;132;65-74;126;132;258;SEC_132
2016;136;25-34;72;52;124;SEC_136
2016;625;00-02;11;12;23;SEC_625
2016;115;16-17;8;18;26;SEC_115
2016;423;00-02;12;22;34;SEC_423
2016;622;65-74;59;50;109;SEC_622
2016;306;03-11;63;63;126;SEC_306
2016;420;00-02;30;39;69;SEC_420
2016;243;25-34;117;104;221;SEC_243
2016;130;35-49;146;132;278;SEC_130
2016;243;50-64;150;145;295;SEC_243
2016;310;25-34;74;58;132;SEC_310
2016;213;25-34;100;73;173;SEC_213
2016;323;75 i +;66;29;95;SEC_323
2016;132;00-02;19;24;43;SEC_132
2016;511;65-74;99;71;170;SEC_511
2016;107;03-11;68;71;139;SEC_107
2016;135;18-24;43;39;82;SEC_135
2016;319;00-02;24;33;57;SEC_319
2016;630;00-02;10;12;22;SEC_630
2016;320;65-74;2;2;4;SEC_320
2016;246;50-64;98;99;197;SEC_246
2016;432;00-02;16;17;33;SEC_432
2016;240;18-24;77;65;142;SEC_240
2016;631;75 i +;68;48;116;SEC_631
2016;209;35-49;129;118;247;SEC_209
2016;245;50-64;97;91;188;SEC_245
2016;208;35-49;182;156;338;SEC_208
2016;132;75 i +;108;74;182;SEC_132
2016;125;18-24;44;59;103;SEC_125
2016;306;25-34;114;115;229;SEC_306
2016;418;18-24;49;57;106;SEC_418
2016;120;18-24;75;61;136;SEC_120
2016;140;18-24;27;44;71;SEC_140
2016;535;75 i +;68;69;137;SEC_535
2016;117;25-34;107;105;212;SEC_117
2016;609;12-15;9;11;20;SEC_609
2016;106;16-17;9;10;19;SEC_106
2016;534;35-49;120;126;246;SEC_534
2016;414;18-24;76;77;153;SEC_414
2016;117;00-02;21;19;40;SEC_117
2016;207;03-11;82;80;162;SEC_207
2016;104;25-34;40;57;97;SEC_104
2016;133;16-17;8;7;15;SEC_133
2016;410;03-11;59;51;110;SEC_410
2016;122;65-74;49;31;80;SEC_122
2016;231;18-24;50;51;101;SEC_231
2016;236;75 i +;96;45;141;SEC_236
2016;129;12-15;16;30;46;SEC_129
2016;245;16-17;10;11;21;SEC_245
2016;529;25-34;99;77;176;SEC_529
2016;208;25-34;110;107;217;SEC_208
2016;617;00-02;12;25;37;SEC_617
2016;311;16-17;18;15;33;SEC_311
2016;625;18-24;27;33;60;SEC_625
2016;307;65-74;130;110;240;SEC_307
2016;436;18-24;75;72;147;SEC_436
2016;605;65-74;152;91;243;SEC_605
2016;412;00-02;9;20;29;SEC_412
2016;405;35-49;235;239;474;SEC_405
2016;622;00-02;10;10;20;SEC_622
2016;621;35-49;162;182;344;SEC_621
2016;612;18-24;24;40;64;SEC_612
2016;430;03-11;51;56;107;SEC_430
2016;213;75 i +;50;43;93;SEC_213
2016;139;18-24;34;37;71;SEC_139
2016;407;00-02;13;15;28;SEC_407
2016;401;00-02;18;8;26;SEC_401
2016;305;75 i +;80;44;124;SEC_305
2016;524;50-64;115;89;204;SEC_524
2016;506;35-49;176;173;349;SEC_506
2016;127;25-34;56;48;104;SEC_127
2016;405;75 i +;143;96;239;SEC_405
2016;236;25-34;74;93;167;SEC_236
2016;128;35-49;169;150;319;SEC_128
2016;626;75 i +;65;48;113;SEC_626
2016;502;18-24;54;46;100;SEC_502
2016;306;12-15;33;33;66;SEC_306
2016;626;16-17;7;8;15;SEC_626
2016;622;25-34;50;42;92;SEC_622
2016;532;12-15;25;26;51;SEC_532
2016;437;75 i +;111;77;188;SEC_437
2016;427;16-17;13;26;39;SEC_427
2016;404;75 i +;81;55;136;SEC_404
2016;311;25-34;114;119;233;SEC_311
2016;632;03-11;38;50;88;SEC_632
2016;118;25-34;85;67;152;SEC_118
2016;614;00-02;13;11;24;SEC_614
2016;531;03-11;42;36;78;SEC_531
2016;208;03-11;36;44;80;SEC_208
2016;418;00-02;9;15;24;SEC_418
2016;624;25-34;45;39;84;SEC_624
2016;313;16-17;18;19;37;SEC_313
2016;125;50-64;147;141;288;SEC_125
2016;426;25-34;86;83;169;SEC_426
2016;117;50-64;247;225;472;SEC_117
2016;421;18-24;28;55;83;SEC_421
2016;220;50-64;169;141;310;SEC_220
2016;108;03-11;61;69;130;SEC_108
2016;616;75 i +;61;37;98;SEC_616
2016;619;00-02;12;11;23;SEC_619
2016;409;03-11;77;77;154;SEC_409
2016;118;50-64;190;149;339;SEC_118
2016;619;75 i +;112;92;204;SEC_619
2016;132;16-17;10;16;26;SEC_132
2016;216;12-15;25;21;46;SEC_216
2016;409;35-49;207;230;437;SEC_409
2016;513;18-24;54;57;111;SEC_513
2016;631;25-34;46;38;84;SEC_631
2016;521;16-17;7;5;12;SEC_521
2016;611;50-64;134;137;271;SEC_611
2016;138;03-11;21;28;49;SEC_138
2016;614;16-17;6;7;13;SEC_614
2016;623;12-15;23;33;56;SEC_623
2016;314;00-02;36;39;75;SEC_314
2016;626;50-64;74;72;146;SEC_626
2016;520;16-17;11;11;22;SEC_520
2016;246;25-34;101;104;205;SEC_246
2016;627;65-74;88;91;179;SEC_627
2016;530;65-74;64;33;97;SEC_530
2016;517;25-34;165;180;345;SEC_517
2016;529;12-15;24;25;49;SEC_529
2016;115;35-49;164;159;323;SEC_115
2016;125;03-11;74;78;152;SEC_125
2016;112;12-15;43;31;74;SEC_112
2016;113;16-17;11;10;21;SEC_113
2016;223;25-34;95;100;195;SEC_223
2016;414;50-64;161;143;304;SEC_414
2016;124;18-24;20;23;43;SEC_124
2016;601;25-34;117;123;240;SEC_601
2016;137;50-64;163;139;302;SEC_137
2016;626;00-02;13;10;23;SEC_626
2016;316;65-74;146;141;287;SEC_316
2016;326;12-15;18;15;33;SEC_326
2016;231;16-17;21;17;38;SEC_231
2016;229;25-34;160;141;301;SEC_229
2016;228;18-24;90;81;171;SEC_228
2016;228;50-64;173;179;352;SEC_228
2016;631;65-74;120;92;212;SEC_631
2016;406;75 i +;74;61;135;SEC_406
2016;503;12-15;7;9;16;SEC_503
2016;114;00-02;10;8;18;SEC_114
2016;528;35-49;171;170;341;SEC_528
2016;205;12-15;20;20;40;SEC_205
2016;101;03-11;145;181;326;SEC_101
2016;324;50-64;66;79;145;SEC_324
2016;119;50-64;138;93;231;SEC_119
2016;302;00-02;16;20;36;SEC_302
2016;441;12-15;33;40;73;SEC_441
2016;207;12-15;24;31;55;SEC_207
2016;239;25-34;78;83;161;SEC_239
2016;229;16-17;24;17;41;SEC_229
2016;304;65-74;78;67;145;SEC_304
2016;310;03-11;51;48;99;SEC_310
2016;537;35-49;146;126;272;SEC_537
2016;223;12-15;24;23;47;SEC_223
2016;507;25-34;46;51;97;SEC_507
2016;302;35-49;160;187;347;SEC_302
2016;122;25-34;58;43;101;SEC_122
2016;501;16-17;14;8;22;SEC_501
2016;130;18-24;26;32;58;SEC_130
2016;131;75 i +;70;61;131;SEC_131
2016;312;00-02;30;29;59;SEC_312
2016;249;35-49;129;125;254;SEC_249
2016;121;03-11;33;52;85;SEC_121
2016;430;50-64;84;86;170;SEC_430
2016;421;75 i +;86;67;153;SEC_421
2016;302;65-74;114;110;224;SEC_302
2016;632;16-17;13;8;21;SEC_632
2016;216;25-34;90;83;173;SEC_216
2016;238;65-74;37;37;74;SEC_238
2016;314;12-15;31;35;66;SEC_314
2016;414;16-17;22;21;43;SEC_414
2016;423;50-64;85;70;155;SEC_423
2016;108;35-49;183;177;360;SEC_108
2016;520;75 i +;57;35;92;SEC_520
2016;226;65-74;91;70;161;SEC_226
2016;120;50-64;202;194;396;SEC_120
2016;619;35-49;131;131;262;SEC_619
2016;105;50-64;134;108;242;SEC_105
2016;240;65-74;60;38;98;SEC_240
2016;533;00-02;28;34;62;SEC_533
2016;226;00-02;29;29;58;SEC_226
2016;535;16-17;7;12;19;SEC_535
2016;123;00-02;17;13;30;SEC_123
2016;126;50-64;78;58;136;SEC_126
2016;140;16-17;9;9;18;SEC_140
2016;316;50-64;353;283;636;SEC_316
2016;523;75 i +;88;66;154;SEC_523
2016;139;16-17;4;10;14;SEC_139
2016;608;65-74;70;46;116;SEC_608
2016;501;12-15;19;24;43;SEC_501
2016;511;35-49;266;290;556;SEC_511
2016;531;16-17;5;6;11;SEC_531
2016;437;00-02;14;26;40;SEC_437
2016;602;25-34;58;60;118;SEC_602
2016;416;00-02;21;30;51;SEC_416
2016;119;12-15;10;17;27;SEC_119
2016;630;65-74;75;61;136;SEC_630
2016;201;16-17;10;13;23;SEC_201
2016;136;03-11;62;56;118;SEC_136
2016;210;03-11;36;28;64;SEC_210
2016;116;65-74;122;91;213;SEC_116
2016;226;18-24;59;68;127;SEC_226
2016;229;03-11;78;93;171;SEC_229
2016;621;03-11;55;51;106;SEC_621
2016;431;18-24;56;59;115;SEC_431
2016;623;16-17;9;10;19;SEC_623
2016;526;65-74;66;46;112;SEC_526
2016;511;25-34;162;146;308;SEC_511
2016;609;25-34;36;38;74;SEC_609
2016;214;25-34;190;200;390;SEC_214
2016;533;50-64;154;142;296;SEC_533
2016;304;25-34;288;261;549;SEC_304
2016;315;03-11;81;86;167;SEC_315
2016;323;35-49;223;229;452;SEC_323
2016;432;18-24;36;49;85;SEC_432
2016;139;35-49;106;116;222;SEC_139
2016;213;50-64;90;76;166;SEC_213
2016;401;50-64;142;117;259;SEC_401
2016;601;16-17;15;14;29;SEC_601
2016;601;50-64;183;160;343;SEC_601
2016;247;00-02;20;24;44;SEC_247
2016;126;18-24;33;35;68;SEC_126
2016;437;50-64;148;131;279;SEC_437
2016;205;25-34;73;82;155;SEC_205
2016;205;18-24;30;43;73;SEC_205
2016;202;25-34;151;171;322;SEC_202
2016;502;00-02;18;24;42;SEC_502
2016;401;16-17;9;20;29;SEC_401
2016;242;25-34;96;79;175;SEC_242
2016;322;35-49;181;179;360;SEC_322
2016;137;35-49;180;157;337;SEC_137
2016;501;65-74;112;118;230;SEC_501
2016;220;00-02;31;28;59;SEC_220
2016;201;18-24;37;44;81;SEC_201
2016;105;25-34;69;71;140;SEC_105
2016;627;35-49;93;98;191;SEC_627
2016;114;35-49;179;189;368;SEC_114
2016;535;25-34;50;46;96;SEC_535
2016;303;12-15;16;17;33;SEC_303
2016;518;00-02;14;13;27;SEC_518
2016;221;25-34;125;161;286;SEC_221
2016;320;35-49;189;185;374;SEC_320
2016;313;25-34;106;113;219;SEC_313
2016;537;50-64;120;106;226;SEC_537
2016;514;25-34;90;85;175;SEC_514
2016;201;12-15;23;32;55;SEC_201
2016;530;50-64;147;139;286;SEC_530
2016;301;12-15;62;52;114;SEC_301
2016;618;25-34;41;49;90;SEC_618
2016;232;75 i +;73;48;121;SEC_232
2016;109;18-24;29;38;67;SEC_109
2016;311;50-64;121;114;235;SEC_311
2016;607;12-15;18;8;26;SEC_607
2016;606;50-64;87;93;180;SEC_606
2016;126;03-11;39;37;76;SEC_126
2016;247;75 i +;78;42;120;SEC_247
2016;405;65-74;79;59;138;SEC_405
2016;502;12-15;29;31;60;SEC_502
2016;104;03-11;39;30;69;SEC_104
2016;440;75 i +;80;67;147;SEC_440
2016;107;12-15;26;37;63;SEC_107
2016;229;00-02;25;34;59;SEC_229
2016;535;18-24;38;27;65;SEC_535
2016;133;03-11;36;39;75;SEC_133
2016;403;03-11;53;51;104;SEC_403
2016;414;03-11;89;86;175;SEC_414
2016;617;75 i +;72;42;114;SEC_617
2016;426;75 i +;47;24;71;SEC_426
2016;303;35-49;188;214;402;SEC_303
2016;526;00-02;34;27;61;SEC_526
2016;209;25-34;80;80;160;SEC_209
2016;249;50-64;97;85;182;SEC_249
2016;129;00-02;17;20;37;SEC_129
2016;124;35-49;92;92;184;SEC_124
2016;631;12-15;8;14;22;SEC_631
2016;322;00-02;16;17;33;SEC_322
2016;325;18-24;65;54;119;SEC_325
2016;404;03-11;70;68;138;SEC_404
2016;410;25-34;103;108;211;SEC_410
2016;608;25-34;59;65;124;SEC_608
2016;606;35-49;131;127;258;SEC_606
2016;517;50-64;197;152;349;SEC_517
2016;108;16-17;15;15;30;SEC_108
2016;518;50-64;89;84;173;SEC_518
2016;325;65-74;128;106;234;SEC_325
2016;423;35-49;135;132;267;SEC_423
2016;138;65-74;61;47;108;SEC_138
2016;304;03-11;179;201;380;SEC_304
2016;614;35-49;114;102;216;SEC_614
2016;618;00-02;7;9;16;SEC_618
2016;129;65-74;69;52;121;SEC_129
2016;305;65-74;74;75;149;SEC_305
2016;532;75 i +;98;68;166;SEC_532
2016;517;18-24;75;101;176;SEC_517
2016;404;18-24;49;57;106;SEC_404
2016;326;65-74;15;11;26;SEC_326
2016;612;03-11;40;32;72;SEC_612
2016;524;16-17;17;11;28;SEC_524
2016;228;03-11;107;111;218;SEC_228
2016;410;50-64;155;136;291;SEC_410
2016;402;03-11;57;53;110;SEC_402
2016;232;25-34;83;81;164;SEC_232
2016;320;65-74;89;86;175;SEC_320
2016;610;25-34;53;51;104;SEC_610
2016;608;16-17;12;9;21;SEC_608
2016;118;35-49;175;190;365;SEC_118
2016;528;03-11;45;48;93;SEC_528
2016;207;18-24;66;70;136;SEC_207
2016;525;50-64;58;60;118;SEC_525
2016;507;75 i +;47;21;68;SEC_507
2016;513;03-11;71;69;140;SEC_513
2016;137;75 i +;53;43;96;SEC_137
2016;248;12-15;23;14;37;SEC_248
2016;418;35-49;146;179;325;SEC_418
2016;246;00-02;22;17;39;SEC_246
2016;229;65-74;55;30;85;SEC_229
2016;530;00-02;31;37;68;SEC_530
2016;507;18-24;24;40;64;SEC_507
2016;624;03-11;39;42;81;SEC_624
2016;430;25-34;75;94;169;SEC_430
2016;121;35-49;124;131;255;SEC_121
2016;229;35-49;241;226;467;SEC_229
2016;242;65-74;67;46;113;SEC_242
2016;243;16-17;15;17;32;SEC_243
2016;205;35-49;106;102;208;SEC_205
2016;521;75 i +;70;59;129;SEC_521
2016;243;00-02;18;15;33;SEC_243
2016;624;12-15;18;20;38;SEC_624
2016;207;50-64;171;140;311;SEC_207
2016;327;25-34;88;84;172;SEC_327
2016;306;50-64;146;155;301;SEC_306
2016;317;50-64;88;71;159;SEC_317
2016;128;65-74;62;46;108;SEC_128
2016;224;03-11;51;66;117;SEC_224
2016;237;25-34;110;99;209;SEC_237
2016;615;00-02;10;11;21;SEC_615
2016;305;00-02;26;17;43;SEC_305
2016;117;12-15;31;38;69;SEC_117
2016;243;03-11;57;78;135;SEC_243
2016;128;03-11;43;57;100;SEC_128
2016;138;25-34;40;56;96;SEC_138
2016;137;16-17;16;13;29;SEC_137
2016;430;18-24;39;57;96;SEC_430
2016;130;00-02;18;13;31;SEC_130
2016;327;35-49;141;152;293;SEC_327
2016;310;65-74;49;50;99;SEC_310
2016;624;18-24;30;27;57;SEC_624
2016;248;65-74;45;43;88;SEC_248
2016;130;75 i +;100;58;158;SEC_130
2016;403;75 i +;96;80;176;SEC_403
2016;126;35-49;115;107;222;SEC_126
2016;437;03-11;64;70;134;SEC_437
2016;511;18-24;87;82;169;SEC_511
2016;602;03-11;58;67;125;SEC_602
2016;125;65-74;108;93;201;SEC_125
2016;538;03-11;52;50;102;SEC_538
2016;115;12-15;20;23;43;SEC_115
2016;529;18-24;50;48;98;SEC_529
2016;113;25-34;96;95;191;SEC_113
2016;315;25-34;125;131;256;SEC_315
2016;106;03-11;56;64;120;SEC_106
2016;503;16-17;6;7;13;SEC_503
2016;530;35-49;246;239;485;SEC_530
2016;419;25-34;138;161;299;SEC_419
2016;120;12-15;23;48;71;SEC_120
2016;103;25-34;42;37;79;SEC_103
2016;406;03-11;57;60;117;SEC_406
2016;526;16-17;15;22;37;SEC_526
2016;233;03-11;37;47;84;SEC_233
2016;101;18-24;64;68;132;SEC_101
2016;404;65-74;68;50;118;SEC_404
2016;430;16-17;6;12;18;SEC_430
2016;421;12-15;29;19;48;SEC_421
2016;531;50-64;81;82;163;SEC_531
2016;213;03-11;37;56;93;SEC_213
2016;308;50-64;212;197;409;SEC_308
2016;407;35-49;121;138;259;SEC_407
2016;238;03-11;42;55;97;SEC_238
2016;513;65-74;57;37;94;SEC_513
2016;630;18-24;19;34;53;SEC_630
2016;623;03-11;54;61;115;SEC_623
2016;237;65-74;64;49;113;SEC_237
2016;102;50-64;152;132;284;SEC_102
2016;406;18-24;60;54;114;SEC_406
2016;112;00-02;23;23;46;SEC_112
2016;440;03-11;40;46;86;SEC_440
2016;441;00-02;34;30;64;SEC_441
2016;301;25-34;149;171;320;SEC_301
2016;211;18-24;57;67;124;SEC_211
2016;613;25-34;47;52;99;SEC_613
2016;212;35-49;193;192;385;SEC_212
2016;410;65-74;104;86;190;SEC_410
2016;427;25-34;156;127;283;SEC_427
2016;433;16-17;18;14;32;SEC_433
2016;202;12-15;27;26;53;SEC_202
2016;137;00-02;22;18;40;SEC_137
2016;234;00-02;16;18;34;SEC_234
2016;607;75 i +;103;90;193;SEC_607
2016;312;12-15;19;25;44;SEC_312
2016;537;16-17;13;14;27;SEC_537
2016;136;65-74;63;64;127;SEC_136
2016;523;00-02;17;21;38;SEC_523
2016;412;75 i +;111;86;197;SEC_412
2016;411;50-64;94;74;168;SEC_411
2016;534;65-74;57;46;103;SEC_534
2016;521;03-11;36;31;67;SEC_521
2016;214;03-11;98;108;206;SEC_214
2016;419;18-24;65;92;157;SEC_419
2016;213;00-02;20;10;30;SEC_213
2016;311;00-02;21;26;47;SEC_311
2016;514;75 i +;101;60;161;SEC_514
2016;610;18-24;31;43;74;SEC_610
2016;132;18-24;68;78;146;SEC_132
2016;618;16-17;13;15;28;SEC_618
2016;108;00-02;23;22;45;SEC_108
2016;133;35-49;92;114;206;SEC_133
2016;503;03-11;18;23;41;SEC_503
2016;617;35-49;116;130;246;SEC_617
2016;631;00-02;5;17;22;SEC_631
2016;325;12-15;27;40;67;SEC_325
2016;119;65-74;112;107;219;SEC_119
2016;409;25-34;130;142;272;SEC_409
2016;610;65-74;130;88;218;SEC_610
2016;538;16-17;11;16;27;SEC_538
2016;608;12-15;30;23;53;SEC_608
2016;423;65-74;49;40;89;SEC_423
2016;217;12-15;18;26;44;SEC_217
2016;314;35-49;274;273;547;SEC_314
2016;129;25-34;50;78;128;SEC_129
2016;211;16-17;14;17;31;SEC_211
2016;103;12-15;15;10;25;SEC_103
2016;626;12-15;16;21;37;SEC_626
2016;518;18-24;37;49;86;SEC_518
2016;609;16-17;5;7;12;SEC_609
2016;307;18-24;28;39;67;SEC_307
2016;128;75 i +;58;46;104;SEC_128
2016;105;16-17;7;10;17;SEC_105
2016;304;35-49;481;486;967;SEC_304
2016;101;25-34;132;124;256;SEC_101
2016;115;50-64;112;126;238;SEC_115
2016;208;16-17;13;11;24;SEC_208
2016;611;65-74;109;73;182;SEC_611
2016;109;25-34;68;67;135;SEC_109
2016;104;50-64;80;80;160;SEC_104
2016;134;35-49;164;173;337;SEC_134
2016;535;00-02;8;5;13;SEC_535
2016;246;75 i +;69;46;115;SEC_246
2016;321;18-24;67;78;145;SEC_321
2016;410;75 i +;159;108;267;SEC_410
2016;249;16-17;10;13;23;SEC_249
2016;501;75 i +;41;37;78;SEC_501
2016;107;75 i +;111;68;179;SEC_107
2016;113;18-24;49;58;107;SEC_113
2016;614;18-24;21;32;53;SEC_614
2016;317;25-34;79;85;164;SEC_317
2016;607;25-34;54;63;117;SEC_607
2016;134;25-34;87;97;184;SEC_134
2016;201;50-64;101;89;190;SEC_201
2016;242;16-17;11;13;24;SEC_242
2016;139;12-15;15;17;32;SEC_139
2016;618;03-11;48;48;96;SEC_618
2016;301;50-64;233;224;457;SEC_301
2016;128;12-15;12;15;27;SEC_128
2016;212;12-15;17;28;45;SEC_212
2016;324;12-15;26;23;49;SEC_324
2016;607;65-74;66;24;90;SEC_607
2016;423;75 i +;75;57;132;SEC_423
2016;506;12-15;28;39;67;SEC_506
2016;624;16-17;7;7;14;SEC_624
2016;614;03-11;36;46;82;SEC_614
2016;526;75 i +;88;60;148;SEC_526
2016;108;65-74;66;57;123;SEC_108
2016;617;50-64;81;74;155;SEC_617
2016;130;50-64;84;84;168;SEC_130
2016;432;75 i +;82;52;134;SEC_432
2016;622;03-11;28;35;63;SEC_622
2016;510;25-34;64;74;138;SEC_510
2016;229;75 i +;87;51;138;SEC_229
2016;431;65-74;58;47;105;SEC_431
2016;221;35-49;261;275;536;SEC_221
2016;401;25-34;91;89;180;SEC_401
2016;433;75 i +;75;36;111;SEC_433
2016;202;18-24;75;72;147;SEC_202
2016;432;65-74;90;86;176;SEC_432
2016;248;75 i +;62;47;109;SEC_248
2016;327;00-02;13;19;32;SEC_327
2016;309;12-15;17;31;48;SEC_309
2016;625;16-17;8;9;17;SEC_625
2016;111;18-24;25;22;47;SEC_111
2016;126;25-34;57;51;108;SEC_126
2016;531;00-02;7;18;25;SEC_531
2016;129;75 i +;102;72;174;SEC_129
2016;616;65-74;110;100;210;SEC_616
2016;111;50-64;96;70;166;SEC_111
2016;605;50-64;146;113;259;SEC_605
2016;240;16-17;15;12;27;SEC_240
2016;239;16-17;7;10;17;SEC_239
2016;223;35-49;150;151;301;SEC_223
2016;125;35-49;217;229;446;SEC_125
2016;216;35-49;149;150;299;SEC_216
2016;325;03-11;63;63;126;SEC_325
2016;234;50-64;90;90;180;SEC_234
2016;107;65-74;101;81;182;SEC_107
2016;606;65-74;53;34;87;SEC_606
2016;406;00-02;22;16;38;SEC_406
2016;605;12-15;32;31;63;SEC_605
2016;240;12-15;24;30;54;SEC_240
2016;502;25-34;89;91;180;SEC_502
2016;618;75 i +;85;72;157;SEC_618
2016;231;35-49;183;179;362;SEC_231
2016;207;75 i +;118;53;171;SEC_207
2016;109;00-02;9;9;18;SEC_109
2016;622;16-17;9;13;22;SEC_622
2016;313;00-02;25;22;47;SEC_313
2016;401;18-24;43;53;96;SEC_401
2016;209;16-17;15;8;23;SEC_209
2016;528;16-17;16;8;24;SEC_528
2016;320;50-64;113;119;232;SEC_320
2016;327;12-15;31;19;50;SEC_327
2016;406;12-15;27;28;55;SEC_406
2016;412;12-15;27;27;54;SEC_412
2016;111;00-02;8;8;16;SEC_111
2016;320;25-34;61;66;127;SEC_320
2016;319;18-24;50;56;106;SEC_319
2016;431;12-15;34;33;67;SEC_431
2016;518;16-17;6;15;21;SEC_518
2016;105;12-15;19;24;43;SEC_105
2016;305;25-34;119;104;223;SEC_305
2016;410;12-15;22;38;60;SEC_410
2016;619;16-17;11;11;22;SEC_619
2016;632;65-74;49;40;89;SEC_632
2016;311;75 i +;93;57;150;SEC_311
2016;210;16-17;8;4;12;SEC_210
2016;124;12-15;16;11;27;SEC_124
2016;228;35-49;290;321;611;SEC_228
2016;538;00-02;17;13;30;SEC_538
2016;521;65-74;106;100;206;SEC_521
2016;320;12-15;2;2;4;SEC_320
2016;530;18-24;57;66;123;SEC_530
2016;412;65-74;118;91;209;SEC_412
2016;327;16-17;7;11;18;SEC_327
2016;111;12-15;10;21;31;SEC_111
2016;437;18-24;60;62;122;SEC_437
2016;419;35-49;231;328;559;SEC_419
2016;109;12-15;17;14;31;SEC_109
2016;139;25-34;50;60;110;SEC_139
2016;607;18-24;29;42;71;SEC_607
2016;320;75 i +;1;3;4;SEC_320
2016;302;12-15;16;14;30;SEC_302
2016;627;00-02;9;11;20;SEC_627
2016;403;65-74;80;58;138;SEC_403
2016;301;65-74;136;110;246;SEC_301
2016;315;12-15;22;29;51;SEC_315
2016;103;50-64;67;66;133;SEC_103
2016;615;75 i +;53;54;107;SEC_615
2016;122;50-64;56;50;106;SEC_122
2016;432;35-49;132;144;276;SEC_432
2016;303;65-74;113;77;190;SEC_303
2016;407;16-17;13;8;21;SEC_407
2016;324;16-17;14;15;29;SEC_324
2016;234;18-24;50;39;89;SEC_234
2016;204;16-17;11;10;21;SEC_204
2016;136;50-64;113;98;211;SEC_136
2016;427;12-15;31;28;59;SEC_427
2016;240;03-11;77;55;132;SEC_240
2016;616;12-15;39;45;84;SEC_616
2016;131;03-11;48;52;100;SEC_131
2016;249;65-74;51;34;85;SEC_249
2016;305;03-11;62;69;131;SEC_305
2016;123;35-49;161;137;298;SEC_123
2016;320;35-49;32;42;74;SEC_320
2016;243;65-74;56;50;106;SEC_243
2016;605;18-24;53;43;96;SEC_605
2016;224;25-34;117;113;230;SEC_224
2016;605;00-02;30;7;37;SEC_605
2016;124;03-11;42;36;78;SEC_124
2016;322;25-34;97;92;189;SEC_322
2016;310;12-15;14;18;32;SEC_310
2016;310;00-02;15;13;28;SEC_310
2016;401;75 i +;99;52;151;SEC_401
2016;121;16-17;5;11;16;SEC_121
2016;138;00-02;7;7;14;SEC_138
2016;221;12-15;41;36;77;SEC_221
2016;507;16-17;5;13;18;SEC_507
2016;208;75 i +;221;114;335;SEC_208
2016;325;00-02;14;22;36;SEC_325
2016;505;50-64;86;82;168;SEC_505
2016;435;00-02;26;14;40;SEC_435
2016;303;50-64;118;129;247;SEC_303
2016;123;12-15;23;22;45;SEC_123
2016;632;25-34;47;52;99;SEC_632
2016;406;35-49;162;155;317;SEC_406
2016;101;35-49;389;381;770;SEC_101
2016;530;25-34;139;120;259;SEC_530
2016;115;75 i +;70;37;107;SEC_115
2016;503;25-34;28;49;77;SEC_503
2016;103;03-11;31;33;64;SEC_103
2016;419;50-64;150;154;304;SEC_419
2016;506;18-24;49;62;111;SEC_506
2016;320;00-02;14;21;35;SEC_320
2016;524;03-11;54;66;120;SEC_524
2016;611;75 i +;101;91;192;SEC_611
2016;135;16-17;16;11;27;SEC_135
2016;532;18-24;44;44;88;SEC_532
2016;210;25-34;39;52;91;SEC_210
2016;242;50-64;99;98;197;SEC_242
2016;140;35-49;131;129;260;SEC_140
2016;120;03-11;55;71;126;SEC_120
2016;237;03-11;74;58;132;SEC_237
2016;204;75 i +;108;67;175;SEC_204
2016;528;75 i +;73;55;128;SEC_528
2016;221;03-11;93;89;182;SEC_221
2016;418;03-11;68;57;125;SEC_418
2016;418;65-74;60;46;106;SEC_418
2016;237;18-24;43;44;87;SEC_237
2016;113;75 i +;58;48;106;SEC_113
2016;116;12-15;18;24;42;SEC_116
2016;537;75 i +;81;55;136;SEC_537
2016;246;03-11;61;51;112;SEC_246
2016;126;75 i +;71;69;140;SEC_126
2016;632;12-15;22;19;41;SEC_632
2016;101;50-64;199;200;399;SEC_101
2016;525;18-24;43;30;73;SEC_525
2016;507;65-74;54;48;102;SEC_507
2016;611;16-17;15;15;30;SEC_611
2016;210;12-15;13;19;32;SEC_210
2016;617;65-74;59;41;100;SEC_617
2016;233;25-34;84;79;163;SEC_233
2016;510;12-15;17;11;28;SEC_510
2016;314;25-34;145;168;313;SEC_314
2016;514;35-49;174;190;364;SEC_514
2016;322;50-64;120;97;217;SEC_322
2016;421;50-64;100;80;180;SEC_421
2016;625;50-64;178;140;318;SEC_625
2016;605;35-49;185;196;381;SEC_605
2016;247;16-17;12;8;20;SEC_247
2016;240;75 i +;113;72;185;SEC_240
2016;108;18-24;55;52;107;SEC_108
2016;316;16-17;14;13;27;SEC_316
2016;533;18-24;67;60;127;SEC_533
2016;320;12-15;43;34;77;SEC_320
2016;110;16-17;2;8;10;SEC_110
2016;526;03-11;79;96;175;SEC_526
2016;320;03-11;13;3;16;SEC_320
2016;327;65-74;66;64;130;SEC_327
2016;226;16-17;13;16;29;SEC_226
2016;131;65-74;124;114;238;SEC_131
2016;304;00-02;75;102;177;SEC_304
2016;102;03-11;54;52;106;SEC_102
2016;102;65-74;133;124;257;SEC_102
2016;430;75 i +;52;34;86;SEC_430
2016;615;12-15;17;8;25;SEC_615
2016;520;35-49;92;92;184;SEC_520
2016;229;12-15;48;27;75;SEC_229
2016;318;65-74;45;41;86;SEC_318
2016;308;18-24;75;79;154;SEC_308
2016;213;18-24;32;41;73;SEC_213
2016;207;65-74;78;63;141;SEC_207
2016;135;25-34;89;107;196;SEC_135
2016;114;65-74;114;82;196;SEC_114
2016;239;00-02;18;8;26;SEC_239
2016;246;65-74;36;37;73;SEC_246
2016;109;65-74;72;66;138;SEC_109
2016;405;00-02;17;37;54;SEC_405
2016;304;12-15;94;46;140;SEC_304
2016;626;25-34;51;35;86;SEC_626
2016;402;75 i +;60;43;103;SEC_402
2016;423;12-15;26;22;48;SEC_423
2016;140;00-02;14;12;26;SEC_140
2016;104;65-74;42;34;76;SEC_104
2016;531;25-34;75;83;158;SEC_531
2016;318;35-49;81;82;163;SEC_318
2016;239;35-49;134;156;290;SEC_239
2016;211;25-34;107;117;224;SEC_211
2016;238;18-24;41;34;75;SEC_238
2016;504;50-64;75;70;145;SEC_504
2016;625;65-74;106;86;192;SEC_625
2016;416;75 i +;88;50;138;SEC_416
2016;213;35-49;112;117;229;SEC_213
2016;514;65-74;49;30;79;SEC_514
2016;405;16-17;23;18;41;SEC_405
2016;216;00-02;22;15;37;SEC_216
2016;303;16-17;16;9;25;SEC_303
2016;118;03-11;77;80;157;SEC_118
2016;623;65-74;141;99;240;SEC_623
2016;432;03-11;50;48;98;SEC_432
2016;534;00-02;14;27;41;SEC_534
2016;223;16-17;11;13;24;SEC_223
2016;209;18-24;32;36;68;SEC_209
2016;623;35-49;160;172;332;SEC_623
2016;309;65-74;41;43;84;SEC_309
2016;133;00-02;11;5;16;SEC_133
2016;105;35-49;139;140;279;SEC_105
2016;129;35-49;123;128;251;SEC_129
2016;112;35-49;214;203;417;SEC_112
2016;212;16-17;12;8;20;SEC_212
2016;216;16-17;18;14;32;SEC_216
2016;510;35-49;109;123;232;SEC_510
2016;111;16-17;12;7;19;SEC_111
2016;236;65-74;63;37;100;SEC_236
2016;309;50-64;107;79;186;SEC_309
2016;601;75 i +;128;112;240;SEC_601
2016;440;50-64;71;77;148;SEC_440
2016;504;16-17;4;7;11;SEC_504
2016;524;35-49;163;182;345;SEC_524
2016;228;25-34;179;182;361;SEC_228
2016;510;03-11;48;44;92;SEC_510
2016;321;12-15;35;43;78;SEC_321
2016;436;65-74;58;51;109;SEC_436
2016;431;50-64;115;105;220;SEC_431
2016;606;00-02;12;21;33;SEC_606
2016;116;75 i +;96;75;171;SEC_116
2016;510;50-64;97;92;189;SEC_510
2016;602;75 i +;83;88;171;SEC_602
2016;138;18-24;25;21;46;SEC_138
2016;405;50-64;158;147;305;SEC_405
2016;112;18-24;58;62;120;SEC_112
2016;326;25-34;140;105;245;SEC_326
2016;538;50-64;120;103;223;SEC_538
2016;511;75 i +;146;102;248;SEC_511
2016;612;25-34;48;36;84;SEC_612
2016;306;65-74;87;70;157;SEC_306
2016;223;00-02;23;15;38;SEC_223
2016;217;00-02;15;19;34;SEC_217
2016;121;00-02;6;14;20;SEC_121
2016;316;25-34;155;165;320;SEC_316
2016;221;16-17;17;21;38;SEC_221
2016;114;03-11;50;60;110;SEC_114
2016;513;25-34;86;91;177;SEC_513
2016;403;25-34;71;79;150;SEC_403
2016;502;35-49;182;191;373;SEC_502
2016;432;12-15;22;16;38;SEC_432
2016;122;16-17;4;15;19;SEC_122
2016;211;50-64;118;95;213;SEC_211
2016;616;16-17;23;35;58;SEC_616
2016;422;75 i +;77;39;116;SEC_422
2016;538;25-34;88;79;167;SEC_538
2016;213;65-74;52;33;85;SEC_213
2016;301;75 i +;153;101;254;SEC_301
2016;309;00-02;12;19;31;SEC_309
2016;201;03-11;71;80;151;SEC_201
2016;529;50-64;105;95;200;SEC_529
2016;311;03-11;54;80;134;SEC_311
2016;237;35-49;173;190;363;SEC_237
2016;121;12-15;14;12;26;SEC_121
2016;525;03-11;46;48;94;SEC_525
2016;202;75 i +;74;60;134;SEC_202
2016;310;75 i +;42;22;64;SEC_310
2016;101;16-17;12;15;27;SEC_101
2016;128;00-02;10;18;28;SEC_128
2016;435;65-74;37;28;65;SEC_435
2016;220;25-34;148;167;315;SEC_220
2016;114;18-24;49;36;85;SEC_114
2016;420;03-11;96;73;169;SEC_420
2016;402;00-02;6;20;26;SEC_402
2016;133;18-24;17;24;41;SEC_133
2016;248;50-64;110;112;222;SEC_248
2016;305;12-15;34;22;56;SEC_305
2016;122;75 i +;69;59;128;SEC_122
2016;436;35-49;202;223;425;SEC_436
2016;201;35-49;232;238;470;SEC_201
2016;305;50-64;201;173;374;SEC_305
2016;127;35-49;99;91;190;SEC_127
2016;110;35-49;117;121;238;SEC_110
2016;119;75 i +;101;59;160;SEC_119
2016;202;35-49;243;278;521;SEC_202
2016;210;35-49;103;89;192;SEC_210
2016;608;50-64;147;116;263;SEC_608
2016;312;03-11;55;74;129;SEC_312
2016;309;75 i +;46;27;73;SEC_309
2016;324;65-74;51;34;85;SEC_324
2016;404;16-17;6;15;21;SEC_404
2016;239;75 i +;90;52;142;SEC_239
2016;247;03-11;85;78;163;SEC_247
2016;307;16-17;9;10;19;SEC_307
2016;418;50-64;108;117;225;SEC_418
2016;210;75 i +;89;43;132;SEC_210
2016;113;65-74;94;100;194;SEC_113
2016;517;35-49;251;302;553;SEC_517
2016;422;16-17;12;8;20;SEC_422
2016;520;12-15;7;17;24;SEC_520
2016;306;35-49;212;182;394;SEC_306
2016;419;75 i +;110;75;185;SEC_419
2016;116;18-24;46;38;84;SEC_116
2016;220;75 i +;95;57;152;SEC_220
2016;121;75 i +;73;42;115;SEC_121
2016;520;00-02;9;12;21;SEC_520
2016;532;50-64;119;86;205;SEC_532
2016;205;75 i +;76;49;125;SEC_205
2016;119;03-11;45;39;84;SEC_119
2016;416;50-64;112;107;219;SEC_416
2016;109;50-64;132;119;251;SEC_109
2016;104;75 i +;79;40;119;SEC_104
2016;105;65-74;65;74;139;SEC_105
2016;611;18-24;45;49;94;SEC_611
2016;140;65-74;48;45;93;SEC_140
2016;210;00-02;7;7;14;SEC_210
2016;617;18-24;36;34;70;SEC_617
2016;233;35-49;131;147;278;SEC_233
2016;537;65-74;88;68;156;SEC_537
2016;318;25-34;51;49;100;SEC_318
2016;138;16-17;9;6;15;SEC_138
2016;248;35-49;171;168;339;SEC_248
2016;602;00-02;12;20;32;SEC_602
2016;621;75 i +;51;43;94;SEC_621
2016;433;50-64;163;157;320;SEC_433
2016;106;35-49;181;197;378;SEC_106
2016;616;00-02;22;23;45;SEC_616
2016;523;12-15;25;23;48;SEC_523
2016;402;12-15;14;18;32;SEC_402
2016;303;75 i +;143;117;260;SEC_303
2016;322;16-17;14;16;30;SEC_322
2016;112;25-34;92;96;188;SEC_112
2016;239;12-15;14;18;32;SEC_239
2016;122;18-24;24;23;47;SEC_122
2016;407;50-64;86;74;160;SEC_407
2016;416;18-24;60;69;129;SEC_416
2016;134;50-64;147;113;260;SEC_134
2016;402;25-34;80;63;143;SEC_402
2016;239;65-74;59;30;89;SEC_239
2016;501;50-64;116;76;192;SEC_501
2016;135;65-74;79;79;158;SEC_135
2016;513;00-02;17;24;41;SEC_513
2016;118;75 i +;58;54;112;SEC_118
2016;110;18-24;23;30;53;SEC_110
2016;529;35-49;181;169;350;SEC_529
2016;320;25-34;33;29;62;SEC_320
2016;223;03-11;58;51;109;SEC_223
2016;249;25-34;76;88;164;SEC_249
2016;119;16-17;4;10;14;SEC_119
2016;508;16-17;11;13;24;SEC_508
2016;631;03-11;44;49;93;SEC_631
2016;419;03-11;68;115;183;SEC_419
2016;249;00-02;14;11;25;SEC_249
2016;503;65-74;54;69;123;SEC_503
2016;224;35-49;157;149;306;SEC_224
2016;317;03-11;64;60;124;SEC_317
2016;243;18-24;54;80;134;SEC_243
2016;102;18-24;47;49;96;SEC_102
2016;214;75 i +;118;66;184;SEC_214
2016;105;03-11;47;57;104;SEC_105
2016;247;50-64;127;108;235;SEC_247
2016;135;75 i +;82;56;138;SEC_135
2016;412;50-64;162;132;294;SEC_412
2016;501;03-11;19;35;54;SEC_501
2016;129;50-64;88;83;171;SEC_129
2016;201;65-74;49;31;80;SEC_201
2016;245;18-24;56;47;103;SEC_245
2016;128;50-64;79;82;161;SEC_128
2016;212;75 i +;77;49;126;SEC_212
2016;621;16-17;10;17;27;SEC_621
2016;234;35-49;147;134;281;SEC_234
2016;513;16-17;16;16;32;SEC_513
2016;318;50-64;110;100;210;SEC_318
2016;138;75 i +;49;37;86;SEC_138
2016;416;65-74;68;54;122;SEC_416
2016;303;00-02;23;23;46;SEC_303
2016;309;03-11;69;70;139;SEC_309
2016;107;18-24;35;51;86;SEC_107
2016;535;35-49;91;91;182;SEC_535
2016;117;16-17;19;14;33;SEC_117
2016;302;03-11;50;41;91;SEC_302
2016;601;03-11;76;85;161;SEC_601
2016;242;75 i +;67;54;121;SEC_242
2016;305;16-17;14;13;27;SEC_305
2016;114;25-34;60;65;125;SEC_114
2016;324;18-24;32;40;72;SEC_324
2016;615;35-49;99;101;200;SEC_615
2016;602;50-64;91;105;196;SEC_602
2016;403;00-02;17;14;31;SEC_403
2016;538;65-74;67;33;100;SEC_538
2016;234;75 i +;59;41;100;SEC_234
