AnyPadro;Seccio;GrupEdat;Dones;Homes;Total;IdSeccio
2001;240;00-02;7;11;18;SEC_240
2001;314;03-11;80;109;189;SEC_314
2001;433;50-64;71;73;144;SEC_433
2001;244;16-17;2;3;5;SEC_244
2001;429;75 i +;33;21;54;SEC_429
2001;506;25-34;152;182;334;SEC_506
2001;213;25-34;73;84;157;SEC_213
2001;509;75 i +;39;17;56;SEC_509
2001;441;16-17;34;28;62;SEC_441
2001;536;35-49;82;88;170;SEC_536
2001;140;03-11;13;16;29;SEC_140
2001;526;50-64;55;57;112;SEC_526
2001;230;25-34;75;76;151;SEC_230
2001;304;75 i +;91;38;129;SEC_304
2001;518;25-34;93;100;193;SEC_518
2001;228;12-15;11;9;20;SEC_228
2001;628;75 i +;36;17;53;SEC_628
2001;621;65-74;47;40;87;SEC_621
2001;201;50-64;77;59;136;SEC_201
2001;123;65-74;84;78;162;SEC_123
2001;502;16-17;15;18;33;SEC_502
2001;218;35-49;77;78;155;SEC_218
2001;516;50-64;59;55;114;SEC_516
2001;245;18-24;39;45;84;SEC_245
2001;419;25-34;79;91;170;SEC_419
2001;140;16-17;7;7;14;SEC_140
2001;235;03-11;29;37;66;SEC_235
2001;130;65-74;90;77;167;SEC_130
2001;312;50-64;196;164;360;SEC_312
2001;128;16-17;11;8;19;SEC_128
2001;216;35-49;114;106;220;SEC_216
2001;305;75 i +;78;45;123;SEC_305
2001;624;75 i +;27;11;38;SEC_624
2001;404;25-34;115;120;235;SEC_404
2001;603;25-34;58;81;139;SEC_603
2001;132;12-15;41;36;77;SEC_132
2001;611;12-15;22;24;46;SEC_611
2001;249;75 i +;55;36;91;SEC_249
2001;243;00-02;15;25;40;SEC_243
2001;110;00-02;6;7;13;SEC_110
2001;231;25-34;95;90;185;SEC_231
2001;323;12-15;76;59;135;SEC_323
2001;508;25-34;46;53;99;SEC_508
2001;603;75 i +;15;17;32;SEC_603
2001;507;75 i +;37;22;59;SEC_507
2001;433;12-15;20;11;31;SEC_433
2001;210;12-15;7;16;23;SEC_210
2001;140;50-64;106;103;209;SEC_140
2001;441;12-15;62;50;112;SEC_441
2001;320;25-34;96;109;205;SEC_320
2001;107;25-34;163;196;359;SEC_107
2001;441;35-49;241;240;481;SEC_441
2001;627;75 i +;24;15;39;SEC_627
2001;225;25-34;36;43;79;SEC_225
2001;207;03-11;15;20;35;SEC_207
2001;520;25-34;64;75;139;SEC_520
2001;317;12-15;13;18;31;SEC_317
2001;409;50-64;66;61;127;SEC_409
2001;408;75 i +;36;21;57;SEC_408
2001;430;16-17;9;11;20;SEC_430
2001;109;03-11;37;39;76;SEC_109
2001;304;18-24;48;48;96;SEC_304
2001;114;16-17;20;17;37;SEC_114
2001;439;75 i +;40;25;65;SEC_439
2001;114;12-15;19;15;34;SEC_114
2001;209;35-49;90;104;194;SEC_209
2001;517;18-24;49;63;112;SEC_517
2001;237;75 i +;70;38;108;SEC_237
2001;319;00-02;11;13;24;SEC_319
2001;515;25-34;44;68;112;SEC_515
2001;217;35-49;69;70;139;SEC_217
2001;422;16-17;4;11;15;SEC_422
2001;405;50-64;104;79;183;SEC_405
2001;406;18-24;74;77;151;SEC_406
2001;414;00-02;13;6;19;SEC_414
2001;318;65-74;22;23;45;SEC_318
2001;109;00-02;14;15;29;SEC_109
2001;411;75 i +;52;35;87;SEC_411
2001;601;16-17;13;8;21;SEC_601
2001;207;65-74;47;35;82;SEC_207
2001;139;35-49;88;101;189;SEC_139
2001;214;35-49;53;60;113;SEC_214
2001;414;65-74;70;57;127;SEC_414
2001;243;25-34;134;136;270;SEC_243
2001;311;03-11;32;47;79;SEC_311
2001;125;12-15;19;20;39;SEC_125
2001;522;18-24;41;43;84;SEC_522
2001;511;18-24;26;29;55;SEC_511
2001;318;50-64;65;65;130;SEC_318
2001;302;65-74;59;42;101;SEC_302
2001;513;35-49;63;77;140;SEC_513
2001;534;16-17;5;4;9;SEC_534
2001;414;16-17;4;12;16;SEC_414
2001;513;50-64;74;56;130;SEC_513
2001;426;50-64;78;77;155;SEC_426
2001;305;16-17;18;21;39;SEC_305
2001;619;16-17;12;19;31;SEC_619
2001;519;00-02;7;12;19;SEC_519
2001;618;03-11;17;24;41;SEC_618
2001;211;50-64;82;64;146;SEC_211
2001;118;18-24;143;142;285;SEC_118
2001;134;00-02;22;13;35;SEC_134
2001;610;00-02;10;17;27;SEC_610
2001;123;25-34;109;103;212;SEC_123
2001;131;12-15;26;28;54;SEC_131
2001;513;00-02;11;12;23;SEC_513
2001;532;18-24;61;68;129;SEC_532
2001;630;18-24;73;87;160;SEC_630
2001;531;25-34;78;79;157;SEC_531
2001;217;00-02;4;6;10;SEC_217
2001;619;12-15;22;32;54;SEC_619
2001;510;00-02;18;19;37;SEC_510
2001;107;16-17;14;20;34;SEC_107
2001;231;75 i +;88;46;134;SEC_231
2001;247;18-24;51;45;96;SEC_247
2001;506;75 i +;65;39;104;SEC_506
2001;510;65-74;60;55;115;SEC_510
2001;629;00-02;6;5;11;SEC_629
2001;324;75 i +;53;26;79;SEC_324
2001;618;65-74;27;22;49;SEC_618
2001;135;25-34;116;122;238;SEC_135
2001;308;18-24;75;71;146;SEC_308
2001;210;75 i +;69;38;107;SEC_210
2001;624;50-64;160;173;333;SEC_624
2001;422;18-24;52;50;102;SEC_422
2001;419;75 i +;39;18;57;SEC_419
2001;248;25-34;101;116;217;SEC_248
2001;534;75 i +;49;19;68;SEC_534
2001;319;65-74;36;25;61;SEC_319
2001;208;65-74;140;124;264;SEC_208
2001;427;35-49;76;81;157;SEC_427
2001;238;65-74;58;37;95;SEC_238
2001;525;16-17;6;4;10;SEC_525
2001;429;50-64;49;54;103;SEC_429
2001;324;00-02;12;16;28;SEC_324
2001;407;12-15;6;19;25;SEC_407
2001;201;35-49;53;52;105;SEC_201
2001;524;03-11;41;56;97;SEC_524
2001;627;00-02;15;5;20;SEC_627
2001;622;00-02;13;10;23;SEC_622
2001;415;16-17;7;6;13;SEC_415
2001;309;75 i +;30;10;40;SEC_309
2001;220;18-24;44;25;69;SEC_220
2001;501;50-64;154;182;336;SEC_501
2001;628;35-49;104;78;182;SEC_628
2001;421;35-49;79;90;169;SEC_421
2001;206;25-34;67;82;149;SEC_206
2001;236;25-34;72;87;159;SEC_236
2001;604;65-74;36;35;71;SEC_604
2001;412;50-64;180;173;353;SEC_412
2001;133;75 i +;43;33;76;SEC_133
2001;506;16-17;17;23;40;SEC_506
2001;622;35-49;94;78;172;SEC_622
2001;226;50-64;92;84;176;SEC_226
2001;101;25-34;113;123;236;SEC_101
2001;501;18-24;94;104;198;SEC_501
2001;110;16-17;13;13;26;SEC_110
2001;530;25-34;129;139;268;SEC_530
2001;202;25-34;69;80;149;SEC_202
2001;402;18-24;40;33;73;SEC_402
2001;104;18-24;28;24;52;SEC_104
2001;134;18-24;44;71;115;SEC_134
2001;204;03-11;11;14;25;SEC_204
2001;106;18-24;142;159;301;SEC_106
2001;532;03-11;43;36;79;SEC_532
2001;317;25-34;91;93;184;SEC_317
2001;416;03-11;27;26;53;SEC_416
2001;527;00-02;16;13;29;SEC_527
2001;124;25-34;63;66;129;SEC_124
2001;408;25-34;61;66;127;SEC_408
2001;412;12-15;22;30;52;SEC_412
2001;630;35-49;95;72;167;SEC_630
2001;301;75 i +;78;40;118;SEC_301
2001;513;12-15;7;11;18;SEC_513
2001;429;65-74;51;34;85;SEC_429
2001;224;75 i +;35;13;48;SEC_224
2001;223;50-64;100;87;187;SEC_223
2001;321;16-17;25;26;51;SEC_321
2001;136;00-02;11;13;24;SEC_136
2001;211;35-49;114;110;224;SEC_211
2001;103;03-11;29;20;49;SEC_103
2001;246;03-11;31;36;67;SEC_246
2001;211;03-11;41;41;82;SEC_211
2001;523;50-64;130;116;246;SEC_523
2001;412;16-17;22;14;36;SEC_412
2001;437;16-17;8;9;17;SEC_437
2001;412;65-74;96;100;196;SEC_412
2001;507;12-15;18;18;36;SEC_507
2001;208;18-24;62;68;130;SEC_208
2001;418;03-11;33;41;74;SEC_418
2001;503;65-74;30;21;51;SEC_503
2001;513;65-74;55;51;106;SEC_513
2001;615;18-24;48;45;93;SEC_615
2001;627;18-24;97;79;176;SEC_627
2001;528;18-24;43;60;103;SEC_528
2001;504;50-64;153;140;293;SEC_504
2001;325;75 i +;135;69;204;SEC_325
2001;138;18-24;48;57;105;SEC_138
2001;132;50-64;177;211;388;SEC_132
2001;308;00-02;22;33;55;SEC_308
2001;102;65-74;97;75;172;SEC_102
2001;611;16-17;16;11;27;SEC_611
2001;609;12-15;11;14;25;SEC_609
2001;504;25-34;118;123;241;SEC_504
2001;519;65-74;45;42;87;SEC_519
2001;321;25-34;174;187;361;SEC_321
2001;609;25-34;82;106;188;SEC_609
2001;321;03-11;84;95;179;SEC_321
2001;310;75 i +;29;17;46;SEC_310
2001;114;18-24;101;93;194;SEC_114
2001;139;12-15;10;16;26;SEC_139
2001;235;16-17;6;9;15;SEC_235
2001;204;00-02;3;6;9;SEC_204
2001;301;35-49;212;210;422;SEC_301
2001;429;12-15;9;18;27;SEC_429
2001;325;00-02;20;20;40;SEC_325
2001;427;16-17;6;6;12;SEC_427
2001;613;25-34;147;164;311;SEC_613
2001;224;16-17;4;4;8;SEC_224
2001;138;75 i +;22;15;37;SEC_138
2001;227;12-15;8;6;14;SEC_227
2001;415;03-11;22;27;49;SEC_415
2001;438;16-17;11;4;15;SEC_438
2001;422;75 i +;65;41;106;SEC_422
2001;127;18-24;34;37;71;SEC_127
2001;220;50-64;71;52;123;SEC_220
2001;231;35-49;102;121;223;SEC_231
2001;228;16-17;3;5;8;SEC_228
2001;115;12-15;16;27;43;SEC_115
2001;419;00-02;16;16;32;SEC_419
2001;210;35-49;77;76;153;SEC_210
2001;411;25-34;68;83;151;SEC_411
2001;104;03-11;35;23;58;SEC_104
2001;413;65-74;48;32;80;SEC_413
2001;608;35-49;85;92;177;SEC_608
2001;236;16-17;9;6;15;SEC_236
2001;111;50-64;108;94;202;SEC_111
2001;103;16-17;10;5;15;SEC_103
2001;314;65-74;64;55;119;SEC_314
2001;529;16-17;12;10;22;SEC_529
2001;122;65-74;45;50;95;SEC_122
2001;225;35-49;43;46;89;SEC_225
2001;609;50-64;138;121;259;SEC_609
2001;516;35-49;55;67;122;SEC_516
2001;310;35-49;101;108;209;SEC_310
2001;107;03-11;37;56;93;SEC_107
2001;420;18-24;58;64;122;SEC_420
2001;527;12-15;21;18;39;SEC_527
2001;517;12-15;22;16;38;SEC_517
2001;247;25-34;102;110;212;SEC_247
2001;131;50-64;170;183;353;SEC_131
2001;304;35-49;110;130;240;SEC_304
2001;425;03-11;23;32;55;SEC_425
2001;103;12-15;12;8;20;SEC_103
2001;109;16-17;14;9;23;SEC_109
2001;436;18-24;39;46;85;SEC_436
2001;620;16-17;7;8;15;SEC_620
2001;133;18-24;47;49;96;SEC_133
2001;325;16-17;11;18;29;SEC_325
2001;315;12-15;20;27;47;SEC_315
2001;226;00-02;10;6;16;SEC_226
2001;401;12-15;26;25;51;SEC_401
2001;316;03-11;78;85;163;SEC_316
2001;226;12-15;25;17;42;SEC_226
2001;209;25-34;77;82;159;SEC_209
2001;440;25-34;89;107;196;SEC_440
2001;101;18-24;68;67;135;SEC_101
2001;118;25-34;136;151;287;SEC_118
2001;202;16-17;5;7;12;SEC_202
2001;102;00-02;20;18;38;SEC_102
2001;125;50-64;143;149;292;SEC_125
2001;110;50-64;168;165;333;SEC_110
2001;522;50-64;61;53;114;SEC_522
2001;515;16-17;9;3;12;SEC_515
2001;215;75 i +;56;42;98;SEC_215
2001;226;18-24;47;50;97;SEC_226
2001;103;50-64;62;58;120;SEC_103
2001;439;35-49;76;77;153;SEC_439
2001;421;50-64;133;96;229;SEC_421
2001;417;03-11;24;16;40;SEC_417
2001;138;25-34;62;58;120;SEC_138
2001;246;16-17;9;5;14;SEC_246
2001;221;03-11;35;41;76;SEC_221
2001;223;75 i +;74;29;103;SEC_223
2001;235;25-34;127;110;237;SEC_235
2001;234;12-15;14;13;27;SEC_234
2001;320;65-74;27;12;39;SEC_320
2001;109;25-34;88;81;169;SEC_109
2001;217;25-34;39;59;98;SEC_217
2001;424;65-74;36;43;79;SEC_424
2001;534;03-11;30;29;59;SEC_534
2001;211;75 i +;77;52;129;SEC_211
2001;133;00-02;4;10;14;SEC_133
2001;237;03-11;36;30;66;SEC_237
2001;510;12-15;16;18;34;SEC_510
2001;309;03-11;23;34;57;SEC_309
2001;609;16-17;4;5;9;SEC_609
2001;514;50-64;58;45;103;SEC_514
2001;238;18-24;28;29;57;SEC_238
2001;409;35-49;73;62;135;SEC_409
2001;128;75 i +;40;25;65;SEC_128
2001;134;16-17;18;11;29;SEC_134
2001;523;18-24;64;73;137;SEC_523
2001;402;35-49;70;80;150;SEC_402
2001;411;18-24;70;50;120;SEC_411
2001;140;65-74;70;63;133;SEC_140
2001;241;00-02;4;6;10;SEC_241
2001;323;18-24;203;218;421;SEC_323
2001;405;12-15;12;7;19;SEC_405
2001;303;18-24;66;64;130;SEC_303
2001;410;18-24;91;104;195;SEC_410
2001;241;12-15;15;9;24;SEC_241
2001;234;35-49;83;81;164;SEC_234
2001;530;16-17;9;10;19;SEC_530
2001;130;18-24;36;29;65;SEC_130
2001;216;65-74;82;70;152;SEC_216
2001;106;00-02;21;18;39;SEC_106
2001;612;65-74;49;56;105;SEC_612
2001;611;65-74;86;86;172;SEC_611
2001;437;75 i +;25;15;40;SEC_437
2001;616;75 i +;33;21;54;SEC_616
2001;225;00-02;2;5;7;SEC_225
2001;204;18-24;20;19;39;SEC_204
2001;123;16-17;12;13;25;SEC_123
2001;537;35-49;121;120;241;SEC_537
2001;601;50-64;167;170;337;SEC_601
2001;437;12-15;10;20;30;SEC_437
2001;115;65-74;79;49;128;SEC_115
2001;305;12-15;43;34;77;SEC_305
2001;608;75 i +;34;13;47;SEC_608
2001;115;50-64;121;125;246;SEC_115
2001;622;03-11;24;47;71;SEC_622
2001;414;18-24;28;46;74;SEC_414
2001;415;75 i +;45;28;73;SEC_415
2001;526;25-34;60;74;134;SEC_526
2001;220;75 i +;40;27;67;SEC_220
2001;433;65-74;49;43;92;SEC_433
2001;504;00-02;8;8;16;SEC_504
2001;501;03-11;30;40;70;SEC_501
2001;431;16-17;14;14;28;SEC_431
2001;130;25-34;92;102;194;SEC_130
2001;623;65-74;50;48;98;SEC_623
2001;112;16-17;15;18;33;SEC_112
2001;436;35-49;74;93;167;SEC_436
2001;432;75 i +;38;32;70;SEC_432
2001;109;35-49;126;128;254;SEC_109
2001;626;18-24;40;46;86;SEC_626
2001;422;25-34;78;76;154;SEC_422
2001;101;03-11;53;61;114;SEC_101
2001;604;18-24;35;45;80;SEC_604
2001;320;16-17;3;5;8;SEC_320
2001;502;25-34;107;137;244;SEC_502
2001;619;75 i +;50;34;84;SEC_619
2001;210;25-34;58;66;124;SEC_210
2001;314;16-17;36;37;73;SEC_314
2001;311;18-24;50;68;118;SEC_311
2001;220;16-17;7;5;12;SEC_220
2001;442;75 i +;29;23;52;SEC_442
2001;504;75 i +;51;39;90;SEC_504
2001;527;65-74;69;45;114;SEC_527
2001;207;18-24;29;31;60;SEC_207
2001;231;50-64;93;77;170;SEC_231
2001;319;03-11;21;32;53;SEC_319
2001;412;25-34;110;144;254;SEC_412
2001;115;25-34;100;128;228;SEC_115
2001;505;00-02;9;3;12;SEC_505
2001;104;16-17;3;3;6;SEC_104
2001;223;12-15;15;11;26;SEC_223
2001;622;50-64;80;79;159;SEC_622
2001;229;65-74;55;47;102;SEC_229
2001;411;03-11;30;25;55;SEC_411
2001;523;03-11;33;44;77;SEC_523
2001;408;16-17;9;7;16;SEC_408
2001;211;16-17;10;4;14;SEC_211
2001;113;35-49;188;162;350;SEC_113
2001;509;18-24;41;30;71;SEC_509
2001;225;18-24;15;28;43;SEC_225
2001;312;12-15;30;21;51;SEC_312
2001;232;03-11;31;25;56;SEC_232
2001;525;03-11;21;22;43;SEC_525
2001;133;16-17;8;9;17;SEC_133
2001;203;12-15;8;9;17;SEC_203
2001;629;35-49;63;54;117;SEC_629
2001;514;18-24;24;36;60;SEC_514
2001;521;18-24;77;78;155;SEC_521
2001;441;25-34;131;153;284;SEC_441
2001;417;00-02;7;5;12;SEC_417
2001;246;25-34;109;106;215;SEC_246
2001;514;65-74;54;39;93;SEC_514
2001;238;00-02;11;9;20;SEC_238
2001;430;18-24;38;36;74;SEC_430
2001;217;65-74;44;34;78;SEC_217
2001;419;35-49;61;83;144;SEC_419
2001;424;35-49;44;50;94;SEC_424
2001;442;18-24;23;27;50;SEC_442
2001;212;50-64;134;117;251;SEC_212
2001;619;35-49;152;151;303;SEC_619
2001;243;16-17;14;8;22;SEC_243
2001;440;00-02;7;5;12;SEC_440
2001;209;00-02;10;6;16;SEC_209
2001;302;18-24;88;85;173;SEC_302
2001;502;00-02;10;17;27;SEC_502
2001;441;75 i +;78;54;132;SEC_441
2001;323;65-74;79;59;138;SEC_323
2001;203;65-74;47;37;84;SEC_203
2001;618;00-02;4;6;10;SEC_618
2001;217;16-17;6;6;12;SEC_217
2001;248;16-17;15;9;24;SEC_248
2001;238;03-11;19;15;34;SEC_238
2001;113;00-02;6;16;22;SEC_113
2001;621;35-49;175;134;309;SEC_621
2001;625;12-15;32;44;76;SEC_625
2001;502;35-49;150;131;281;SEC_502
2001;411;12-15;17;6;23;SEC_411
2001;307;50-64;176;173;349;SEC_307
2001;434;12-15;16;16;32;SEC_434
2001;610;12-15;16;21;37;SEC_610
2001;427;65-74;78;48;126;SEC_427
2001;522;12-15;11;12;23;SEC_522
2001;125;18-24;62;91;153;SEC_125
2001;234;00-02;9;5;14;SEC_234
2001;243;75 i +;84;50;134;SEC_243
2001;423;50-64;94;103;197;SEC_423
2001;511;65-74;51;40;91;SEC_511
2001;619;03-11;36;45;81;SEC_619
2001;119;00-02;8;12;20;SEC_119
2001;244;12-15;6;7;13;SEC_244
2001;519;25-34;58;60;118;SEC_519
2001;203;50-64;54;63;117;SEC_203
2001;413;16-17;2;3;5;SEC_413
2001;249;00-02;11;4;15;SEC_249
2001;101;16-17;19;18;37;SEC_101
2001;516;18-24;29;26;55;SEC_516
2001;114;35-49;162;158;320;SEC_114
2001;101;12-15;32;22;54;SEC_101
2001;435;00-02;11;12;23;SEC_435
2001;601;03-11;38;44;82;SEC_601
2001;528;25-34;109;114;223;SEC_528
2001;114;00-02;14;13;27;SEC_114
2001;441;00-02;14;17;31;SEC_441
2001;425;35-49;69;82;151;SEC_425
2001;321;12-15;38;54;92;SEC_321
2001;538;65-74;92;94;186;SEC_538
2001;121;35-49;77;104;181;SEC_121
2001;442;65-74;30;23;53;SEC_442
2001;215;16-17;6;5;11;SEC_215
2001;216;25-34;100;100;200;SEC_216
2001;426;12-15;17;17;34;SEC_426
2001;240;18-24;28;34;62;SEC_240
2001;205;25-34;66;72;138;SEC_205
2001;613;12-15;17;18;35;SEC_613
2001;411;00-02;10;8;18;SEC_411
2001;219;00-02;14;11;25;SEC_219
2001;225;12-15;9;6;15;SEC_225
2001;135;03-11;55;40;95;SEC_135
2001;414;03-11;25;34;59;SEC_414
2001;139;18-24;54;49;103;SEC_139
2001;521;16-17;9;10;19;SEC_521
2001;401;75 i +;48;25;73;SEC_401
2001;249;35-49;102;112;214;SEC_249
2001;519;50-64;50;42;92;SEC_519
2001;302;00-02;11;21;32;SEC_302
2001;419;16-17;7;4;11;SEC_419
2001;226;03-11;28;31;59;SEC_226
2001;526;75 i +;34;16;50;SEC_526
2001;623;50-64;213;194;407;SEC_623
2001;311;35-49;124;118;242;SEC_311
2001;439;03-11;31;30;61;SEC_439
2001;436;25-34;88;115;203;SEC_436
2001;437;00-02;15;6;21;SEC_437
2001;235;65-74;109;78;187;SEC_235
2001;425;75 i +;57;30;87;SEC_425
2001;536;65-74;71;64;135;SEC_536
2001;136;35-49;123;110;233;SEC_136
2001;227;35-49;70;60;130;SEC_227
2001;112;65-74;55;46;101;SEC_112
2001;405;25-34;92;81;173;SEC_405
2001;229;12-15;10;8;18;SEC_229
2001;125;03-11;33;42;75;SEC_125
2001;429;16-17;2;5;7;SEC_429
2001;527;03-11;33;28;61;SEC_527
2001;513;18-24;37;26;63;SEC_513
2001;214;75 i +;36;19;55;SEC_214
2001;537;12-15;16;17;33;SEC_537
2001;114;03-11;50;43;93;SEC_114
2001;611;18-24;81;68;149;SEC_611
2001;423;16-17;1;5;6;SEC_423
2001;126;03-11;25;19;44;SEC_126
2001;514;03-11;26;19;45;SEC_514
2001;210;65-74;97;66;163;SEC_210
2001;619;00-02;18;12;30;SEC_619
2001;420;50-64;109;92;201;SEC_420
2001;430;50-64;81;74;155;SEC_430
2001;428;50-64;36;32;68;SEC_428
2001;307;16-17;12;17;29;SEC_307
2001;307;00-02;13;11;24;SEC_307
2001;438;50-64;94;82;176;SEC_438
2001;322;75 i +;49;25;74;SEC_322
2001;623;03-11;47;58;105;SEC_623
2001;423;12-15;11;14;25;SEC_423
2001;217;12-15;9;9;18;SEC_217
2001;623;18-24;98;116;214;SEC_623
2001;204;16-17;3;7;10;SEC_204
2001;609;65-74;42;39;81;SEC_609
2001;431;35-49;122;133;255;SEC_431
2001;308;16-17;17;23;40;SEC_308
2001;104;25-34;80;89;169;SEC_104
2001;528;50-64;124;103;227;SEC_528
2001;108;25-34;99;87;186;SEC_108
2001;420;00-02;7;16;23;SEC_420
2001;433;03-11;39;44;83;SEC_433
2001;218;12-15;6;18;24;SEC_218
2001;308;75 i +;73;44;117;SEC_308
2001;121;75 i +;49;32;81;SEC_121
2001;307;75 i +;61;36;97;SEC_307
2001;415;00-02;3;8;11;SEC_415
2001;108;12-15;23;17;40;SEC_108
2001;517;35-49;121;130;251;SEC_517
2001;614;35-49;82;81;163;SEC_614
2001;227;25-34;63;63;126;SEC_227
2001;118;12-15;42;38;80;SEC_118
2001;610;75 i +;40;27;67;SEC_610
2001;510;35-49;85;103;188;SEC_510
2001;213;18-24;40;52;92;SEC_213
2001;535;35-49;120;114;234;SEC_535
2001;630;75 i +;24;13;37;SEC_630
2001;325;65-74;123;106;229;SEC_325
2001;512;75 i +;57;26;83;SEC_512
2001;208;75 i +;116;73;189;SEC_208
2001;520;12-15;17;17;34;SEC_520
2001;121;03-11;41;40;81;SEC_121
2001;632;25-34;98;117;215;SEC_632
2001;533;12-15;24;15;39;SEC_533
2001;139;25-34;90;90;180;SEC_139
2001;213;00-02;3;12;15;SEC_213
2001;434;18-24;26;27;53;SEC_434
2001;615;35-49;52;53;105;SEC_615
2001;425;00-02;12;5;17;SEC_425
2001;626;03-11;36;29;65;SEC_626
2001;135;16-17;16;19;35;SEC_135
2001;219;16-17;6;11;17;SEC_219
2001;322;35-49;105;105;210;SEC_322
2001;119;03-11;29;41;70;SEC_119
2001;407;03-11;25;28;53;SEC_407
2001;603;65-74;25;21;46;SEC_603
2001;248;65-74;70;61;131;SEC_248
2001;243;12-15;18;20;38;SEC_243
2001;122;50-64;105;88;193;SEC_122
2001;534;35-49;83;87;170;SEC_534
2001;428;18-24;22;20;42;SEC_428
2001;437;03-11;25;32;57;SEC_437
2001;535;16-17;18;14;32;SEC_535
2001;315;65-74;53;43;96;SEC_315
2001;113;18-24;102;90;192;SEC_113
2001;249;65-74;78;62;140;SEC_249
2001;140;35-49;84;87;171;SEC_140
2001;238;75 i +;64;31;95;SEC_238
2001;509;16-17;7;5;12;SEC_509
2001;127;16-17;7;10;17;SEC_127
2001;323;03-11;146;128;274;SEC_323
2001;604;35-49;67;75;142;SEC_604
2001;518;65-74;73;83;156;SEC_518
2001;249;25-34;91;100;191;SEC_249
2001;213;50-64;82;92;174;SEC_213
2001;415;35-49;64;72;136;SEC_415
2001;536;50-64;97;85;182;SEC_536
2001;228;65-74;44;40;84;SEC_228
2001;305;25-34;101;113;214;SEC_305
2001;225;03-11;9;15;24;SEC_225
2001;306;35-49;167;178;345;SEC_306
2001;602;35-49;45;45;90;SEC_602
2001;224;65-74;44;33;77;SEC_224
2001;517;75 i +;48;25;73;SEC_517
2001;511;16-17;4;3;7;SEC_511
2001;512;16-17;7;9;16;SEC_512
2001;302;25-34;138;165;303;SEC_302
2001;435;16-17;8;10;18;SEC_435
2001;524;75 i +;54;31;85;SEC_524
2001;106;50-64;181;214;395;SEC_106
2001;522;65-74;38;44;82;SEC_522
2001;128;65-74;51;53;104;SEC_128
2001;202;75 i +;30;23;53;SEC_202
2001;508;03-11;18;24;42;SEC_508
2001;402;03-11;23;21;44;SEC_402
2001;106;35-49;239;223;462;SEC_106
2001;424;16-17;6;6;12;SEC_424
2001;136;12-15;20;14;34;SEC_136
2001;207;75 i +;70;29;99;SEC_207
2001;603;12-15;7;14;21;SEC_603
2001;427;50-64;64;49;113;SEC_427
2001;604;16-17;9;12;21;SEC_604
2001;508;75 i +;32;23;55;SEC_508
2001;220;03-11;25;19;44;SEC_220
2001;209;18-24;19;29;48;SEC_209
2001;111;12-15;18;16;34;SEC_111
2001;621;18-24;111;131;242;SEC_621
2001;608;16-17;10;11;21;SEC_608
2001;616;50-64;185;205;390;SEC_616
2001;107;50-64;183;181;364;SEC_107
2001;215;35-49;90;84;174;SEC_215
2001;313;00-02;27;24;51;SEC_313
2001;107;75 i +;67;37;104;SEC_107
2001;421;16-17;2;9;11;SEC_421
2001;105;35-49;157;125;282;SEC_105
2001;111;75 i +;39;26;65;SEC_111
2001;516;25-34;72;66;138;SEC_516
2001;631;00-02;10;9;19;SEC_631
2001;248;18-24;42;65;107;SEC_248
2001;105;75 i +;47;22;69;SEC_105
2001;118;03-11;63;64;127;SEC_118
2001;129;16-17;12;11;23;SEC_129
2001;229;16-17;5;4;9;SEC_229
2001;438;75 i +;31;13;44;SEC_438
2001;209;12-15;10;19;29;SEC_209
2001;402;12-15;12;16;28;SEC_402
2001;416;75 i +;33;20;53;SEC_416
2001;432;03-11;27;34;61;SEC_432
2001;612;25-34;110;135;245;SEC_612
2001;438;18-24;34;34;68;SEC_438
2001;503;50-64;84;104;188;SEC_503
2001;308;25-34;158;158;316;SEC_308
2001;223;03-11;44;40;84;SEC_223
2001;241;50-64;51;45;96;SEC_241
2001;605;35-49;52;43;95;SEC_605
2001;514;00-02;9;7;16;SEC_514
2001;135;75 i +;51;22;73;SEC_135
2001;323;16-17;33;40;73;SEC_323
2001;202;65-74;53;40;93;SEC_202
2001;439;65-74;64;59;123;SEC_439
2001;214;16-17;4;3;7;SEC_214
2001;217;75 i +;48;14;62;SEC_217
2001;219;35-49;117;114;231;SEC_219
2001;205;75 i +;38;23;61;SEC_205
2001;322;12-15;22;18;40;SEC_322
2001;132;00-02;23;16;39;SEC_132
2001;506;35-49;212;182;394;SEC_506
2001;130;00-02;14;21;35;SEC_130
2001;506;03-11;66;75;141;SEC_506
2001;321;65-74;78;75;153;SEC_321
2001;410;65-74;129;127;256;SEC_410
2001;407;18-24;44;44;88;SEC_407
2001;248;00-02;16;13;29;SEC_248
2001;318;25-34;56;71;127;SEC_318
2001;324;25-34;83;98;181;SEC_324
2001;533;75 i +;38;22;60;SEC_533
2001;518;12-15;18;14;32;SEC_518
2001;401;65-74;103;78;181;SEC_401
2001;430;75 i +;62;33;95;SEC_430
2001;214;25-34;65;66;131;SEC_214
2001;122;25-34;87;97;184;SEC_122
2001;404;16-17;11;9;20;SEC_404
2001;410;00-02;14;17;31;SEC_410
2001;525;18-24;52;53;105;SEC_525
2001;128;00-02;13;13;26;SEC_128
2001;218;00-02;2;10;12;SEC_218
2001;238;12-15;10;9;19;SEC_238
2001;302;50-64;170;193;363;SEC_302
2001;239;75 i +;73;59;132;SEC_239
2001;407;25-34;68;92;160;SEC_407
2001;304;03-11;33;44;77;SEC_304
2001;516;75 i +;22;11;33;SEC_516
2001;231;03-11;36;22;58;SEC_231
2001;525;75 i +;40;31;71;SEC_525
2001;606;18-24;48;50;98;SEC_606
2001;601;65-74;60;66;126;SEC_601
2001;131;75 i +;44;30;74;SEC_131
2001;528;65-74;62;62;124;SEC_528
2001;229;18-24;27;26;53;SEC_229
2001;211;18-24;52;51;103;SEC_211
2001;138;03-11;24;34;58;SEC_138
2001;301;65-74;122;113;235;SEC_301
2001;245;65-74;68;57;125;SEC_245
2001;323;75 i +;46;16;62;SEC_323
2001;219;03-11;42;36;78;SEC_219
2001;244;65-74;47;26;73;SEC_244
2001;317;03-11;32;39;71;SEC_317
2001;625;50-64;142;149;291;SEC_625
2001;247;03-11;28;36;64;SEC_247
2001;312;65-74;62;59;121;SEC_312
2001;211;65-74;91;62;153;SEC_211
2001;223;25-34;89;97;186;SEC_223
2001;418;25-34;102;123;225;SEC_418
2001;118;65-74;47;38;85;SEC_118
2001;615;16-17;6;2;8;SEC_615
2001;306;16-17;16;16;32;SEC_306
2001;241;16-17;7;5;12;SEC_241
2001;237;35-49;118;137;255;SEC_237
2001;314;12-15;52;59;111;SEC_314
2001;613;75 i +;43;22;65;SEC_613
2001;427;00-02;14;11;25;SEC_427
2001;605;75 i +;24;18;42;SEC_605
2001;601;18-24;85;98;183;SEC_601
2001;408;12-15;19;10;29;SEC_408
2001;123;18-24;65;61;126;SEC_123
2001;232;65-74;73;51;124;SEC_232
2001;632;35-49;93;89;182;SEC_632
2001;111;03-11;27;26;53;SEC_111
2001;102;03-11;50;64;114;SEC_102
2001;302;03-11;37;46;83;SEC_302
2001;529;00-02;15;14;29;SEC_529
2001;242;12-15;13;24;37;SEC_242
2001;627;35-49;136;112;248;SEC_627
2001;115;16-17;12;14;26;SEC_115
2001;618;35-49;57;51;108;SEC_618
2001;524;65-74;82;55;137;SEC_524
2001;531;35-49;80;83;163;SEC_531
2001;631;50-64;177;163;340;SEC_631
2001;413;25-34;45;54;99;SEC_413
2001;201;65-74;48;52;100;SEC_201
2001;505;75 i +;41;35;76;SEC_505
2001;503;25-34;69;69;138;SEC_503
2001;601;12-15;12;23;35;SEC_601
2001;202;12-15;7;13;20;SEC_202
2001;629;18-24;30;31;61;SEC_629
2001;247;00-02;14;11;25;SEC_247
2001;409;65-74;40;41;81;SEC_409
2001;519;03-11;14;34;48;SEC_519
2001;514;16-17;6;5;11;SEC_514
2001;230;00-02;11;13;24;SEC_230
2001;513;75 i +;44;17;61;SEC_513
2001;115;00-02;18;14;32;SEC_115
2001;210;00-02;4;7;11;SEC_210
2001;129;25-34;102;123;225;SEC_129
2001;113;65-74;57;31;88;SEC_113
2001;137;50-64;134;141;275;SEC_137
2001;106;12-15;47;32;79;SEC_106
2001;240;35-49;64;60;124;SEC_240
2001;127;03-11;28;30;58;SEC_127
2001;522;03-11;23;14;37;SEC_522
2001;632;16-17;6;16;22;SEC_632
2001;121;50-64;48;34;82;SEC_121
2001;308;35-49;154;174;328;SEC_308
2001;140;25-34;80;91;171;SEC_140
2001;619;50-64;160;139;299;SEC_619
2001;614;50-64;140;119;259;SEC_614
2001;520;18-24;37;48;85;SEC_520
2001;607;16-17;8;10;18;SEC_607
2001;529;50-64;104;92;196;SEC_529
2001;119;25-34;111;127;238;SEC_119
2001;514;75 i +;35;17;52;SEC_514
2001;423;03-11;30;31;61;SEC_423
2001;632;50-64;94;83;177;SEC_632
2001;502;65-74;74;61;135;SEC_502
2001;408;03-11;18;29;47;SEC_408
2001;435;65-74;98;52;150;SEC_435
2001;511;00-02;11;8;19;SEC_511
2001;235;35-49;107;114;221;SEC_235
2001;537;18-24;71;63;134;SEC_537
2001;521;03-11;21;31;52;SEC_521
2001;621;50-64;200;226;426;SEC_621
2001;136;16-17;11;9;20;SEC_136
2001;235;00-02;19;14;33;SEC_235
2001;501;25-34;93;128;221;SEC_501
2001;507;50-64;90;93;183;SEC_507
2001;530;50-64;112;88;200;SEC_530
2001;625;35-49;181;166;347;SEC_625
2001;420;12-15;14;23;37;SEC_420
2001;428;00-02;3;5;8;SEC_428
2001;324;65-74;51;35;86;SEC_324
2001;624;03-11;34;32;66;SEC_624
2001;509;25-34;56;88;144;SEC_509
2001;632;75 i +;27;12;39;SEC_632
2001;533;18-24;33;44;77;SEC_533
2001;629;75 i +;26;8;34;SEC_629
2001;305;35-49;215;199;414;SEC_305
2001;122;12-15;9;8;17;SEC_122
2001;429;03-11;11;27;38;SEC_429
2001;305;03-11;56;41;97;SEC_305
2001;532;00-02;14;12;26;SEC_532
2001;105;03-11;35;61;96;SEC_105
2001;121;00-02;11;18;29;SEC_121
2001;136;03-11;37;48;85;SEC_136
2001;409;75 i +;25;14;39;SEC_409
2001;510;50-64;110;95;205;SEC_510
2001;620;25-34;64;59;123;SEC_620
2001;210;03-11;25;17;42;SEC_210
2001;117;50-64;174;182;356;SEC_117
2001;116;35-49;160;145;305;SEC_116
2001;112;35-49;188;166;354;SEC_112
2001;613;16-17;6;8;14;SEC_613
2001;612;00-02;10;9;19;SEC_612
2001;313;65-74;80;77;157;SEC_313
2001;118;75 i +;42;22;64;SEC_118
2001;519;18-24;20;26;46;SEC_519
2001;229;03-11;26;28;54;SEC_229
2001;248;12-15;20;20;40;SEC_248
2001;248;35-49;115;130;245;SEC_248
2001;438;65-74;45;46;91;SEC_438
2001;133;50-64;86;78;164;SEC_133
2001;603;35-49;52;50;102;SEC_603
2001;311;50-64;130;107;237;SEC_311
2001;618;50-64;72;69;141;SEC_618
2001;242;18-24;36;45;81;SEC_242
2001;203;35-49;73;88;161;SEC_203
2001;618;75 i +;21;15;36;SEC_618
2001;410;25-34;120;135;255;SEC_410
2001;203;75 i +;53;28;81;SEC_203
2001;440;65-74;55;54;109;SEC_440
2001;217;50-64;36;39;75;SEC_217
2001;202;03-11;14;27;41;SEC_202
2001;421;65-74;95;80;175;SEC_421
2001;110;12-15;23;19;42;SEC_110
2001;134;35-49;144;120;264;SEC_134
2001;401;18-24;57;57;114;SEC_401
2001;320;75 i +;27;11;38;SEC_320
2001;120;00-02;21;25;46;SEC_120
2001;128;18-24;55;52;107;SEC_128
2001;505;25-34;135;164;299;SEC_505
2001;133;35-49;85;91;176;SEC_133
2001;625;65-74;41;40;81;SEC_625
2001;617;35-49;99;99;198;SEC_617
2001;622;18-24;60;54;114;SEC_622
2001;607;25-34;93;98;191;SEC_607
2001;510;25-34;99;99;198;SEC_510
2001;217;03-11;15;19;34;SEC_217
2001;405;35-49;66;72;138;SEC_405
2001;130;12-15;13;11;24;SEC_130
2001;618;25-34;55;79;134;SEC_618
2001;433;18-24;54;52;106;SEC_433
2001;230;35-49;66;78;144;SEC_230
2001;422;12-15;12;20;32;SEC_422
2001;520;35-49;83;67;150;SEC_520
2001;420;16-17;13;13;26;SEC_420
2001;233;65-74;52;48;100;SEC_233
2001;612;16-17;8;12;20;SEC_612
2001;115;75 i +;51;33;84;SEC_115
2001;203;18-24;26;33;59;SEC_203
2001;622;12-15;18;16;34;SEC_622
2001;503;35-49;138;97;235;SEC_503
2001;218;65-74;40;28;68;SEC_218
2001;315;00-02;14;23;37;SEC_315
2001;315;35-49;172;168;340;SEC_315
2001;434;65-74;60;36;96;SEC_434
2001;121;16-17;6;4;10;SEC_121
2001;412;00-02;11;11;22;SEC_412
2001;624;12-15;15;17;32;SEC_624
2001;111;00-02;5;15;20;SEC_111
2001;433;16-17;10;6;16;SEC_433
2001;422;35-49;83;98;181;SEC_422
2001;304;12-15;18;20;38;SEC_304
2001;409;25-34;59;69;128;SEC_409
2001;538;50-64;110;87;197;SEC_538
2001;616;03-11;138;154;292;SEC_616
2001;607;18-24;38;48;86;SEC_607
2001;129;35-49;100;108;208;SEC_129
2001;622;75 i +;40;11;51;SEC_622
2001;407;16-17;4;5;9;SEC_407
2001;120;25-34;143;123;266;SEC_120
2001;219;65-74;80;57;137;SEC_219
2001;621;03-11;63;61;124;SEC_621
2001;129;12-15;24;18;42;SEC_129
2001;609;00-02;8;10;18;SEC_609
2001;325;25-34;153;173;326;SEC_325
2001;415;18-24;33;37;70;SEC_415
2001;117;16-17;39;30;69;SEC_117
2001;304;25-34;105;118;223;SEC_304
2001;424;75 i +;19;8;27;SEC_424
2001;413;12-15;9;10;19;SEC_413
2001;312;18-24;60;73;133;SEC_312
2001;508;35-49;55;71;126;SEC_508
2001;204;25-34;45;49;94;SEC_204
2001;115;03-11;45;58;103;SEC_115
2001;122;00-02;10;15;25;SEC_122
2001;436;00-02;14;14;28;SEC_436
2001;426;35-49;90;91;181;SEC_426
2001;518;16-17;4;9;13;SEC_518
2001;237;65-74;87;64;151;SEC_237
2001;515;50-64;50;46;96;SEC_515
2001;318;12-15;27;28;55;SEC_318
2001;222;03-11;37;24;61;SEC_222
2001;442;35-49;58;58;116;SEC_442
2001;538;12-15;15;17;32;SEC_538
2001;417;25-34;53;51;104;SEC_417
2001;442;50-64;62;56;118;SEC_442
2001;140;00-02;15;6;21;SEC_140
2001;413;75 i +;34;19;53;SEC_413
2001;317;35-49;86;108;194;SEC_317
2001;209;65-74;66;54;120;SEC_209
2001;317;18-24;44;54;98;SEC_317
2001;212;25-34;121;128;249;SEC_212
2001;125;65-74;49;50;99;SEC_125
2001;129;18-24;62;52;114;SEC_129
2001;504;65-74;85;76;161;SEC_504
2001;215;00-02;4;8;12;SEC_215
2001;206;75 i +;66;31;97;SEC_206
2001;436;16-17;7;12;19;SEC_436
2001;441;03-11;62;63;125;SEC_441
2001;403;25-34;78;101;179;SEC_403
2001;613;35-49;76;76;152;SEC_613
2001;204;50-64;43;37;80;SEC_204
2001;602;00-02;5;6;11;SEC_602
2001;206;16-17;6;8;14;SEC_206
2001;314;18-24;126;144;270;SEC_314
2001;619;25-34;100;118;218;SEC_619
2001;314;75 i +;75;37;112;SEC_314
2001;138;00-02;7;6;13;SEC_138
2001;609;75 i +;27;13;40;SEC_609
2001;212;16-17;10;10;20;SEC_212
2001;412;75 i +;63;40;103;SEC_412
2001;430;35-49;81;89;170;SEC_430
2001;113;50-64;117;135;252;SEC_113
2001;625;25-34;100;110;210;SEC_625
2001;510;03-11;27;38;65;SEC_510
2001;222;65-74;48;38;86;SEC_222
2001;414;75 i +;46;32;78;SEC_414
2001;508;12-15;10;10;20;SEC_508
2001;309;50-64;63;68;131;SEC_309
2001;509;00-02;4;15;19;SEC_509
2001;318;16-17;7;8;15;SEC_318
2001;533;65-74;66;62;128;SEC_533
2001;423;25-34;86;92;178;SEC_423
2001;524;16-17;11;14;25;SEC_524
2001;526;16-17;5;7;12;SEC_526
2001;630;50-64;109;120;229;SEC_630
2001;126;50-64;152;150;302;SEC_126
2001;244;18-24;21;15;36;SEC_244
2001;209;50-64;89;72;161;SEC_209
2001;321;75 i +;88;49;137;SEC_321
2001;117;18-24;113;136;249;SEC_117
2001;213;35-49;97;89;186;SEC_213
2001;102;12-15;33;30;63;SEC_102
2001;119;35-49;148;118;266;SEC_119
2001;527;16-17;11;13;24;SEC_527
2001;621;12-15;22;26;48;SEC_621
2001;232;50-64;89;83;172;SEC_232
2001;110;65-74;62;47;109;SEC_110
2001;503;12-15;32;23;55;SEC_503
2001;324;50-64;68;67;135;SEC_324
2001;534;25-34;94;101;195;SEC_534
2001;402;65-74;55;63;118;SEC_402
2001;414;12-15;10;17;27;SEC_414
2001;114;65-74;69;71;140;SEC_114
2001;418;50-64;123;97;220;SEC_418
2001;309;00-02;6;8;14;SEC_309
2001;321;18-24;147;136;283;SEC_321
2001;221;12-15;19;20;39;SEC_221
2001;625;00-02;12;15;27;SEC_625
2001;137;18-24;82;73;155;SEC_137
2001;508;65-74;39;34;73;SEC_508
2001;618;16-17;3;7;10;SEC_618
2001;430;12-15;14;13;27;SEC_430
2001;512;65-74;40;46;86;SEC_512
2001;510;18-24;44;51;95;SEC_510
2001;534;50-64;106;89;195;SEC_534
2001;502;50-64;151;152;303;SEC_502
2001;305;18-24;80;78;158;SEC_305
2001;216;12-15;13;14;27;SEC_216
2001;237;12-15;14;13;27;SEC_237
2001;509;12-15;12;16;28;SEC_509
2001;307;03-11;46;50;96;SEC_307
2001;410;03-11;42;53;95;SEC_410
2001;533;16-17;9;10;19;SEC_533
2001;301;25-34;233;257;490;SEC_301
2001;137;03-11;54;56;110;SEC_137
2001;627;65-74;29;29;58;SEC_627
2001;515;00-02;4;5;9;SEC_515
2001;423;00-02;10;9;19;SEC_423
2001;617;03-11;42;47;89;SEC_617
2001;436;12-15;16;17;33;SEC_436
2001;247;16-17;6;11;17;SEC_247
2001;512;50-64;99;93;192;SEC_512
2001;218;18-24;24;41;65;SEC_218
2001;312;35-49;156;177;333;SEC_312
2001;506;18-24;137;118;255;SEC_506
2001;226;75 i +;77;40;117;SEC_226
2001;241;03-11;40;23;63;SEC_241
2001;246;75 i +;75;33;108;SEC_246
2001;521;50-64;163;182;345;SEC_521
2001;234;65-74;87;50;137;SEC_234
2001;528;12-15;23;14;37;SEC_528
2001;508;00-02;6;5;11;SEC_508
2001;236;65-74;91;71;162;SEC_236
2001;201;18-24;23;27;50;SEC_201
2001;209;75 i +;88;47;135;SEC_209
2001;312;75 i +;53;31;84;SEC_312
2001;214;50-64;59;51;110;SEC_214
2001;229;50-64;61;55;116;SEC_229
2001;510;75 i +;51;29;80;SEC_510
2001;119;16-17;19;17;36;SEC_119
2001;422;03-11;30;38;68;SEC_422
2001;428;03-11;17;19;36;SEC_428
2001;207;00-02;5;9;14;SEC_207
2001;233;16-17;3;6;9;SEC_233
2001;430;00-02;9;10;19;SEC_430
2001;537;25-34;116;105;221;SEC_537
2001;222;12-15;12;15;27;SEC_222
2001;612;75 i +;49;21;70;SEC_612
2001;323;00-02;43;41;84;SEC_323
2001;410;12-15;15;19;34;SEC_410
2001;408;65-74;60;55;115;SEC_408
2001;102;35-49;159;145;304;SEC_102
2001;220;65-74;66;57;123;SEC_220
2001;136;75 i +;59;31;90;SEC_136
2001;119;75 i +;53;43;96;SEC_119
2001;412;18-24;89;110;199;SEC_412
2001;222;75 i +;37;21;58;SEC_222
2001;521;65-74;48;47;95;SEC_521
2001;525;00-02;12;13;25;SEC_525
2001;319;50-64;80;85;165;SEC_319
2001;507;35-49;79;83;162;SEC_507
2001;416;65-74;58;63;121;SEC_416
2001;137;25-34;138;124;262;SEC_137
2001;101;50-64;98;99;197;SEC_101
2001;438;35-49;70;74;144;SEC_438
2001;310;03-11;25;33;58;SEC_310
2001;301;12-15;34;41;75;SEC_301
2001;440;12-15;6;13;19;SEC_440
2001;206;00-02;3;4;7;SEC_206
2001;430;03-11;27;43;70;SEC_430
2001;626;75 i +;23;27;50;SEC_626
2001;406;35-49;142;135;277;SEC_406
2001;620;18-24;48;34;82;SEC_620
2001;418;18-24;48;51;99;SEC_418
2001;219;12-15;19;21;40;SEC_219
2001;528;75 i +;47;30;77;SEC_528
2001;301;00-02;29;26;55;SEC_301
2001;105;50-64;91;108;199;SEC_105
2001;239;18-24;50;39;89;SEC_239
2001;405;18-24;33;34;67;SEC_405
2001;612;50-64;159;139;298;SEC_612
2001;239;65-74;96;74;170;SEC_239
2001;101;00-02;22;12;34;SEC_101
2001;602;16-17;2;5;7;SEC_602
2001;237;50-64;125;114;239;SEC_237
2001;129;50-64;122;114;236;SEC_129
2001;611;03-11;68;57;125;SEC_611
2001;129;03-11;38;26;64;SEC_129
2001;128;25-34;123;112;235;SEC_128
2001;534;00-02;9;8;17;SEC_534
2001;213;65-74;57;42;99;SEC_213
2001;237;16-17;11;6;17;SEC_237
2001;505;03-11;29;24;53;SEC_505
2001;140;75 i +;50;27;77;SEC_140
2001;104;00-02;12;8;20;SEC_104
2001;238;35-49;72;76;148;SEC_238
2001;132;16-17;23;31;54;SEC_132
2001;607;12-15;14;21;35;SEC_607
2001;308;12-15;22;23;45;SEC_308
2001;121;65-74;92;73;165;SEC_121
2001;409;18-24;36;40;76;SEC_409
2001;602;18-24;30;21;51;SEC_602
2001;131;16-17;9;12;21;SEC_131
2001;538;18-24;50;48;98;SEC_538
2001;631;75 i +;30;16;46;SEC_631
2001;105;65-74;44;38;82;SEC_105
2001;229;25-34;44;71;115;SEC_229
2001;242;35-49;101;98;199;SEC_242
2001;233;75 i +;70;23;93;SEC_233
2001;535;00-02;4;9;13;SEC_535
2001;110;35-49;136;116;252;SEC_110
2001;246;18-24;41;34;75;SEC_246
2001;418;12-15;14;21;35;SEC_418
2001;432;35-49;122;112;234;SEC_432
2001;436;50-64;62;54;116;SEC_436
2001;419;03-11;32;36;68;SEC_419
2001;203;25-34;61;60;121;SEC_203
2001;426;03-11;26;28;54;SEC_426
2001;133;12-15;16;16;32;SEC_133
2001;201;25-34;62;54;116;SEC_201
2001;317;16-17;7;8;15;SEC_317
2001;606;25-34;115;97;212;SEC_606
2001;107;18-24;101;123;224;SEC_107
2001;402;75 i +;41;32;73;SEC_402
2001;422;65-74;78;65;143;SEC_422
2001;215;50-64;75;54;129;SEC_215
2001;405;75 i +;38;22;60;SEC_405
2001;247;12-15;21;22;43;SEC_247
2001;414;25-34;63;69;132;SEC_414
2001;410;16-17;14;18;32;SEC_410
2001;304;50-64;110;106;216;SEC_304
2001;530;12-15;14;22;36;SEC_530
2001;422;00-02;10;6;16;SEC_422
2001;604;25-34;63;90;153;SEC_604
2001;313;16-17;21;23;44;SEC_313
2001;248;03-11;34;44;78;SEC_248
2001;405;03-11;24;25;49;SEC_405
2001;530;03-11;44;41;85;SEC_530
2001;516;16-17;6;3;9;SEC_516
2001;116;18-24;88;92;180;SEC_116
2001;423;35-49;81;92;173;SEC_423
2001;518;35-49;83;100;183;SEC_518
2001;406;65-74;80;86;166;SEC_406
2001;537;50-64;144;123;267;SEC_537
2001;508;50-64;56;44;100;SEC_508
2001;125;75 i +;37;26;63;SEC_125
2001;138;35-49;97;92;189;SEC_138
2001;313;25-34;161;163;324;SEC_313
2001;242;25-34;71;84;155;SEC_242
2001;239;12-15;7;20;27;SEC_239
2001;602;25-34;51;66;117;SEC_602
2001;137;65-74;44;37;81;SEC_137
2001;318;03-11;32;38;70;SEC_318
2001;208;12-15;24;24;48;SEC_208
2001;605;16-17;3;3;6;SEC_605
2001;506;12-15;34;39;73;SEC_506
2001;507;65-74;36;37;73;SEC_507
2001;244;35-49;74;75;149;SEC_244
2001;240;65-74;65;43;108;SEC_240
2001;533;50-64;81;69;150;SEC_533
2001;235;75 i +;72;47;119;SEC_235
2001;121;25-34;82;83;165;SEC_121
2001;434;03-11;21;16;37;SEC_434
2001;303;50-64;206;159;365;SEC_303
2001;515;75 i +;23;13;36;SEC_515
2001;224;12-15;7;7;14;SEC_224
2001;403;35-49;100;99;199;SEC_403
2001;521;25-34;108;111;219;SEC_521
2001;413;35-49;48;63;111;SEC_413
2001;140;12-15;6;14;20;SEC_140
2001;203;03-11;20;18;38;SEC_203
2001;522;16-17;15;8;23;SEC_522
2001;511;12-15;6;9;15;SEC_511
2001;232;75 i +;70;38;108;SEC_232
2001;135;12-15;29;26;55;SEC_135
2001;512;12-15;14;17;31;SEC_512
2001;538;75 i +;63;34;97;SEC_538
2001;413;00-02;2;4;6;SEC_413
2001;621;75 i +;31;19;50;SEC_621
2001;302;16-17;13;9;22;SEC_302
2001;628;12-15;16;19;35;SEC_628
2001;107;35-49;176;154;330;SEC_107
2001;130;75 i +;62;38;100;SEC_130
2001;425;25-34;92;80;172;SEC_425
2001;127;00-02;16;8;24;SEC_127
2001;524;50-64;101;89;190;SEC_524
2001;424;03-11;14;11;25;SEC_424
2001;632;65-74;51;46;97;SEC_632
2001;322;00-02;10;14;24;SEC_322
2001;408;00-02;11;12;23;SEC_408
2001;225;65-74;44;31;75;SEC_225
2001;321;50-64;236;256;492;SEC_321
2001;528;35-49;100;101;201;SEC_528
2001;435;18-24;40;49;89;SEC_435
2001;529;75 i +;74;38;112;SEC_529
2001;607;75 i +;34;18;52;SEC_607
2001;632;18-24;56;64;120;SEC_632
2001;630;16-17;8;10;18;SEC_630
2001;402;16-17;8;7;15;SEC_402
2001;504;18-24;41;58;99;SEC_504
2001;138;65-74;35;35;70;SEC_138
2001;245;03-11;34;36;70;SEC_245
2001;627;50-64;116;132;248;SEC_627
2001;211;25-34;110;148;258;SEC_211
2001;614;25-34;93;104;197;SEC_614
2001;303;12-15;17;19;36;SEC_303
2001;525;50-64;88;84;172;SEC_525
2001;535;25-34;75;91;166;SEC_535
2001;125;16-17;16;12;28;SEC_125
2001;221;00-02;13;10;23;SEC_221
2001;228;75 i +;40;19;59;SEC_228
2001;216;16-17;15;12;27;SEC_216
2001;613;18-24;52;45;97;SEC_613
2001;223;00-02;8;6;14;SEC_223
2001;535;18-24;64;80;144;SEC_535
2001;117;25-34;181;172;353;SEC_117
2001;621;25-34;153;166;319;SEC_621
2001;310;50-64;71;85;156;SEC_310
2001;316;35-49;380;309;689;SEC_316
2001;504;16-17;10;12;22;SEC_504
2001;113;75 i +;43;26;69;SEC_113
2001;119;12-15;24;20;44;SEC_119
2001;604;12-15;12;17;29;SEC_604
2001;242;50-64;102;93;195;SEC_242
2001;109;75 i +;48;29;77;SEC_109
2001;516;12-15;9;13;22;SEC_516
2001;520;16-17;10;9;19;SEC_520
2001;630;12-15;18;12;30;SEC_630
2001;616;25-34;237;275;512;SEC_616
2001;421;25-34;121;119;240;SEC_421
2001;503;16-17;10;8;18;SEC_503
2001;108;65-74;86;70;156;SEC_108
2001;246;00-02;7;18;25;SEC_246
2001;325;35-49;202;186;388;SEC_325
2001;625;75 i +;15;9;24;SEC_625
2001;223;16-17;5;11;16;SEC_223
2001;629;25-34;40;57;97;SEC_629
2001;523;12-15;10;21;31;SEC_523
2001;417;50-64;60;49;109;SEC_417
2001;249;12-15;15;17;32;SEC_249
2001;433;35-49;105;96;201;SEC_433
2001;313;50-64;161;165;326;SEC_313
2001;612;03-11;33;33;66;SEC_612
2001;316;16-17;54;57;111;SEC_316
2001;423;75 i +;49;26;75;SEC_423
2001;527;50-64;74;72;146;SEC_527
2001;628;18-24;62;72;134;SEC_628
2001;120;50-64;129;148;277;SEC_120
2001;134;50-64;117;107;224;SEC_134
2001;406;75 i +;51;32;83;SEC_406
2001;136;50-64;101;106;207;SEC_136
2001;415;12-15;7;11;18;SEC_415
2001;108;03-11;37;46;83;SEC_108
2001;315;75 i +;55;28;83;SEC_315
2001;420;75 i +;78;37;115;SEC_420
2001;421;18-24;55;52;107;SEC_421
2001;132;18-24;113;137;250;SEC_132
2001;519;75 i +;18;21;39;SEC_519
2001;245;16-17;3;6;9;SEC_245
2001;530;00-02;15;23;38;SEC_530
2001;308;65-74;71;71;142;SEC_308
2001;120;12-15;43;41;84;SEC_120
2001;231;16-17;8;4;12;SEC_231
2001;121;18-24;19;21;40;SEC_121
2001;214;65-74;39;36;75;SEC_214
2001;121;12-15;6;8;14;SEC_121
2001;303;16-17;8;10;18;SEC_303
2001;224;50-64;33;36;69;SEC_224
2001;538;35-49;116;101;217;SEC_538
2001;619;65-74;78;77;155;SEC_619
2001;247;50-64;99;96;195;SEC_247
2001;230;12-15;7;16;23;SEC_230
2001;129;65-74;46;46;92;SEC_129
2001;507;18-24;45;51;96;SEC_507
2001;132;35-49;239;236;475;SEC_132
2001;440;35-49;67;87;154;SEC_440
2001;207;35-49;76;59;135;SEC_207
2001;632;03-11;43;43;86;SEC_632
2001;240;12-15;8;11;19;SEC_240
2001;410;35-49;144;143;287;SEC_410
2001;411;50-64;112;102;214;SEC_411
2001;403;18-24;62;64;126;SEC_403
2001;522;75 i +;33;21;54;SEC_522
2001;615;25-34;90;114;204;SEC_615
2001;515;65-74;33;29;62;SEC_515
2001;426;75 i +;53;34;87;SEC_426
2001;207;12-15;13;10;23;SEC_207
2001;504;03-11;20;24;44;SEC_504
2001;426;18-24;51;61;112;SEC_426
2001;102;75 i +;69;36;105;SEC_102
2001;107;12-15;29;24;53;SEC_107
2001;441;18-24;116;110;226;SEC_441
2001;122;03-11;43;22;65;SEC_122
2001;403;12-15;24;15;39;SEC_403
2001;628;25-34;96;104;200;SEC_628
2001;219;25-34;100;93;193;SEC_219
2001;241;25-34;63;63;126;SEC_241
2001;320;00-02;12;14;26;SEC_320
2001;616;12-15;75;75;150;SEC_616
2001;238;25-34;70;84;154;SEC_238
2001;614;65-74;55;44;99;SEC_614
2001;421;75 i +;58;36;94;SEC_421
2001;417;65-74;40;39;79;SEC_417
2001;528;16-17;8;3;11;SEC_528
2001;243;35-49;153;155;308;SEC_243
2001;245;35-49;99;103;202;SEC_245
2001;436;03-11;27;32;59;SEC_436
2001;401;03-11;42;42;84;SEC_401
2001;621;00-02;13;18;31;SEC_621
2001;125;35-49;131;113;244;SEC_125
2001;105;25-34;78;80;158;SEC_105
2001;413;18-24;23;22;45;SEC_413
2001;217;18-24;26;21;47;SEC_217
2001;605;00-02;5;7;12;SEC_605
2001;409;00-02;12;3;15;SEC_409
2001;440;18-24;61;53;114;SEC_440
2001;137;16-17;15;13;28;SEC_137
2001;620;50-64;85;87;172;SEC_620
2001;511;25-34;58;65;123;SEC_511
2001;222;16-17;9;5;14;SEC_222
2001;407;35-49;95;91;186;SEC_407
2001;138;50-64;91;79;170;SEC_138
2001;227;65-74;51;41;92;SEC_227
2001;536;75 i +;42;34;76;SEC_536
2001;608;03-11;26;38;64;SEC_608
2001;525;25-34;76;94;170;SEC_525
2001;139;65-74;32;25;57;SEC_139
2001;306;00-02;25;18;43;SEC_306
2001;419;12-15;15;8;23;SEC_419
2001;310;16-17;18;11;29;SEC_310
2001;222;50-64;78;75;153;SEC_222
2001;320;18-24;25;34;59;SEC_320
2001;216;50-64;147;120;267;SEC_216
2001;111;25-34;66;101;167;SEC_111
2001;311;75 i +;89;41;130;SEC_311
2001;629;50-64;58;50;108;SEC_629
2001;312;00-02;8;27;35;SEC_312
2001;239;35-49;98;101;199;SEC_239
2001;523;65-74;95;87;182;SEC_523
2001;403;65-74;78;67;145;SEC_403
2001;139;16-17;5;11;16;SEC_139
2001;322;16-17;15;9;24;SEC_322
2001;511;75 i +;45;23;68;SEC_511
2001;430;65-74;50;51;101;SEC_430
2001;623;16-17;14;14;28;SEC_623
2001;416;00-02;6;9;15;SEC_416
2001;319;35-49;94;83;177;SEC_319
2001;233;50-64;67;63;130;SEC_233
2001;427;12-15;6;7;13;SEC_427
2001;123;75 i +;67;45;112;SEC_123
2001;229;00-02;4;8;12;SEC_229
2001;428;35-49;49;55;104;SEC_428
2001;123;35-49;125;127;252;SEC_123
2001;249;03-11;29;29;58;SEC_249
2001;219;50-64;99;82;181;SEC_219
2001;410;75 i +;74;53;127;SEC_410
2001;536;00-02;5;13;18;SEC_536
2001;126;00-02;11;13;24;SEC_126
2001;316;65-74;47;36;83;SEC_316
2001;302;75 i +;49;24;73;SEC_302
2001;105;12-15;24;23;47;SEC_105
2001;322;18-24;73;59;132;SEC_322
2001;246;50-64;73;67;140;SEC_246
2001;501;16-17;8;10;18;SEC_501
2001;530;75 i +;72;30;102;SEC_530
2001;233;35-49;80;86;166;SEC_233
2001;626;16-17;13;9;22;SEC_626
2001;241;18-24;36;29;65;SEC_241
2001;230;18-24;22;29;51;SEC_230
2001;427;75 i +;43;39;82;SEC_427
2001;226;35-49;103;99;202;SEC_226
2001;102;18-24;71;77;148;SEC_102
2001;318;18-24;57;40;97;SEC_318
2001;131;03-11;40;41;81;SEC_131
2001;315;18-24;80;93;173;SEC_315
2001;530;65-74;112;88;200;SEC_530
2001;502;75 i +;70;43;113;SEC_502
2001;516;00-02;11;13;24;SEC_516
2001;116;65-74;65;59;124;SEC_116
2001;426;00-02;7;9;16;SEC_426
2001;323;25-34;257;275;532;SEC_323
2001;214;03-11;18;15;33;SEC_214
2001;402;25-34;61;77;138;SEC_402
2001;626;65-74;63;56;119;SEC_626
2001;213;03-11;21;39;60;SEC_213
2001;524;18-24;65;62;127;SEC_524
2001;509;35-49;87;74;161;SEC_509
2001;629;65-74;43;44;87;SEC_629
2001;503;75 i +;27;11;38;SEC_503
2001;516;03-11;20;20;40;SEC_516
2001;134;03-11;36;44;80;SEC_134
2001;304;16-17;4;8;12;SEC_304
2001;128;03-11;22;39;61;SEC_128
2001;513;16-17;4;5;9;SEC_513
2001;624;16-17;12;10;22;SEC_624
2001;611;50-64;218;174;392;SEC_611
2001;310;18-24;57;55;112;SEC_310
2001;306;12-15;22;36;58;SEC_306
2001;434;75 i +;58;29;87;SEC_434
2001;517;00-02;7;27;34;SEC_517
2001;243;18-24;50;48;98;SEC_243
2001;517;25-34;101;116;217;SEC_517
2001;212;00-02;14;17;31;SEC_212
2001;124;75 i +;37;23;60;SEC_124
2001;619;18-24;86;85;171;SEC_619
2001;512;00-02;4;13;17;SEC_512
2001;125;25-34;115;131;246;SEC_125
2001;630;00-02;7;7;14;SEC_630
2001;532;75 i +;71;44;115;SEC_532
2001;118;00-02;21;22;43;SEC_118
2001;604;75 i +;26;13;39;SEC_604
2001;632;12-15;19;20;39;SEC_632
2001;526;03-11;18;23;41;SEC_526
2001;315;25-34;152;141;293;SEC_315
2001;429;00-02;9;3;12;SEC_429
2001;519;16-17;6;4;10;SEC_519
2001;529;12-15;15;11;26;SEC_529
2001;432;65-74;76;66;142;SEC_432
2001;324;35-49;76;84;160;SEC_324
2001;605;18-24;27;33;60;SEC_605
2001;440;75 i +;53;35;88;SEC_440
2001;436;65-74;34;28;62;SEC_436
2001;113;16-17;23;16;39;SEC_113
2001;614;18-24;48;52;100;SEC_614
2001;311;16-17;8;8;16;SEC_311
2001;509;50-64;69;79;148;SEC_509
2001;118;16-17;26;35;61;SEC_118
2001;422;50-64;81;78;159;SEC_422
2001;302;12-15;27;10;37;SEC_302
2001;407;65-74;84;69;153;SEC_407
2001;525;35-49;73;81;154;SEC_525
2001;427;03-11;20;36;56;SEC_427
2001;620;12-15;14;14;28;SEC_620
2001;227;50-64;73;58;131;SEC_227
2001;110;75 i +;53;26;79;SEC_110
2001;220;25-34;79;77;156;SEC_220
2001;613;65-74;68;58;126;SEC_613
2001;513;25-34;73;64;137;SEC_513
2001;509;03-11;24;27;51;SEC_509
2001;216;18-24;55;59;114;SEC_216
2001;205;12-15;12;12;24;SEC_205
2001;110;25-34;105;109;214;SEC_110
2001;512;03-11;25;20;45;SEC_512
2001;612;35-49;71;73;144;SEC_612
2001;603;16-17;3;8;11;SEC_603
2001;126;16-17;6;6;12;SEC_126
2001;249;18-24;40;49;89;SEC_249
2001;205;16-17;8;10;18;SEC_205
2001;135;35-49;181;163;344;SEC_135
2001;614;75 i +;35;20;55;SEC_614
2001;412;35-49;178;156;334;SEC_412
2001;245;12-15;11;19;30;SEC_245
2001;130;16-17;4;5;9;SEC_130
2001;310;12-15;17;21;38;SEC_310
2001;101;65-74;37;37;74;SEC_101
2001;405;65-74;81;80;161;SEC_405
2001;624;00-02;6;12;18;SEC_624
2001;624;65-74;50;40;90;SEC_624
2001;234;16-17;5;8;13;SEC_234
2001;119;50-64;173;174;347;SEC_119
2001;112;00-02;8;12;20;SEC_112
2001;305;00-02;20;14;34;SEC_305
2001;615;03-11;11;21;32;SEC_615
2001;115;35-49;152;143;295;SEC_115
2001;215;12-15;12;14;26;SEC_215
2001;127;25-34;61;85;146;SEC_127
2001;613;50-64;200;181;381;SEC_613
2001;249;16-17;7;12;19;SEC_249
2001;309;18-24;40;48;88;SEC_309
2001;420;65-74;77;67;144;SEC_420
2001;225;75 i +;45;34;79;SEC_225
2001;232;12-15;13;19;32;SEC_232
2001;231;18-24;40;55;95;SEC_231
2001;628;16-17;15;8;23;SEC_628
2001;617;12-15;15;18;33;SEC_617
2001;201;75 i +;41;17;58;SEC_201
2001;526;18-24;22;33;55;SEC_526
2001;313;12-15;39;29;68;SEC_313
2001;131;00-02;11;20;31;SEC_131
2001;624;25-34;103;143;246;SEC_624
2001;513;03-11;16;19;35;SEC_513
2001;215;65-74;75;44;119;SEC_215
2001;114;75 i +;60;23;83;SEC_114
2001;534;12-15;10;14;24;SEC_534
2001;401;25-34;76;71;147;SEC_401
2001;517;16-17;5;8;13;SEC_517
2001;434;16-17;7;5;12;SEC_434
2001;103;00-02;5;8;13;SEC_103
2001;308;50-64;181;158;339;SEC_308
2001;227;18-24;29;26;55;SEC_227
2001;242;75 i +;57;49;106;SEC_242
2001;312;03-11;54;52;106;SEC_312
2001;234;50-64;72;60;132;SEC_234
2001;240;03-11;17;24;41;SEC_240
2001;528;00-02;14;14;28;SEC_528
2001;311;12-15;19;20;39;SEC_311
2001;123;12-15;19;14;33;SEC_123
2001;514;35-49;62;80;142;SEC_514
2001;439;25-34;100;121;221;SEC_439
2001;403;50-64;151;122;273;SEC_403
2001;434;25-34;34;34;68;SEC_434
2001;606;35-49;92;104;196;SEC_606
2001;526;65-74;36;33;69;SEC_526
2001;106;25-34;179;178;357;SEC_106
2001;529;65-74;87;89;176;SEC_529
2001;109;12-15;23;14;37;SEC_109
2001;234;25-34;73;87;160;SEC_234
2001;404;03-11;53;46;99;SEC_404
2001;210;18-24;32;36;68;SEC_210
2001;529;03-11;31;43;74;SEC_529
2001;117;65-74;69;53;122;SEC_117
2001;127;75 i +;29;14;43;SEC_127
2001;408;18-24;33;48;81;SEC_408
2001;126;65-74;63;50;113;SEC_126
2001;317;65-74;57;38;95;SEC_317
2001;316;00-02;10;16;26;SEC_316
2001;234;18-24;29;35;64;SEC_234
2001;611;35-49;133;174;307;SEC_611
2001;517;65-74;71;64;135;SEC_517
2001;616;35-49;292;281;573;SEC_616
2001;409;16-17;5;4;9;SEC_409
2001;605;12-15;7;4;11;SEC_605
2001;231;00-02;11;13;24;SEC_231
2001;248;50-64;83;84;167;SEC_248
2001;424;18-24;32;43;75;SEC_424
2001;321;00-02;30;34;64;SEC_321
2001;209;03-11;25;33;58;SEC_209
2001;605;50-64;100;82;182;SEC_605
2001;405;16-17;5;4;9;SEC_405
2001;236;00-02;13;7;20;SEC_236
2001;229;35-49;66;65;131;SEC_229
2001;432;16-17;12;9;21;SEC_432
2001;131;65-74;54;52;106;SEC_131
2001;629;12-15;16;9;25;SEC_629
2001;230;03-11;25;27;52;SEC_230
2001;322;50-64;98;93;191;SEC_322
2001;116;50-64;184;174;358;SEC_116
2001;631;18-24;53;65;118;SEC_631
2001;309;12-15;13;13;26;SEC_309
2001;229;75 i +;49;19;68;SEC_229
2001;419;50-64;69;74;143;SEC_419
2001;319;16-17;10;11;21;SEC_319
2001;309;25-34;59;69;128;SEC_309
2001;625;16-17;24;19;43;SEC_625
2001;537;03-11;48;32;80;SEC_537
2001;132;65-74;89;86;175;SEC_132
2001;440;03-11;28;30;58;SEC_440
2001;438;12-15;15;9;24;SEC_438
2001;406;03-11;42;41;83;SEC_406
2001;113;25-34;91;96;187;SEC_113
2001;231;12-15;17;15;32;SEC_231
2001;206;12-15;15;10;25;SEC_206
2001;414;50-64;73;70;143;SEC_414
2001;403;16-17;7;6;13;SEC_403
2001;212;03-11;37;47;84;SEC_212
2001;507;03-11;22;33;55;SEC_507
2001;134;25-34;91;103;194;SEC_134
2001;110;18-24;70;75;145;SEC_110
2001;407;00-02;11;11;22;SEC_407
2001;310;65-74;45;37;82;SEC_310
2001;126;75 i +;47;25;72;SEC_126
2001;131;18-24;111;91;202;SEC_131
2001;618;18-24;34;25;59;SEC_618
2001;215;03-11;30;21;51;SEC_215
2001;225;16-17;8;8;16;SEC_225
2001;508;16-17;5;6;11;SEC_508
2001;301;50-64;195;194;389;SEC_301
2001;320;12-15;14;12;26;SEC_320
2001;213;16-17;10;15;25;SEC_213
2001;124;65-74;44;42;86;SEC_124
2001;434;00-02;6;5;11;SEC_434
2001;537;16-17;10;11;21;SEC_537
2001;117;35-49;246;243;489;SEC_117
2001;227;00-02;9;10;19;SEC_227
2001;424;12-15;8;5;13;SEC_424
2001;524;35-49;119;113;232;SEC_524
2001;439;16-17;5;11;16;SEC_439
2001;132;25-34;171;174;345;SEC_132
2001;531;16-17;6;10;16;SEC_531
2001;404;00-02;20;12;32;SEC_404
2001;435;50-64;74;64;138;SEC_435
2001;506;50-64;218;236;454;SEC_506
2001;204;35-49;43;56;99;SEC_204
2001;420;25-34;109;134;243;SEC_420
2001;304;00-02;14;14;28;SEC_304
2001;228;00-02;5;6;11;SEC_228
2001;127;65-74;46;45;91;SEC_127
2001;201;12-15;8;17;25;SEC_201
2001;628;65-74;50;48;98;SEC_628
2001;306;18-24;95;78;173;SEC_306
2001;524;00-02;20;14;34;SEC_524
2001;603;03-11;22;20;42;SEC_603
2001;407;75 i +;42;36;78;SEC_407
2001;623;25-34;154;161;315;SEC_623
2001;441;65-74;94;80;174;SEC_441
2001;614;12-15;9;29;38;SEC_614
2001;226;25-34;103;95;198;SEC_226
2001;533;00-02;8;11;19;SEC_533
2001;501;35-49;130;90;220;SEC_501
2001;520;50-64;87;85;172;SEC_520
2001;108;00-02;19;12;31;SEC_108
2001;523;16-17;9;11;20;SEC_523
2001;243;03-11;46;54;100;SEC_243
2001;325;18-24;98;77;175;SEC_325
2001;241;35-49;73;68;141;SEC_241
2001;531;18-24;36;45;81;SEC_531
2001;526;35-49;61;71;132;SEC_526
2001;431;03-11;37;40;77;SEC_431
2001;103;18-24;48;33;81;SEC_103
2001;317;75 i +;45;29;74;SEC_317
2001;602;12-15;10;8;18;SEC_602
2001;535;65-74;38;41;79;SEC_535
2001;312;16-17;13;12;25;SEC_312
2001;505;65-74;63;47;110;SEC_505
2001;231;65-74;82;64;146;SEC_231
2001;109;18-24;58;56;114;SEC_109
2001;111;35-49;105;87;192;SEC_111
2001;132;75 i +;62;31;93;SEC_132
2001;429;25-34;34;40;74;SEC_429
2001;211;00-02;10;29;39;SEC_211
2001;615;75 i +;18;12;30;SEC_615
2001;106;16-17;25;28;53;SEC_106
2001;127;50-64;53;50;103;SEC_127
2001;416;12-15;9;16;25;SEC_416
2001;206;35-49;84;78;162;SEC_206
2001;230;75 i +;50;25;75;SEC_230
2001;119;65-74;68;56;124;SEC_119
2001;616;00-02;37;59;96;SEC_616
2001;307;65-74;75;55;130;SEC_307
2001;112;50-64;147;151;298;SEC_112
2001;516;65-74;53;39;92;SEC_516
2001;527;25-34;85;91;176;SEC_527
2001;102;25-34;143;166;309;SEC_102
2001;424;50-64;61;57;118;SEC_424
2001;437;65-74;53;56;109;SEC_437
2001;119;18-24;90;92;182;SEC_119
2001;305;65-74;86;63;149;SEC_305
2001;240;25-34;57;62;119;SEC_240
2001;426;25-34;84;98;182;SEC_426
2001;228;35-49;52;58;110;SEC_228
2001;322;65-74;58;54;112;SEC_322
2001;123;03-11;41;63;104;SEC_123
2001;207;25-34;45;44;89;SEC_207
2001;235;50-64;119;99;218;SEC_235
2001;226;65-74;80;54;134;SEC_226
2001;208;35-49;183;177;360;SEC_208
2001;120;75 i +;49;28;77;SEC_120
2001;239;25-34;84;101;185;SEC_239
2001;442;16-17;6;4;10;SEC_442
2001;508;18-24;38;24;62;SEC_508
2001;248;75 i +;70;43;113;SEC_248
2001;101;75 i +;26;18;44;SEC_101
2001;230;16-17;6;7;13;SEC_230
2001;415;50-64;52;52;104;SEC_415
2001;113;12-15;44;38;82;SEC_113
2001;102;50-64;199;196;395;SEC_102
2001;536;18-24;36;40;76;SEC_536
2001;531;75 i +;47;27;74;SEC_531
2001;512;18-24;23;44;67;SEC_512
2001;218;75 i +;43;19;62;SEC_218
2001;515;12-15;11;17;28;SEC_515
2001;128;12-15;14;12;26;SEC_128
2001;111;16-17;10;8;18;SEC_111
2001;220;35-49;84;80;164;SEC_220
2001;631;16-17;13;7;20;SEC_631
2001;611;75 i +;54;35;89;SEC_611
2001;624;18-24;65;86;151;SEC_624
2001;216;75 i +;52;38;90;SEC_216
2001;629;03-11;17;16;33;SEC_629
2001;531;65-74;58;54;112;SEC_531
2001;137;75 i +;50;26;76;SEC_137
2001;405;00-02;12;14;26;SEC_405
2001;631;25-34;121;123;244;SEC_631
2001;537;75 i +;60;29;89;SEC_537
2001;125;00-02;13;17;30;SEC_125
2001;218;16-17;2;6;8;SEC_218
2001;401;50-64;92;87;179;SEC_401
2001;221;65-74;81;64;145;SEC_221
2001;107;65-74;95;74;169;SEC_107
2001;103;65-74;43;40;83;SEC_103
2001;401;00-02;12;7;19;SEC_401
2001;532;50-64;144;139;283;SEC_532
2001;418;75 i +;73;43;116;SEC_418
2001;102;16-17;14;13;27;SEC_102
2001;609;18-24;49;41;90;SEC_609
2001;127;12-15;24;19;43;SEC_127
2001;622;25-34;89;106;195;SEC_622
2001;402;00-02;6;11;17;SEC_402
2001;319;25-34;68;60;128;SEC_319
2001;527;75 i +;57;30;87;SEC_527
2001;317;00-02;15;10;25;SEC_317
2001;126;25-34;122;134;256;SEC_126
2001;605;65-74;51;44;95;SEC_605
2001;221;16-17;8;11;19;SEC_221
2001;432;50-64;150;153;303;SEC_432
2001;503;00-02;11;10;21;SEC_503
2001;514;12-15;18;10;28;SEC_514
2001;520;65-74;60;57;117;SEC_520
2001;441;50-64;205;191;396;SEC_441
2001;614;16-17;4;5;9;SEC_614
2001;105;16-17;7;13;20;SEC_105
2001;404;35-49;108;136;244;SEC_404
2001;247;35-49;132;142;274;SEC_247
2001;319;18-24;40;54;94;SEC_319
2001;315;16-17;17;17;34;SEC_315
2001;428;65-74;48;30;78;SEC_428
2001;303;03-11;39;45;84;SEC_303
2001;603;18-24;32;38;70;SEC_603
2001;521;12-15;22;16;38;SEC_521
2001;130;35-49;86;99;185;SEC_130
2001;423;18-24;44;43;87;SEC_423
2001;136;25-34;104;104;208;SEC_136
2001;620;75 i +;14;4;18;SEC_620
2001;223;35-49;95;113;208;SEC_223
2001;610;35-49;91;93;184;SEC_610
2001;501;65-74;22;23;45;SEC_501
2001;431;65-74;87;68;155;SEC_431
2001;620;00-02;5;8;13;SEC_620
2001;117;75 i +;59;33;92;SEC_117
2001;613;00-02;14;15;29;SEC_613
2001;122;18-24;39;28;67;SEC_122
2001;237;18-24;46;48;94;SEC_237
2001;601;00-02;12;7;19;SEC_601
2001;227;03-11;21;18;39;SEC_227
2001;618;12-15;15;9;24;SEC_618
2001;322;25-34;126;130;256;SEC_322
2001;418;00-02;14;9;23;SEC_418
2001;411;16-17;4;5;9;SEC_411
2001;404;12-15;15;15;30;SEC_404
2001;524;25-34;131;122;253;SEC_524
2001;115;18-24;73;74;147;SEC_115
2001;208;50-64;186;155;341;SEC_208
2001;246;35-49;98;112;210;SEC_246
2001;245;75 i +;70;35;105;SEC_245
2001;409;03-11;13;19;32;SEC_409
2001;126;35-49;58;55;113;SEC_126
2001;215;25-34;64;69;133;SEC_215
2001;535;75 i +;41;28;69;SEC_535
2001;604;03-11;26;34;60;SEC_604
2001;221;50-64;98;93;191;SEC_221
2001;608;12-15;15;20;35;SEC_608
2001;208;25-34;125;141;266;SEC_208
2001;216;03-11;35;35;70;SEC_216
2001;427;18-24;49;50;99;SEC_427
2001;323;50-64;235;286;521;SEC_323
2001;137;35-49;164;156;320;SEC_137
2001;123;50-64;101;102;203;SEC_123
2001;506;65-74;82;73;155;SEC_506
2001;523;35-49;126;121;247;SEC_523
2001;611;00-02;20;24;44;SEC_611
2001;505;35-49;83;73;156;SEC_505
2001;416;35-49;63;79;142;SEC_416
2001;502;03-11;49;27;76;SEC_502
2001;532;16-17;13;6;19;SEC_532
2001;503;03-11;25;38;63;SEC_503
2001;606;03-11;36;44;80;SEC_606
2001;417;35-49;63;64;127;SEC_417
2001;428;75 i +;26;21;47;SEC_428
2001;301;03-11;75;100;175;SEC_301
2001;108;35-49;140;130;270;SEC_108
2001;205;35-49;85;87;172;SEC_205
2001;528;03-11;39;31;70;SEC_528
2001;245;50-64;79;66;145;SEC_245
2001;205;03-11;31;32;63;SEC_205
2001;610;25-34;114;148;262;SEC_610
2001;531;00-02;12;11;23;SEC_531
2001;223;65-74;79;67;146;SEC_223
2001;134;65-74;47;37;84;SEC_134
2001;435;75 i +;89;48;137;SEC_435
2001;631;65-74;49;51;100;SEC_631
2001;512;35-49;78;76;154;SEC_512
2001;204;65-74;52;38;90;SEC_204
2001;627;25-34;76;108;184;SEC_627
2001;124;16-17;13;12;25;SEC_124
2001;123;00-02;10;13;23;SEC_123
2001;116;12-15;28;23;51;SEC_116
2001;118;50-64;162;194;356;SEC_118
2001;234;75 i +;77;38;115;SEC_234
2001;322;03-11;43;45;88;SEC_322
2001;505;16-17;12;6;18;SEC_505
2001;314;00-02;31;24;55;SEC_314
2001;632;00-02;16;14;30;SEC_632
2001;117;03-11;79;68;147;SEC_117
2001;302;35-49;137;121;258;SEC_302
2001;242;03-11;35;22;57;SEC_242
2001;431;18-24;81;85;166;SEC_431
2001;538;00-02;13;18;31;SEC_538
2001;601;35-49;123;117;240;SEC_601
2001;531;50-64;74;80;154;SEC_531
2001;526;12-15;6;9;15;SEC_526
2001;428;12-15;14;7;21;SEC_428
2001;623;12-15;25;22;47;SEC_623
2001;420;03-11;42;36;78;SEC_420
2001;606;12-15;20;19;39;SEC_606
2001;417;12-15;10;9;19;SEC_417
2001;518;18-24;46;46;92;SEC_518
2001;525;65-74;62;52;114;SEC_525
2001;316;18-24;184;198;382;SEC_316
2001;437;25-34;80;86;166;SEC_437
2001;532;12-15;19;18;37;SEC_532
2001;512;25-34;66;72;138;SEC_512
2001;628;03-11;43;33;76;SEC_628
2001;536;25-34;75;88;163;SEC_536
2001;313;18-24;145;99;244;SEC_313
2001;106;75 i +;51;27;78;SEC_106
2001;246;65-74;80;60;140;SEC_246
2001;128;50-64;95;83;178;SEC_128
2001;616;65-74;52;52;104;SEC_616
2001;629;16-17;4;7;11;SEC_629
2001;425;18-24;45;37;82;SEC_425
2001;504;12-15;8;17;25;SEC_504
2001;314;50-64;182;197;379;SEC_314
2001;409;12-15;8;10;18;SEC_409
2001;239;03-11;30;28;58;SEC_239
2001;325;03-11;68;60;128;SEC_325
2001;507;16-17;13;7;20;SEC_507
2001;433;00-02;9;23;32;SEC_433
2001;523;75 i +;84;33;117;SEC_523
2001;232;25-34;83;86;169;SEC_232
2001;430;25-34;90;75;165;SEC_430
2001;401;35-49;124;123;247;SEC_401
2001;418;16-17;10;15;25;SEC_418
2001;247;75 i +;64;33;97;SEC_247
2001;431;12-15;15;19;34;SEC_431
2001;438;00-02;6;14;20;SEC_438
2001;118;35-49;227;175;402;SEC_118
2001;628;50-64;136;143;279;SEC_628
2001;437;50-64;81;57;138;SEC_437
2001;626;25-34;82;118;200;SEC_626
2001;306;75 i +;83;55;138;SEC_306
2001;429;18-24;31;36;67;SEC_429
2001;505;18-24;80;67;147;SEC_505
2001;416;25-34;62;70;132;SEC_416
2001;604;00-02;6;5;11;SEC_604
2001;501;12-15;20;13;33;SEC_501
2001;535;50-64;150;141;291;SEC_535
2001;417;18-24;25;38;63;SEC_417
2001;234;03-11;21;30;51;SEC_234
2001;625;03-11;42;44;86;SEC_625
2001;418;65-74;63;52;115;SEC_418
2001;419;18-24;35;38;73;SEC_419
2001;135;65-74;62;51;113;SEC_135
2001;219;75 i +;82;42;124;SEC_219
2001;605;25-34;68;77;145;SEC_605
2001;533;25-34;90;101;191;SEC_533
2001;415;65-74;43;35;78;SEC_415
2001;510;16-17;7;10;17;SEC_510
2001;620;65-74;26;29;55;SEC_620
2001;139;50-64;87;85;172;SEC_139
2001;521;00-02;8;5;13;SEC_521
2001;104;65-74;70;47;117;SEC_104
2001;602;75 i +;21;15;36;SEC_602
2001;315;50-64;122;133;255;SEC_315
2001;303;35-49;110;119;229;SEC_303
2001;627;16-17;15;15;30;SEC_627
2001;321;35-49;313;295;608;SEC_321
2001;325;12-15;25;26;51;SEC_325
2001;202;00-02;6;7;13;SEC_202
2001;535;03-11;34;31;65;SEC_535
2001;613;03-11;42;35;77;SEC_613
2001;537;65-74;79;66;145;SEC_537
2001;532;65-74;90;70;160;SEC_532
2001;212;18-24;58;51;109;SEC_212
2001;439;50-64;83;66;149;SEC_439
2001;514;25-34;54;59;113;SEC_514
2001;609;03-11;24;26;50;SEC_609
2001;107;00-02;21;14;35;SEC_107
2001;505;50-64;231;208;439;SEC_505
2001;527;35-49;113;129;242;SEC_527
2001;122;35-49;71;84;155;SEC_122
2001;218;25-34;59;63;122;SEC_218
2001;210;16-17;2;5;7;SEC_210
2001;135;00-02;23;20;43;SEC_135
2001;303;25-34;151;189;340;SEC_303
2001;536;12-15;11;11;22;SEC_536
2001;124;50-64;66;64;130;SEC_124
2001;533;03-11;29;13;42;SEC_533
2001;304;65-74;80;73;153;SEC_304
2001;140;18-24;48;57;105;SEC_140
2001;630;25-34;69;79;148;SEC_630
2001;307;35-49;180;146;326;SEC_307
2001;312;25-34;182;212;394;SEC_312
2001;244;75 i +;45;40;85;SEC_244
2001;243;50-64;128;102;230;SEC_243
2001;603;00-02;7;8;15;SEC_603
2001;214;00-02;10;9;19;SEC_214
2001;228;25-34;64;71;135;SEC_228
2001;249;50-64;103;78;181;SEC_249
2001;607;65-74;78;73;151;SEC_607
2001;401;16-17;6;18;24;SEC_401
2001;529;18-24;48;48;96;SEC_529
2001;525;12-15;23;15;38;SEC_525
2001;608;50-64;89;63;152;SEC_608
2001;206;50-64;73;64;137;SEC_206
2001;611;25-34;177;198;375;SEC_611
2001;318;35-49;129;128;257;SEC_318
2001;608;18-24;50;53;103;SEC_608
2001;538;25-34;98;115;213;SEC_538
2001;104;50-64;63;72;135;SEC_104
2001;536;03-11;28;23;51;SEC_536
2001;517;50-64;88;79;167;SEC_517
2001;623;00-02;15;19;34;SEC_623
2001;133;25-34;81;97;178;SEC_133
2001;120;16-17;23;19;42;SEC_120
2001;608;00-02;7;8;15;SEC_608
2001;133;65-74;58;39;97;SEC_133
2001;232;00-02;11;8;19;SEC_232
2001;225;50-64;54;36;90;SEC_225
2001;624;35-49;95;77;172;SEC_624
2001;314;25-34;183;193;376;SEC_314
2001;311;65-74;89;72;161;SEC_311
2001;213;75 i +;37;26;63;SEC_213
2001;242;00-02;6;10;16;SEC_242
2001;601;25-34;116;135;251;SEC_601
2001;522;00-02;5;9;14;SEC_522
2001;104;35-49;75;74;149;SEC_104
2001;306;65-74;97;83;180;SEC_306
2001;207;50-64;59;53;112;SEC_207
2001;505;12-15;14;11;25;SEC_505
2001;236;03-11;34;28;62;SEC_236
2001;246;12-15;7;18;25;SEC_246
2001;306;25-34;117;115;232;SEC_306
2001;218;50-64;71;63;134;SEC_218
2001;113;03-11;41;58;99;SEC_113
2001;432;18-24;69;81;150;SEC_432
2001;617;75 i +;25;23;48;SEC_617
2001;124;00-02;4;4;8;SEC_124
2001;221;35-49;97;117;214;SEC_221
2001;606;50-64;98;70;168;SEC_606
2001;609;35-49;54;52;106;SEC_609
2001;425;50-64;87;78;165;SEC_425
2001;238;50-64;59;69;128;SEC_238
2001;212;65-74;80;72;152;SEC_212
2001;105;18-24;80;78;158;SEC_105
2001;518;03-11;28;29;57;SEC_518
2001;227;16-17;7;2;9;SEC_227
2001;131;35-49;157;147;304;SEC_131
2001;523;25-34;114;118;232;SEC_523
2001;440;50-64;156;140;296;SEC_440
2001;103;75 i +;44;17;61;SEC_103
2001;124;35-49;102;83;185;SEC_124
2001;207;16-17;4;4;8;SEC_207
2001;324;18-24;31;39;70;SEC_324
2001;630;65-74;34;29;63;SEC_630
2001;411;65-74;93;74;167;SEC_411
2001;413;03-11;26;17;43;SEC_413
2001;617;00-02;10;6;16;SEC_617
2001;631;03-11;38;32;70;SEC_631
2001;503;18-24;63;65;128;SEC_503
2001;110;03-11;32;46;78;SEC_110
2001;442;25-34;54;51;105;SEC_442
2001;438;25-34;92;94;186;SEC_438
2001;515;35-49;50;52;102;SEC_515
2001;627;12-15;18;31;49;SEC_627
2001;223;18-24;44;43;87;SEC_223
2001;117;12-15;38;37;75;SEC_117
2001;205;65-74;65;54;119;SEC_205
2001;527;18-24;47;47;94;SEC_527
2001;310;00-02;16;11;27;SEC_310
2001;108;18-24;41;52;93;SEC_108
2001;614;03-11;30;35;65;SEC_614
2001;614;00-02;13;5;18;SEC_614
2001;608;65-74;64;62;126;SEC_608
2001;425;12-15;14;12;26;SEC_425
2001;417;75 i +;31;17;48;SEC_417
2001;307;18-24;105;93;198;SEC_307
2001;522;25-34;63;73;136;SEC_522
2001;306;50-64;145;122;267;SEC_306
2001;426;65-74;59;45;104;SEC_426
2001;417;16-17;5;5;10;SEC_417
2001;129;00-02;8;13;21;SEC_129
2001;224;18-24;28;23;51;SEC_224
2001;431;25-34;134;121;255;SEC_431
2001;615;12-15;8;13;21;SEC_615
2001;224;35-49;62;60;122;SEC_224
2001;137;00-02;18;18;36;SEC_137
2001;139;03-11;33;31;64;SEC_139
2001;205;00-02;8;6;14;SEC_205
2001;136;18-24;64;68;132;SEC_136
2001;112;25-34;136;119;255;SEC_112
2001;122;75 i +;44;23;67;SEC_122
2001;216;00-02;15;10;25;SEC_216
2001;534;65-74;55;62;117;SEC_534
2001;226;16-17;8;9;17;SEC_226
2001;108;75 i +;88;43;131;SEC_108
2001;607;00-02;11;8;19;SEC_607
2001;423;65-74;79;55;134;SEC_423
2001;139;75 i +;23;11;34;SEC_139
2001;212;12-15;18;22;40;SEC_212
2001;602;50-64;76;68;144;SEC_602
2001;114;50-64;198;186;384;SEC_114
2001;529;25-34;99;111;210;SEC_529
2001;235;18-24;48;55;103;SEC_235
2001;214;18-24;31;28;59;SEC_214
2001;610;18-24;70;56;126;SEC_610
2001;506;00-02;22;25;47;SEC_506
2001;622;65-74;35;25;60;SEC_622
2001;432;12-15;15;26;41;SEC_432
2001;203;00-02;7;9;16;SEC_203
2001;224;25-34;48;53;101;SEC_224
2001;117;00-02;26;24;50;SEC_117
2001;509;65-74;42;35;77;SEC_509
2001;437;35-49;73;76;149;SEC_437
2001;307;25-34;115;99;214;SEC_307
2001;228;03-11;16;14;30;SEC_228
2001;407;50-64;89;78;167;SEC_407
2001;206;18-24;39;32;71;SEC_206
2001;536;16-17;4;7;11;SEC_536
2001;109;50-64;94;93;187;SEC_109
2001;504;35-49;78;86;164;SEC_504
2001;411;35-49;90;81;171;SEC_411
2001;314;35-49;314;306;620;SEC_314
2001;311;25-34;129;154;283;SEC_311
2001;436;75 i +;27;23;50;SEC_436
2001;136;65-74;54;47;101;SEC_136
2001;421;00-02;11;15;26;SEC_421
2001;120;03-11;80;83;163;SEC_120
2001;621;16-17;13;24;37;SEC_621
2001;221;18-24;47;55;102;SEC_221
2001;415;25-34;73;68;141;SEC_415
2001;219;18-24;37;54;91;SEC_219
2001;139;00-02;13;9;22;SEC_139
2001;324;03-11;39;31;70;SEC_324
2001;235;12-15;12;14;26;SEC_235
2001;222;25-34;69;86;155;SEC_222
2001;224;00-02;5;8;13;SEC_224
2001;133;03-11;18;30;48;SEC_133
2001;427;25-34;84;88;172;SEC_427
2001;212;75 i +;69;38;107;SEC_212
2001;122;16-17;4;6;10;SEC_122
2001;518;50-64;107;84;191;SEC_518
2001;532;35-49;119;93;212;SEC_532
2001;313;35-49;232;208;440;SEC_313
2001;413;50-64;39;48;87;SEC_413
2001;135;18-24;77;101;178;SEC_135
2001;435;12-15;27;22;49;SEC_435
2001;408;35-49;100;100;200;SEC_408
2001;403;03-11;21;27;48;SEC_403
2001;520;75 i +;40;29;69;SEC_520
2001;617;65-74;62;48;110;SEC_617
2001;224;03-11;16;21;37;SEC_224
2001;402;50-64;84;70;154;SEC_402
2001;325;50-64;193;178;371;SEC_325
2001;442;12-15;10;10;20;SEC_442
2001;202;50-64;68;66;134;SEC_202
2001;518;00-02;12;15;27;SEC_518
2001;626;12-15;15;16;31;SEC_626
2001;316;12-15;71;79;150;SEC_316
2001;531;12-15;8;10;18;SEC_531
2001;205;18-24;46;45;91;SEC_205
2001;309;16-17;6;4;10;SEC_309
2001;236;35-49;105;100;205;SEC_236
2001;233;18-24;28;34;62;SEC_233
2001;236;50-64;107;83;190;SEC_236
2001;628;00-02;12;16;28;SEC_628
2001;421;12-15;8;16;24;SEC_421
2001;602;65-74;30;34;64;SEC_602
2001;134;12-15;22;33;55;SEC_134
2001;215;18-24;37;39;76;SEC_215
2001;515;18-24;21;20;41;SEC_515
2001;221;25-34;102;84;186;SEC_221
2001;626;50-64;124;106;230;SEC_626
2001;244;50-64;46;48;94;SEC_244
2001;435;35-49;85;109;194;SEC_435
2001;435;25-34;67;79;146;SEC_435
2001;431;75 i +;65;43;108;SEC_431
2001;233;25-34;69;64;133;SEC_233
2001;318;75 i +;15;11;26;SEC_318
2001;135;50-64;133;149;282;SEC_135
2001;114;25-34;138;146;284;SEC_114
2001;112;18-24;88;72;160;SEC_112
2001;109;65-74;58;52;110;SEC_109
2001;433;25-34;106;110;216;SEC_433
2001;239;16-17;7;7;14;SEC_239
2001;208;00-02;9;11;20;SEC_208
2001;323;35-49;426;381;807;SEC_323
2001;617;25-34;93;116;209;SEC_617
2001;220;00-02;7;12;19;SEC_220
2001;616;18-24;183;178;361;SEC_616
2001;603;50-64;83;68;151;SEC_603
2001;431;50-64;116;105;221;SEC_431
2001;520;03-11;27;25;52;SEC_520
2001;210;50-64;88;77;165;SEC_210
2001;222;00-02;12;10;22;SEC_222
2001;426;16-17;8;7;15;SEC_426
2001;518;75 i +;58;25;83;SEC_518
2001;610;03-11;31;29;60;SEC_610
2001;303;65-74;118;129;247;SEC_303
2001;406;12-15;20;17;37;SEC_406
2001;511;03-11;22;21;43;SEC_511
2001;404;75 i +;55;28;83;SEC_404
2001;112;12-15;26;24;50;SEC_112
2001;301;16-17;22;28;50;SEC_301
2001;237;00-02;10;10;20;SEC_237
2001;428;16-17;2;2;4;SEC_428
2001;406;25-34;97;105;202;SEC_406
2001;529;35-49;108;106;214;SEC_529
2001;244;25-34;65;56;121;SEC_244
2001;104;12-15;7;9;16;SEC_104
2001;241;65-74;59;43;102;SEC_241
2001;604;50-64;87;64;151;SEC_604
2001;232;35-49;98;87;185;SEC_232
2001;204;75 i +;36;16;52;SEC_204
2001;432;00-02;14;14;28;SEC_432
2001;129;75 i +;38;18;56;SEC_129
2001;243;65-74;101;94;195;SEC_243
2001;617;50-64;110;96;206;SEC_617
2001;306;03-11;61;44;105;SEC_306
2001;601;75 i +;60;26;86;SEC_601
2001;605;03-11;9;17;26;SEC_605
2001;406;16-17;10;12;22;SEC_406
2001;239;50-64;109;64;173;SEC_239
2001;507;25-34;87;98;185;SEC_507
2001;201;16-17;8;6;14;SEC_201
2001;233;03-11;29;26;55;SEC_233
2001;103;35-49;87;73;160;SEC_103
2001;620;35-49;59;59;118;SEC_620
2001;519;35-49;45;53;98;SEC_519
2001;244;03-11;17;19;36;SEC_244
2001;124;18-24;46;45;91;SEC_124
2001;116;25-34;147;139;286;SEC_116
2001;202;18-24;35;38;73;SEC_202
2001;612;18-24;50;60;110;SEC_612
2001;240;16-17;4;7;11;SEC_240
2001;105;00-02;7;13;20;SEC_105
2001;320;03-11;21;25;46;SEC_320
2001;106;65-74;61;42;103;SEC_106
2001;131;25-34;109;144;253;SEC_131
2001;221;75 i +;34;32;66;SEC_221
2001;538;16-17;5;9;14;SEC_538
2001;313;75 i +;69;31;100;SEC_313
2001;622;16-17;11;13;24;SEC_622
2001;610;50-64;203;173;376;SEC_610
2001;212;35-49;120;116;236;SEC_212
2001;520;00-02;3;10;13;SEC_520
2001;612;12-15;13;14;27;SEC_612
2001;537;00-02;13;11;24;SEC_537
2001;202;35-49;56;62;118;SEC_202
2001;111;18-24;42;47;89;SEC_111
2001;134;75 i +;58;29;87;SEC_134
2001;524;12-15;17;18;35;SEC_524
2001;313;03-11;72;60;132;SEC_313
2001;303;00-02;21;14;35;SEC_303
2001;311;00-02;17;14;31;SEC_311
2001;416;18-24;25;36;61;SEC_416
2001;532;25-34;125;134;259;SEC_532
2001;126;12-15;11;14;25;SEC_126
2001;416;16-17;8;3;11;SEC_416
2001;230;50-64;64;52;116;SEC_230
2001;324;12-15;12;20;32;SEC_324
2001;606;75 i +;43;25;68;SEC_606
2001;602;03-11;14;17;31;SEC_602
2001;104;75 i +;70;38;108;SEC_104
2001;310;25-34;77;91;168;SEC_310
2001;244;00-02;2;6;8;SEC_244
2001;307;12-15;25;32;57;SEC_307
2001;205;50-64;84;75;159;SEC_205
2001;316;25-34;109;114;223;SEC_316
2001;439;18-24;25;48;73;SEC_439
2001;419;65-74;41;37;78;SEC_419
2001;425;16-17;5;10;15;SEC_425
2001;209;16-17;4;5;9;SEC_209
2001;421;03-11;33;34;67;SEC_421
2001;439;00-02;15;10;25;SEC_439
2001;531;03-11;24;34;58;SEC_531
2001;130;03-11;38;34;72;SEC_130
2001;511;50-64;66;62;128;SEC_511
2001;522;35-49;86;70;156;SEC_522
2001;615;00-02;13;6;19;SEC_615
2001;519;12-15;5;8;13;SEC_519
2001;403;00-02;6;7;13;SEC_403
2001;236;18-24;46;40;86;SEC_236
2001;420;35-49;123;126;249;SEC_420
2001;610;65-74;59;64;123;SEC_610
2001;607;50-64;133;115;248;SEC_607
2001;220;12-15;7;11;18;SEC_220
2001;232;18-24;41;53;94;SEC_232
2001;301;18-24;95;117;212;SEC_301
2001;316;75 i +;70;37;107;SEC_316
2001;204;12-15;5;12;17;SEC_204
2001;434;35-49;59;55;114;SEC_434
2001;236;75 i +;69;40;109;SEC_236
2001;404;65-74;82;76;158;SEC_404
2001;623;35-49;129;114;243;SEC_623
2001;303;75 i +;77;46;123;SEC_303
2001;317;50-64;58;57;115;SEC_317
2001;116;00-02;20;16;36;SEC_116
2001;620;03-11;17;26;43;SEC_620
2001;507;00-02;10;11;21;SEC_507
2001;120;35-49;230;232;462;SEC_120
2001;242;16-17;4;6;10;SEC_242
2001;309;35-49;98;81;179;SEC_309
2001;631;35-49;80;79;159;SEC_631
2001;101;35-49;152;160;312;SEC_101
2001;228;50-64;65;55;120;SEC_228
2001;116;75 i +;61;29;90;SEC_116
2001;211;12-15;13;16;29;SEC_211
2001;127;35-49;101;93;194;SEC_127
2001;309;65-74;34;25;59;SEC_309
2001;138;12-15;14;25;39;SEC_138
2001;410;50-64;200;172;372;SEC_410
2001;242;65-74;82;70;152;SEC_242
2001;606;65-74;80;66;146;SEC_606
2001;517;03-11;44;49;93;SEC_517
2001;240;50-64;59;53;112;SEC_240
2001;404;18-24;51;67;118;SEC_404
2001;439;12-15;9;14;23;SEC_439
2001;124;03-11;25;29;54;SEC_124
2001;237;25-34;114;153;267;SEC_237
2001;319;12-15;16;14;30;SEC_319
2001;201;00-02;7;5;12;SEC_201
2001;206;65-74;66;61;127;SEC_206
2001;120;18-24;66;98;164;SEC_120
2001;305;50-64;106;113;219;SEC_305
2001;201;03-11;21;27;48;SEC_201
2001;408;50-64;70;56;126;SEC_408
2001;111;65-74;49;48;97;SEC_111
2001;230;65-74;53;43;96;SEC_230
2001;138;16-17;5;12;17;SEC_138
2001;126;18-24;59;47;106;SEC_126
2001;437;18-24;39;36;75;SEC_437
2001;320;35-49;61;61;122;SEC_320
2001;412;03-11;40;46;86;SEC_412
2001;319;75 i +;26;21;47;SEC_319
2001;124;12-15;18;17;35;SEC_124
2001;607;03-11;31;29;60;SEC_607
2001;515;03-11;17;16;33;SEC_515
2001;108;16-17;14;10;24;SEC_108
2001;233;12-15;11;10;21;SEC_233
2001;103;25-34;57;53;110;SEC_103
2001;501;00-02;13;6;19;SEC_501
2001;424;00-02;11;7;18;SEC_424
2001;625;18-24;106;126;232;SEC_625
2001;627;03-11;25;31;56;SEC_627
2001;623;75 i +;52;27;79;SEC_623
2001;218;03-11;29;15;44;SEC_218
2001;116;03-11;51;47;98;SEC_116
2001;615;50-64;162;133;295;SEC_615
2001;535;12-15;22;27;49;SEC_535
2001;232;16-17;4;4;8;SEC_232
2001;214;12-15;9;6;15;SEC_214
2001;233;00-02;8;10;18;SEC_233
2001;414;35-49;93;86;179;SEC_414
2001;116;16-17;15;13;28;SEC_116
2001;403;75 i +;51;32;83;SEC_403
2001;130;50-64;92;67;159;SEC_130
2001;630;03-11;26;32;58;SEC_630
2001;213;12-15;27;14;41;SEC_213
2001;120;65-74;55;36;91;SEC_120
2001;523;00-02;13;10;23;SEC_523
2001;245;00-02;18;6;24;SEC_245
2001;128;35-49;94;90;184;SEC_128
2001;610;16-17;8;11;19;SEC_610
2001;132;03-11;64;81;145;SEC_132
2001;315;03-11;52;57;109;SEC_315
2001;222;35-49;81;71;152;SEC_222
2001;502;18-24;100;82;182;SEC_502
2001;442;00-02;8;4;12;SEC_442
2001;222;18-24;45;61;106;SEC_222
2001;606;00-02;13;19;32;SEC_606
2001;227;75 i +;46;27;73;SEC_227
2001;112;03-11;63;72;135;SEC_112
2001;241;75 i +;51;33;84;SEC_241
2001;521;75 i +;41;26;67;SEC_521
2001;501;75 i +;19;11;30;SEC_501
2001;526;00-02;6;9;15;SEC_526
2001;245;25-34;98;100;198;SEC_245
2001;631;12-15;12;8;20;SEC_631
2001;626;00-02;8;15;23;SEC_626
2001;106;03-11;58;64;122;SEC_106
2001;208;03-11;43;41;84;SEC_208
2001;208;16-17;20;22;42;SEC_208
2001;435;03-11;25;29;54;SEC_435
2001;606;16-17;5;6;11;SEC_606
2001;416;50-64;71;54;125;SEC_416
2001;431;00-02;20;16;36;SEC_431
2001;238;16-17;5;7;12;SEC_238
2001;615;65-74;43;43;86;SEC_615
2001;236;12-15;19;17;36;SEC_236
2001;406;50-64;123;120;243;SEC_406
2001;433;75 i +;49;20;69;SEC_433
2001;318;00-02;13;16;29;SEC_318
2001;626;35-49;96;93;189;SEC_626
2001;617;18-24;50;69;119;SEC_617
2001;203;16-17;2;10;12;SEC_203
2001;418;35-49;98;122;220;SEC_418
2001;434;50-64;43;44;87;SEC_434
2001;608;25-34;74;97;171;SEC_608
2001;112;75 i +;65;19;84;SEC_112
2001;502;12-15;21;26;47;SEC_502
2001;240;75 i +;42;22;64;SEC_240
2001;442;03-11;22;23;45;SEC_442
2001;316;50-64;205;227;432;SEC_316
2001;428;25-34;53;63;116;SEC_428
2001;530;18-24;46;82;128;SEC_530
2001;425;65-74;75;62;137;SEC_425
2001;424;25-34;35;65;100;SEC_424
2001;108;50-64;103;102;205;SEC_108
2001;320;50-64;102;92;194;SEC_320
2001;511;35-49;57;62;119;SEC_511
2001;432;25-34;88;99;187;SEC_432
2001;530;35-49;119;130;249;SEC_530
2001;440;16-17;10;3;13;SEC_440
2001;534;18-24;44;56;100;SEC_534
2001;324;16-17;11;9;20;SEC_324
2001;429;35-49;64;71;135;SEC_429
2001;521;35-49;94;79;173;SEC_521
2001;137;12-15;28;23;51;SEC_137
2001;607;35-49;99;97;196;SEC_607
2001;228;18-24;33;30;63;SEC_228
2001;247;65-74;78;61;139;SEC_247
2001;308;03-11;55;57;112;SEC_308
2001;616;16-17;46;50;96;SEC_616
2001;404;50-64;126;103;229;SEC_404
2001;438;03-11;22;26;48;SEC_438
2001;406;00-02;9;14;23;SEC_406
2001;533;35-49;81;91;172;SEC_533
2001;206;03-11;25;26;51;SEC_206
2001;617;16-17;16;8;24;SEC_617
2001;239;00-02;9;17;26;SEC_239
2001;538;03-11;28;39;67;SEC_538
