AnyPadro;Seccio;GrupEdat;Dones;Homes;Total;IdSeccio
2000;520;25-34;76;69;145;SEC_520
2000;409;12-15;8;10;18;SEC_409
2000;236;50-64;110;91;201;SEC_236
2000;427;18-24;54;43;97;SEC_427
2000;535;12-15;32;28;60;SEC_535
2000;313;25-34;151;143;294;SEC_313
2000;437;25-34;65;87;152;SEC_437
2000;511;75 i +;41;15;56;SEC_511
2000;511;35-49;49;56;105;SEC_511
2000;626;35-49;105;102;207;SEC_626
2000;417;25-34;56;57;113;SEC_417
2000;424;12-15;10;8;18;SEC_424
2000;248;16-17;13;11;24;SEC_248
2000;403;16-17;13;9;22;SEC_403
2000;427;25-34;69;74;143;SEC_427
2000;228;75 i +;39;21;60;SEC_228
2000;601;75 i +;64;27;91;SEC_601
2000;409;75 i +;22;13;35;SEC_409
2000;414;00-02;11;9;20;SEC_414
2000;114;35-49;162;160;322;SEC_114
2000;244;65-74;47;29;76;SEC_244
2000;408;35-49;94;91;185;SEC_408
2000;433;25-34;101;106;207;SEC_433
2000;204;03-11;12;16;28;SEC_204
2000;416;16-17;7;3;10;SEC_416
2000;234;75 i +;82;32;114;SEC_234
2000;236;12-15;18;12;30;SEC_236
2000;424;16-17;7;7;14;SEC_424
2000;605;12-15;8;6;14;SEC_605
2000;409;03-11;14;16;30;SEC_409
2000;604;16-17;7;7;14;SEC_604
2000;105;12-15;22;26;48;SEC_105
2000;520;65-74;54;60;114;SEC_520
2000;239;03-11;29;30;59;SEC_239
2000;530;65-74;113;84;197;SEC_530
2000;308;25-34;150;146;296;SEC_308
2000;508;50-64;55;47;102;SEC_508
2000;216;12-15;12;17;29;SEC_216
2000;525;12-15;21;16;37;SEC_525
2000;102;03-11;46;62;108;SEC_102
2000;325;03-11;64;55;119;SEC_325
2000;128;16-17;12;10;22;SEC_128
2000;221;75 i +;33;31;64;SEC_221
2000;239;16-17;8;7;15;SEC_239
2000;232;35-49;92;88;180;SEC_232
2000;304;03-11;32;43;75;SEC_304
2000;611;65-74;81;76;157;SEC_611
2000;313;50-64;156;161;317;SEC_313
2000;248;25-34;92;109;201;SEC_248
2000;116;50-64;176;173;349;SEC_116
2000;619;03-11;36;46;82;SEC_619
2000;405;00-02;16;12;28;SEC_405
2000;424;50-64;66;56;122;SEC_424
2000;319;12-15;15;15;30;SEC_319
2000;611;18-24;78;75;153;SEC_611
2000;120;25-34;151;129;280;SEC_120
2000;506;35-49;222;187;409;SEC_506
2000;629;75 i +;24;7;31;SEC_629
2000;409;50-64;71;65;136;SEC_409
2000;623;16-17;15;19;34;SEC_623
2000;130;03-11;39;39;78;SEC_130
2000;121;65-74;97;78;175;SEC_121
2000;319;03-11;18;28;46;SEC_319
2000;223;03-11;43;43;86;SEC_223
2000;513;12-15;7;12;19;SEC_513
2000;430;35-49;73;87;160;SEC_430
2000;531;25-34;89;87;176;SEC_531
2000;220;65-74;69;56;125;SEC_220
2000;110;12-15;27;20;47;SEC_110
2000;115;65-74;80;52;132;SEC_115
2000;319;18-24;44;51;95;SEC_319
2000;411;12-15;12;8;20;SEC_411
2000;607;12-15;12;19;31;SEC_607
2000;319;25-34;61;55;116;SEC_319
2000;215;25-34;58;68;126;SEC_215
2000;130;65-74;90;80;170;SEC_130
2000;115;18-24;71;80;151;SEC_115
2000;504;75 i +;56;37;93;SEC_504
2000;512;65-74;44;37;81;SEC_512
2000;432;25-34;90;86;176;SEC_432
2000;309;25-34;64;71;135;SEC_309
2000;604;03-11;27;32;59;SEC_604
2000;107;65-74;92;70;162;SEC_107
2000;418;65-74;59;44;103;SEC_418
2000;124;75 i +;34;24;58;SEC_124
2000;123;50-64;107;104;211;SEC_123
2000;106;75 i +;47;26;73;SEC_106
2000;115;25-34;94;128;222;SEC_115
2000;313;75 i +;68;32;100;SEC_313
2000;403;65-74;79;65;144;SEC_403
2000;319;75 i +;24;19;43;SEC_319
2000;223;25-34;83;92;175;SEC_223
2000;619;16-17;16;18;34;SEC_619
2000;509;18-24;48;33;81;SEC_509
2000;316;16-17;61;66;127;SEC_316
2000;623;12-15;30;22;52;SEC_623
2000;108;65-74;84;77;161;SEC_108
2000;311;16-17;7;11;18;SEC_311
2000;124;18-24;52;47;99;SEC_124
2000;244;12-15;7;3;10;SEC_244
2000;113;25-34;95;106;201;SEC_113
2000;113;00-02;9;13;22;SEC_113
2000;432;75 i +;36;32;68;SEC_432
2000;438;12-15;18;11;29;SEC_438
2000;249;75 i +;57;33;90;SEC_249
2000;533;00-02;6;8;14;SEC_533
2000;223;75 i +;71;28;99;SEC_223
2000;104;16-17;4;2;6;SEC_104
2000;506;03-11;68;85;153;SEC_506
2000;416;75 i +;31;18;49;SEC_416
2000;111;75 i +;39;27;66;SEC_111
2000;512;25-34;74;83;157;SEC_512
2000;214;12-15;7;7;14;SEC_214
2000;536;18-24;38;49;87;SEC_536
2000;610;03-11;30;34;64;SEC_610
2000;435;25-34;72;67;139;SEC_435
2000;232;03-11;29;22;51;SEC_232
2000;133;12-15;16;16;32;SEC_133
2000;626;03-11;37;31;68;SEC_626
2000;302;65-74;63;46;109;SEC_302
2000;620;75 i +;13;2;15;SEC_620
2000;118;65-74;41;36;77;SEC_118
2000;137;18-24;92;72;164;SEC_137
2000;132;16-17;33;30;63;SEC_132
2000;106;65-74;57;44;101;SEC_106
2000;132;35-49;252;238;490;SEC_132
2000;133;65-74;57;42;99;SEC_133
2000;114;03-11;49;39;88;SEC_114
2000;245;18-24;45;44;89;SEC_245
2000;441;50-64;184;180;364;SEC_441
2000;202;12-15;10;14;24;SEC_202
2000;414;03-11;23;33;56;SEC_414
2000;604;35-49;60;72;132;SEC_604
2000;612;12-15;12;17;29;SEC_612
2000;111;50-64;109;94;203;SEC_111
2000;613;65-74;69;55;124;SEC_613
2000;224;35-49;64;62;126;SEC_224
2000;229;50-64;61;61;122;SEC_229
2000;310;75 i +;29;15;44;SEC_310
2000;626;50-64;130;107;237;SEC_626
2000;118;12-15;43;44;87;SEC_118
2000;118;18-24;150;160;310;SEC_118
2000;429;03-11;11;25;36;SEC_429
2000;528;00-02;9;10;19;SEC_528
2000;131;75 i +;37;25;62;SEC_131
2000;122;50-64;111;98;209;SEC_122
2000;307;18-24;116;98;214;SEC_307
2000;139;75 i +;25;12;37;SEC_139
2000;617;65-74;56;50;106;SEC_617
2000;134;18-24;47;81;128;SEC_134
2000;420;03-11;46;39;85;SEC_420
2000;414;18-24;31;40;71;SEC_414
2000;603;35-49;51;57;108;SEC_603
2000;518;18-24;51;47;98;SEC_518
2000;423;03-11;33;26;59;SEC_423
2000;621;18-24;125;158;283;SEC_621
2000;623;75 i +;45;30;75;SEC_623
2000;317;35-49;77;98;175;SEC_317
2000;438;16-17;11;0;11;SEC_438
2000;532;18-24;61;69;130;SEC_532
2000;625;35-49;198;169;367;SEC_625
2000;627;50-64;110;132;242;SEC_627
2000;210;18-24;36;34;70;SEC_210
2000;325;50-64;201;187;388;SEC_325
2000;207;50-64;60;54;114;SEC_207
2000;439;75 i +;41;25;66;SEC_439
2000;629;03-11;16;16;32;SEC_629
2000;244;00-02;5;2;7;SEC_244
2000;231;00-02;9;7;16;SEC_231
2000;601;18-24;99;110;209;SEC_601
2000;230;75 i +;45;24;69;SEC_230
2000;615;00-02;13;6;19;SEC_615
2000;246;75 i +;74;37;111;SEC_246
2000;615;50-64;171;145;316;SEC_615
2000;216;25-34;87;100;187;SEC_216
2000;110;18-24;84;90;174;SEC_110
2000;225;00-02;0;4;4;SEC_225
2000;311;35-49;125;112;237;SEC_311
2000;530;12-15;13;12;25;SEC_530
2000;602;12-15;9;7;16;SEC_602
2000;436;65-74;33;26;59;SEC_436
2000;120;50-64;132;142;274;SEC_120
2000;511;00-02;11;7;18;SEC_511
2000;532;16-17;12;13;25;SEC_532
2000;401;25-34;80;83;163;SEC_401
2000;514;18-24;29;36;65;SEC_514
2000;249;65-74;79;67;146;SEC_249
2000;130;25-34;90;100;190;SEC_130
2000;428;65-74;46;32;78;SEC_428
2000;537;25-34;115;108;223;SEC_537
2000;219;50-64;105;87;192;SEC_219
2000;233;35-49;69;72;141;SEC_233
2000;434;25-34;34;37;71;SEC_434
2000;628;35-49;111;79;190;SEC_628
2000;527;50-64;76;74;150;SEC_527
2000;413;35-49;47;59;106;SEC_413
2000;437;18-24;44;41;85;SEC_437
2000;515;03-11;17;22;39;SEC_515
2000;619;12-15;24;34;58;SEC_619
2000;138;65-74;35;34;69;SEC_138
2000;140;35-49;78;79;157;SEC_140
2000;441;25-34;128;152;280;SEC_441
2000;228;50-64;64;58;122;SEC_228
2000;309;16-17;5;6;11;SEC_309
2000;624;65-74;45;37;82;SEC_624
2000;537;35-49;116;122;238;SEC_537
2000;204;16-17;2;6;8;SEC_204
2000;126;35-49;63;55;118;SEC_126
2000;412;75 i +;62;41;103;SEC_412
2000;621;75 i +;28;17;45;SEC_621
2000;246;35-49;90;103;193;SEC_246
2000;514;00-02;6;7;13;SEC_514
2000;617;12-15;21;17;38;SEC_617
2000;213;65-74;60;41;101;SEC_213
2000;528;12-15;24;10;34;SEC_528
2000;440;03-11;23;27;50;SEC_440
2000;529;50-64;117;105;222;SEC_529
2000;515;12-15;13;14;27;SEC_515
2000;314;25-34;181;196;377;SEC_314
2000;624;00-02;7;7;14;SEC_624
2000;114;18-24;100;107;207;SEC_114
2000;602;00-02;5;5;10;SEC_602
2000;212;12-15;16;26;42;SEC_212
2000;248;18-24;45;59;104;SEC_248
2000;230;25-34;72;66;138;SEC_230
2000;439;50-64;89;71;160;SEC_439
2000;304;75 i +;85;38;123;SEC_304
2000;435;75 i +;93;47;140;SEC_435
2000;324;12-15;15;20;35;SEC_324
2000;439;03-11;30;25;55;SEC_439
2000;242;00-02;6;5;11;SEC_242
2000;538;12-15;14;16;30;SEC_538
2000;137;35-49;159;148;307;SEC_137
2000;537;12-15;15;24;39;SEC_537
2000;201;50-64;77;65;142;SEC_201
2000;612;16-17;8;11;19;SEC_612
2000;324;16-17;13;4;17;SEC_324
2000;529;03-11;25;31;56;SEC_529
2000;239;25-34;97;108;205;SEC_239
2000;317;16-17;8;9;17;SEC_317
2000;114;00-02;23;17;40;SEC_114
2000;519;18-24;15;26;41;SEC_519
2000;530;25-34;122;138;260;SEC_530
2000;307;75 i +;48;34;82;SEC_307
2000;403;35-49;107;100;207;SEC_403
2000;622;65-74;41;28;69;SEC_622
2000;513;75 i +;41;16;57;SEC_513
2000;627;18-24;94;91;185;SEC_627
2000;248;35-49;107;114;221;SEC_248
2000;304;65-74;86;73;159;SEC_304
2000;136;25-34;99;110;209;SEC_136
2000;606;25-34;113;100;213;SEC_606
2000;219;03-11;41;38;79;SEC_219
2000;221;50-64;105;89;194;SEC_221
2000;529;16-17;10;7;17;SEC_529
2000;609;03-11;22;30;52;SEC_609
2000;425;16-17;5;9;14;SEC_425
2000;605;75 i +;24;17;41;SEC_605
2000;229;12-15;6;9;15;SEC_229
2000;127;12-15;23;21;44;SEC_127
2000;402;25-34;68;76;144;SEC_402
2000;227;16-17;8;8;16;SEC_227
2000;116;25-34;146;140;286;SEC_116
2000;626;65-74;58;61;119;SEC_626
2000;110;16-17;11;9;20;SEC_110
2000;222;50-64;78;74;152;SEC_222
2000;608;03-11;29;42;71;SEC_608
2000;123;03-11;39;59;98;SEC_123
2000;247;50-64;103;100;203;SEC_247
2000;433;18-24;45;57;102;SEC_433
2000;223;35-49;91;97;188;SEC_223
2000;538;65-74;94;90;184;SEC_538
2000;206;75 i +;67;35;102;SEC_206
2000;435;03-11;23;32;55;SEC_435
2000;233;50-64;69;63;132;SEC_233
2000;320;12-15;6;7;13;SEC_320
2000;415;25-34;69;66;135;SEC_415
2000;426;75 i +;52;35;87;SEC_426
2000;404;00-02;24;16;40;SEC_404
2000;211;35-49;107;108;215;SEC_211
2000;613;35-49;75;73;148;SEC_613
2000;429;65-74;52;35;87;SEC_429
2000;407;00-02;12;10;22;SEC_407
2000;618;00-02;3;5;8;SEC_618
2000;415;16-17;6;4;10;SEC_415
2000;501;75 i +;19;11;30;SEC_501
2000;215;75 i +;62;41;103;SEC_215
2000;317;50-64;58;55;113;SEC_317
2000;231;75 i +;93;47;140;SEC_231
2000;520;75 i +;43;25;68;SEC_520
2000;127;35-49;100;97;197;SEC_127
2000;632;18-24;65;72;137;SEC_632
2000;406;18-24;73;77;150;SEC_406
2000;418;50-64;126;108;234;SEC_418
2000;234;00-02;11;5;16;SEC_234
2000;525;50-64;91;81;172;SEC_525
2000;631;50-64;174;168;342;SEC_631
2000;216;75 i +;50;37;87;SEC_216
2000;522;00-02;10;8;18;SEC_522
2000;439;16-17;5;10;15;SEC_439
2000;531;35-49;80;83;163;SEC_531
2000;111;00-02;7;17;24;SEC_111
2000;615;18-24;55;54;109;SEC_615
2000;213;16-17;9;13;22;SEC_213
2000;116;75 i +;56;25;81;SEC_116
2000;435;50-64;77;66;143;SEC_435
2000;627;03-11;25;45;70;SEC_627
2000;625;16-17;38;20;58;SEC_625
2000;629;16-17;5;9;14;SEC_629
2000;132;03-11;69;86;155;SEC_132
2000;301;12-15;36;48;84;SEC_301
2000;137;50-64;137;141;278;SEC_137
2000;109;18-24;60;55;115;SEC_109
2000;137;16-17;13;11;24;SEC_137
2000;236;18-24;45;41;86;SEC_236
2000;531;18-24;31;49;80;SEC_531
2000;219;35-49;102;117;219;SEC_219
2000;216;50-64;152;123;275;SEC_216
2000;247;75 i +;66;34;100;SEC_247
2000;207;03-11;14;18;32;SEC_207
2000;126;25-34;119;139;258;SEC_126
2000;125;00-02;11;14;25;SEC_125
2000;425;25-34;91;83;174;SEC_425
2000;127;65-74;45;40;85;SEC_127
2000;303;75 i +;76;41;117;SEC_303
2000;108;12-15;24;16;40;SEC_108
2000;205;03-11;32;28;60;SEC_205
2000;428;00-02;5;4;9;SEC_428
2000;105;03-11;39;63;102;SEC_105
2000;626;00-02;12;14;26;SEC_626
2000;245;75 i +;73;36;109;SEC_245
2000;236;75 i +;67;39;106;SEC_236
2000;514;65-74;49;38;87;SEC_514
2000;119;50-64;167;175;342;SEC_119
2000;316;12-15;84;84;168;SEC_316
2000;123;75 i +;63;43;106;SEC_123
2000;247;03-11;24;40;64;SEC_247
2000;514;35-49;65;77;142;SEC_514
2000;246;12-15;14;15;29;SEC_246
2000;110;65-74;62;46;108;SEC_110
2000;231;50-64;92;73;165;SEC_231
2000;105;35-49;165;138;303;SEC_105
2000;320;25-34;80;92;172;SEC_320
2000;624;12-15;18;17;35;SEC_624
2000;105;16-17;10;17;27;SEC_105
2000;119;12-15;26;21;47;SEC_119
2000;101;75 i +;28;12;40;SEC_101
2000;110;35-49;145;132;277;SEC_110
2000;201;75 i +;39;18;57;SEC_201
2000;504;12-15;11;20;31;SEC_504
2000;209;00-02;13;9;22;SEC_209
2000;440;75 i +;52;34;86;SEC_440
2000;309;35-49;99;77;176;SEC_309
2000;225;12-15;9;8;17;SEC_225
2000;502;16-17;17;18;35;SEC_502
2000;401;00-02;11;13;24;SEC_401
2000;425;03-11;24;32;56;SEC_425
2000;438;25-34;85;101;186;SEC_438
2000;436;03-11;24;23;47;SEC_436
2000;525;03-11;30;25;55;SEC_525
2000;105;75 i +;48;23;71;SEC_105
2000;316;35-49;401;330;731;SEC_316
2000;137;75 i +;45;23;68;SEC_137
2000;224;16-17;3;8;11;SEC_224
2000;503;03-11;26;40;66;SEC_503
2000;204;50-64;48;39;87;SEC_204
2000;437;50-64;78;64;142;SEC_437
2000;411;25-34;65;77;142;SEC_411
2000;427;16-17;8;8;16;SEC_427
2000;102;00-02;20;21;41;SEC_102
2000;126;18-24;66;49;115;SEC_126
2000;131;35-49;157;149;306;SEC_131
2000;310;03-11;29;33;62;SEC_310
2000;211;12-15;14;18;32;SEC_211
2000;418;18-24;57;51;108;SEC_418
2000;221;65-74;75;72;147;SEC_221
2000;229;18-24;28;26;54;SEC_229
2000;622;75 i +;36;10;46;SEC_622
2000;441;75 i +;74;51;125;SEC_441
2000;220;12-15;6;8;14;SEC_220
2000;115;50-64;115;125;240;SEC_115
2000;628;25-34;103;102;205;SEC_628
2000;226;35-49;110;94;204;SEC_226
2000;310;00-02;9;11;20;SEC_310
2000;510;75 i +;47;28;75;SEC_510
2000;103;16-17;7;9;16;SEC_103
2000;236;25-34;72;77;149;SEC_236
2000;425;50-64;89;80;169;SEC_425
2000;630;00-02;6;8;14;SEC_630
2000;415;18-24;35;35;70;SEC_415
2000;104;25-34;77;84;161;SEC_104
2000;121;12-15;8;8;16;SEC_121
2000;318;25-34;54;62;116;SEC_318
2000;226;65-74;84;57;141;SEC_226
2000;108;00-02;14;16;30;SEC_108
2000;605;18-24;34;39;73;SEC_605
2000;216;18-24;63;59;122;SEC_216
2000;614;12-15;10;25;35;SEC_614
2000;533;16-17;6;10;16;SEC_533
2000;306;65-74;100;83;183;SEC_306
2000;615;75 i +;24;12;36;SEC_615
2000;310;50-64;73;76;149;SEC_310
2000;249;12-15;12;16;28;SEC_249
2000;235;75 i +;74;45;119;SEC_235
2000;302;16-17;14;14;28;SEC_302
2000;620;00-02;3;6;9;SEC_620
2000;607;25-34;101;105;206;SEC_607
2000;130;75 i +;60;40;100;SEC_130
2000;109;65-74;56;51;107;SEC_109
2000;434;50-64;45;44;89;SEC_434
2000;315;35-49;172;170;342;SEC_315
2000;132;00-02;18;21;39;SEC_132
2000;212;18-24;58;55;113;SEC_212
2000;307;25-34;113;104;217;SEC_307
2000;505;75 i +;44;31;75;SEC_505
2000;236;00-02;8;9;17;SEC_236
2000;231;12-15;17;15;32;SEC_231
2000;227;75 i +;46;25;71;SEC_227
2000;242;16-17;7;12;19;SEC_242
2000;411;00-02;7;8;15;SEC_411
2000;418;16-17;9;17;26;SEC_418
2000;303;18-24;85;71;156;SEC_303
2000;603;12-15;7;18;25;SEC_603
2000;136;03-11;39;44;83;SEC_136
2000;322;25-34;102;106;208;SEC_322
2000;527;18-24;46;42;88;SEC_527
2000;211;03-11;43;40;83;SEC_211
2000;225;35-49;43;41;84;SEC_225
2000;137;25-34;118;109;227;SEC_137
2000;404;35-49;114;127;241;SEC_404
2000;223;18-24;42;44;86;SEC_223
2000;514;75 i +;35;15;50;SEC_514
2000;323;18-24;222;219;441;SEC_323
2000;246;00-02;6;16;22;SEC_246
2000;514;12-15;15;9;24;SEC_514
2000;419;50-64;72;75;147;SEC_419
2000;116;16-17;21;11;32;SEC_116
2000;512;12-15;20;19;39;SEC_512
2000;403;03-11;19;31;50;SEC_403
2000;405;50-64;111;77;188;SEC_405
2000;407;18-24;37;48;85;SEC_407
2000;624;75 i +;27;12;39;SEC_624
2000;426;12-15;15;19;34;SEC_426
2000;507;03-11;22;28;50;SEC_507
2000;430;18-24;36;28;64;SEC_430
2000;526;12-15;6;13;19;SEC_526
2000;107;75 i +;67;36;103;SEC_107
2000;517;25-34;92;111;203;SEC_517
2000;532;35-49;114;90;204;SEC_532
2000;134;75 i +;64;33;97;SEC_134
2000;423;25-34;81;90;171;SEC_423
2000;309;50-64;66;69;135;SEC_309
2000;518;65-74;68;72;140;SEC_518
2000;313;18-24;142;110;252;SEC_313
2000;138;12-15;16;28;44;SEC_138
2000;629;35-49;60;59;119;SEC_629
2000;524;18-24;64;61;125;SEC_524
2000;134;12-15;27;35;62;SEC_134
2000;503;50-64;81;98;179;SEC_503
2000;208;35-49;191;168;359;SEC_208
2000;213;12-15;22;20;42;SEC_213
2000;438;00-02;7;16;23;SEC_438
2000;533;18-24;35;44;79;SEC_533
2000;405;18-24;40;40;80;SEC_405
2000;623;65-74;55;44;99;SEC_623
2000;531;12-15;10;14;24;SEC_531
2000;316;18-24;177;184;361;SEC_316
2000;241;25-34;69;56;125;SEC_241
2000;102;18-24;83;98;181;SEC_102
2000;501;03-11;32;42;74;SEC_501
2000;133;25-34;81;89;170;SEC_133
2000;324;25-34;73;97;170;SEC_324
2000;410;35-49;154;150;304;SEC_410
2000;218;50-64;77;62;139;SEC_218
2000;315;03-11;51;58;109;SEC_315
2000;303;00-02;19;13;32;SEC_303
2000;413;75 i +;32;13;45;SEC_413
2000;431;12-15;20;22;42;SEC_431
2000;422;65-74;81;61;142;SEC_422
2000;319;00-02;8;14;22;SEC_319
2000;409;35-49;67;58;125;SEC_409
2000;431;18-24;82;80;162;SEC_431
2000;209;75 i +;89;49;138;SEC_209
2000;505;12-15;16;13;29;SEC_505
2000;431;35-49;117;128;245;SEC_431
2000;622;16-17;15;5;20;SEC_622
2000;203;65-74;55;41;96;SEC_203
2000;534;12-15;11;13;24;SEC_534
2000;442;35-49;56;56;112;SEC_442
2000;525;25-34;86;88;174;SEC_525
2000;423;35-49;77;81;158;SEC_423
2000;121;75 i +;47;27;74;SEC_121
2000;122;03-11;37;18;55;SEC_122
2000;234;25-34;71;82;153;SEC_234
2000;419;35-49;60;75;135;SEC_419
2000;402;65-74;52;64;116;SEC_402
2000;238;18-24;27;31;58;SEC_238
2000;123;00-02;6;17;23;SEC_123
2000;305;50-64;106;118;224;SEC_305
2000;314;16-17;39;33;72;SEC_314
2000;239;65-74;98;72;170;SEC_239
2000;106;18-24;140;174;314;SEC_106
2000;135;03-11;60;45;105;SEC_135
2000;440;12-15;9;12;21;SEC_440
2000;528;18-24;55;61;116;SEC_528
2000;624;35-49;93;73;166;SEC_624
2000;126;65-74;66;49;115;SEC_126
2000;323;65-74;69;44;113;SEC_323
2000;230;00-02;10;11;21;SEC_230
2000;408;00-02;5;12;17;SEC_408
2000;404;65-74;84;69;153;SEC_404
2000;106;50-64;166;204;370;SEC_106
2000;414;12-15;10;16;26;SEC_414
2000;528;50-64;123;111;234;SEC_528
2000;103;65-74;42;39;81;SEC_103
2000;506;00-02;18;21;39;SEC_506
2000;239;35-49;95;97;192;SEC_239
2000;318;35-49;133;129;262;SEC_318
2000;312;35-49;151;168;319;SEC_312
2000;629;12-15;17;10;27;SEC_629
2000;512;18-24;32;44;76;SEC_512
2000;501;12-15;20;18;38;SEC_501
2000;610;35-49;91;84;175;SEC_610
2000;606;03-11;36;39;75;SEC_606
2000;108;75 i +;83;42;125;SEC_108
2000;620;25-34;58;60;118;SEC_620
2000;106;25-34;170;152;322;SEC_106
2000;140;16-17;6;9;15;SEC_140
2000;431;00-02;19;21;40;SEC_431
2000;507;16-17;9;3;12;SEC_507
2000;134;00-02;17;17;34;SEC_134
2000;435;00-02;12;13;25;SEC_435
2000;431;16-17;18;17;35;SEC_431
2000;621;35-49;186;139;325;SEC_621
2000;108;16-17;12;12;24;SEC_108
2000;424;25-34;33;66;99;SEC_424
2000;422;00-02;9;6;15;SEC_422
2000;129;03-11;42;31;73;SEC_129
2000;127;75 i +;32;11;43;SEC_127
2000;509;12-15;10;14;24;SEC_509
2000;440;50-64;165;143;308;SEC_440
2000;440;16-17;10;6;16;SEC_440
2000;411;03-11;34;24;58;SEC_411
2000;504;50-64;155;149;304;SEC_504
2000;244;25-34;65;53;118;SEC_244
2000;317;65-74;55;40;95;SEC_317
2000;432;16-17;10;17;27;SEC_432
2000;508;12-15;10;10;20;SEC_508
2000;402;18-24;36;40;76;SEC_402
2000;214;03-11;19;19;38;SEC_214
2000;246;65-74;74;57;131;SEC_246
2000;241;65-74;63;44;107;SEC_241
2000;623;50-64;197;199;396;SEC_623
2000;112;03-11;62;72;134;SEC_112
2000;302;50-64;156;195;351;SEC_302
2000;107;00-02;17;11;28;SEC_107
2000;247;00-02;8;9;17;SEC_247
2000;222;12-15;13;16;29;SEC_222
2000;437;03-11;23;30;53;SEC_437
2000;627;25-34;78;104;182;SEC_627
2000;632;35-49;100;92;192;SEC_632
2000;401;16-17;15;17;32;SEC_401
2000;242;35-49;97;92;189;SEC_242
2000;410;16-17;22;22;44;SEC_410
2000;217;12-15;9;8;17;SEC_217
2000;221;35-49;98;106;204;SEC_221
2000;234;03-11;24;30;54;SEC_234
2000;434;03-11;21;23;44;SEC_434
2000;242;50-64;106;100;206;SEC_242
2000;203;16-17;3;8;11;SEC_203
2000;608;75 i +;29;13;42;SEC_608
2000;317;03-11;32;39;71;SEC_317
2000;433;03-11;39;41;80;SEC_433
2000;209;25-34;78;84;162;SEC_209
2000;440;00-02;9;8;17;SEC_440
2000;420;35-49;107;123;230;SEC_420
2000;611;50-64;231;193;424;SEC_611
2000;237;75 i +;67;42;109;SEC_237
2000;235;12-15;16;13;29;SEC_235
2000;202;35-49;52;63;115;SEC_202
2000;210;50-64;94;76;170;SEC_210
2000;238;75 i +;61;30;91;SEC_238
2000;230;12-15;7;15;22;SEC_230
2000;410;65-74;124;123;247;SEC_410
2000;536;12-15;9;11;20;SEC_536
2000;407;35-49;93;87;180;SEC_407
2000;431;25-34;110;106;216;SEC_431
2000;508;65-74;39;32;71;SEC_508
2000;623;00-02;21;11;32;SEC_623
2000;617;03-11;38;46;84;SEC_617
2000;244;03-11;17;21;38;SEC_244
2000;135;75 i +;54;25;79;SEC_135
2000;134;25-34;113;98;211;SEC_134
2000;220;03-11;20;22;42;SEC_220
2000;527;35-49;103;113;216;SEC_527
2000;603;18-24;33;50;83;SEC_603
2000;113;12-15;38;37;75;SEC_113
2000;508;35-49;51;61;112;SEC_508
2000;526;65-74;34;31;65;SEC_526
2000;616;35-49;294;291;585;SEC_616
2000;217;65-74;41;34;75;SEC_217
2000;209;18-24;24;27;51;SEC_209
2000;531;00-02;13;15;28;SEC_531
2000;316;65-74;36;28;64;SEC_316
2000;504;18-24;47;75;122;SEC_504
2000;312;18-24;63;79;142;SEC_312
2000;607;65-74;69;66;135;SEC_607
2000;620;50-64;90;90;180;SEC_620
2000;306;18-24;91;85;176;SEC_306
2000;138;25-34;63;63;126;SEC_138
2000;428;25-34;49;57;106;SEC_428
2000;535;18-24;78;87;165;SEC_535
2000;307;03-11;39;59;98;SEC_307
2000;235;16-17;9;4;13;SEC_235
2000;513;03-11;16;17;33;SEC_513
2000;623;35-49;149;127;276;SEC_623
2000;438;65-74;43;38;81;SEC_438
2000;529;35-49;87;97;184;SEC_529
2000;612;35-49;65;73;138;SEC_612
2000;235;65-74;104;84;188;SEC_235
2000;512;00-02;6;11;17;SEC_512
2000;315;65-74;55;39;94;SEC_315
2000;625;25-34;93;108;201;SEC_625
2000;304;35-49;105;113;218;SEC_304
2000;208;16-17;12;25;37;SEC_208
2000;435;35-49;76;104;180;SEC_435
2000;216;00-02;12;3;15;SEC_216
2000;428;50-64;41;31;72;SEC_428
2000;531;50-64;77;82;159;SEC_531
2000;603;03-11;23;18;41;SEC_603
2000;312;00-02;13;26;39;SEC_312
2000;403;25-34;72;94;166;SEC_403
2000;311;03-11;36;47;83;SEC_311
2000;325;12-15;21;26;47;SEC_325
2000;303;35-49;108;113;221;SEC_303
2000;524;35-49;100;108;208;SEC_524
2000;426;35-49;89;79;168;SEC_426
2000;426;18-24;49;68;117;SEC_426
2000;238;65-74;59;41;100;SEC_238
2000;117;50-64;159;168;327;SEC_117
2000;107;35-49;165;163;328;SEC_107
2000;303;03-11;46;48;94;SEC_303
2000;228;16-17;2;7;9;SEC_228
2000;205;16-17;13;8;21;SEC_205
2000;603;25-34;62;75;137;SEC_603
2000;416;00-02;7;7;14;SEC_416
2000;135;16-17;17;18;35;SEC_135
2000;208;75 i +;119;74;193;SEC_208
2000;203;12-15;5;11;16;SEC_203
2000;103;18-24;45;34;79;SEC_103
2000;120;18-24;75;95;170;SEC_120
2000;413;12-15;7;9;16;SEC_413
2000;510;35-49;87;91;178;SEC_510
2000;139;16-17;8;9;17;SEC_139
2000;129;16-17;13;9;22;SEC_129
2000;204;75 i +;33;16;49;SEC_204
2000;506;65-74;76;72;148;SEC_506
2000;306;00-02;19;20;39;SEC_306
2000;122;75 i +;41;26;67;SEC_122
2000;227;35-49;69;60;129;SEC_227
2000;406;16-17;15;19;34;SEC_406
2000;243;35-49;145;141;286;SEC_243
2000;320;35-49;50;48;98;SEC_320
2000;410;25-34;115;123;238;SEC_410
2000;619;65-74;75;69;144;SEC_619
2000;520;35-49;84;67;151;SEC_520
2000;109;25-34;86;83;169;SEC_109
2000;226;50-64;89;88;177;SEC_226
2000;249;35-49;107;88;195;SEC_249
2000;109;35-49;136;138;274;SEC_109
2000;538;35-49;114;93;207;SEC_538
2000;442;12-15;10;10;20;SEC_442
2000;606;16-17;8;10;18;SEC_606
2000;610;12-15;11;23;34;SEC_610
2000;111;03-11;32;24;56;SEC_111
2000;218;00-02;6;14;20;SEC_218
2000;425;12-15;15;15;30;SEC_425
2000;609;00-02;8;6;14;SEC_609
2000;124;25-34;59;68;127;SEC_124
2000;201;00-02;3;7;10;SEC_201
2000;632;03-11;40;45;85;SEC_632
2000;421;65-74;93;79;172;SEC_421
2000;314;50-64;165;188;353;SEC_314
2000;134;03-11;40;47;87;SEC_134
2000;136;12-15;23;14;37;SEC_136
2000;602;16-17;6;6;12;SEC_602
2000;632;25-34;93;123;216;SEC_632
2000;520;00-02;6;14;20;SEC_520
2000;517;50-64;88;87;175;SEC_517
2000;528;75 i +;46;26;72;SEC_528
2000;301;03-11;77;92;169;SEC_301
2000;139;35-49;95;92;187;SEC_139
2000;213;35-49;97;94;191;SEC_213
2000;241;50-64;49;45;94;SEC_241
2000;519;75 i +;15;18;33;SEC_519
2000;138;16-17;7;14;21;SEC_138
2000;438;75 i +;31;16;47;SEC_438
2000;628;03-11;38;33;71;SEC_628
2000;436;25-34;78;97;175;SEC_436
2000;304;12-15;18;19;37;SEC_304
2000;417;16-17;4;7;11;SEC_417
2000;509;50-64;78;83;161;SEC_509
2000;616;03-11;148;146;294;SEC_616
2000;630;65-74;29;30;59;SEC_630
2000;305;35-49;223;195;418;SEC_305
2000;522;12-15;13;14;27;SEC_522
2000;309;12-15;14;12;26;SEC_309
2000;508;18-24;34;25;59;SEC_508
2000;522;25-34;56;67;123;SEC_522
2000;325;00-02;18;17;35;SEC_325
2000;437;12-15;13;19;32;SEC_437
2000;301;75 i +;77;37;114;SEC_301
2000;218;03-11;27;18;45;SEC_218
2000;213;25-34;69;83;152;SEC_213
2000;216;65-74;78;71;149;SEC_216
2000;125;25-34;93;103;196;SEC_125
2000;502;12-15;25;31;56;SEC_502
2000;323;35-49;446;410;856;SEC_323
2000;232;75 i +;68;35;103;SEC_232
2000;243;12-15;14;17;31;SEC_243
2000;515;25-34;40;48;88;SEC_515
2000;324;35-49;81;78;159;SEC_324
2000;524;16-17;9;13;22;SEC_524
2000;439;00-02;11;16;27;SEC_439
2000;523;25-34;101;110;211;SEC_523
2000;409;18-24;41;41;82;SEC_409
2000;107;12-15;28;31;59;SEC_107
2000;248;03-11;36;38;74;SEC_248
2000;614;18-24;55;53;108;SEC_614
2000;224;03-11;21;19;40;SEC_224
2000;236;35-49;90;90;180;SEC_236
2000;503;25-34;60;61;121;SEC_503
2000;533;03-11;32;23;55;SEC_533
2000;209;12-15;8;14;22;SEC_209
2000;523;65-74;93;84;177;SEC_523
2000;241;35-49;67;64;131;SEC_241
2000;242;12-15;12;19;31;SEC_242
2000;423;18-24;44;48;92;SEC_423
2000;240;00-02;6;8;14;SEC_240
2000;504;00-02;7;8;15;SEC_504
2000;534;00-02;10;6;16;SEC_534
2000;313;35-49;232;212;444;SEC_313
2000;137;00-02;13;18;31;SEC_137
2000;104;75 i +;63;37;100;SEC_104
2000;104;18-24;34;36;70;SEC_104
2000;502;03-11;48;27;75;SEC_502
2000;133;16-17;12;11;23;SEC_133
2000;410;75 i +;71;47;118;SEC_410
2000;608;16-17;10;8;18;SEC_608
2000;230;50-64;70;58;128;SEC_230
2000;201;35-49;54;52;106;SEC_201
2000;129;35-49;99;110;209;SEC_129
2000;605;16-17;1;3;4;SEC_605
2000;537;16-17;14;13;27;SEC_537
2000;631;65-74;47;51;98;SEC_631
2000;104;35-49;70;67;137;SEC_104
2000;125;18-24;72;97;169;SEC_125
2000;233;18-24;33;30;63;SEC_233
2000;124;65-74;47;41;88;SEC_124
2000;403;18-24;59;65;124;SEC_403
2000;247;65-74;79;58;137;SEC_247
2000;536;00-02;4;11;15;SEC_536
2000;317;18-24;44;53;97;SEC_317
2000;208;65-74;132;118;250;SEC_208
2000;105;00-02;8;12;20;SEC_105
2000;324;18-24;26;43;69;SEC_324
2000;226;18-24;54;57;111;SEC_226
2000;243;03-11;43;55;98;SEC_243
2000;434;35-49;56;52;108;SEC_434
2000;220;35-49;77;76;153;SEC_220
2000;608;18-24;57;61;118;SEC_608
2000;206;25-34;62;72;134;SEC_206
2000;525;35-49;69;71;140;SEC_525
2000;114;50-64;209;189;398;SEC_114
2000;215;03-11;22;24;46;SEC_215
2000;136;00-02;9;16;25;SEC_136
2000;617;25-34;99;122;221;SEC_617
2000;517;00-02;9;15;24;SEC_517
2000;210;25-34;62;65;127;SEC_210
2000;514;03-11;22;21;43;SEC_514
2000;612;25-34;112;132;244;SEC_612
2000;317;75 i +;49;28;77;SEC_317
2000;115;35-49;148;147;295;SEC_115
2000;505;18-24;91;83;174;SEC_505
2000;126;03-11;23;19;42;SEC_126
2000;120;16-17;19;19;38;SEC_120
2000;535;75 i +;38;26;64;SEC_535
2000;233;25-34;60;53;113;SEC_233
2000;310;12-15;25;21;46;SEC_310
2000;411;50-64;115;113;228;SEC_411
2000;222;25-34;76;75;151;SEC_222
2000;407;12-15;8;17;25;SEC_407
2000;217;75 i +;49;13;62;SEC_217
2000;232;16-17;5;8;13;SEC_232
2000;321;16-17;27;22;49;SEC_321
2000;122;00-02;11;17;28;SEC_122
2000;239;75 i +;67;57;124;SEC_239
2000;619;35-49;151;145;296;SEC_619
2000;622;12-15;19;23;42;SEC_622
2000;611;75 i +;48;35;83;SEC_611
2000;619;18-24;96;94;190;SEC_619
2000;519;00-02;11;15;26;SEC_519
2000;225;50-64;55;39;94;SEC_225
2000;609;18-24;62;53;115;SEC_609
2000;102;75 i +;75;38;113;SEC_102
2000;516;12-15;9;6;15;SEC_516
2000;617;18-24;53;83;136;SEC_617
2000;531;75 i +;48;27;75;SEC_531
2000;508;03-11;21;21;42;SEC_508
2000;248;50-64;86;79;165;SEC_248
2000;436;75 i +;30;20;50;SEC_436
2000;223;50-64;107;99;206;SEC_223
2000;122;18-24;40;27;67;SEC_122
2000;424;75 i +;21;11;32;SEC_424
2000;120;00-02;23;25;48;SEC_120
2000;115;00-02;16;10;26;SEC_115
2000;534;35-49;83;76;159;SEC_534
2000;435;18-24;33;43;76;SEC_435
2000;119;65-74;70;59;129;SEC_119
2000;625;03-11;48;42;90;SEC_625
2000;240;03-11;17;25;42;SEC_240
2000;401;18-24;53;52;105;SEC_401
2000;111;65-74;47;45;92;SEC_111
2000;502;18-24;101;85;186;SEC_502
2000;225;75 i +;41;39;80;SEC_225
2000;621;25-34;150;158;308;SEC_621
2000;520;03-11;32;28;60;SEC_520
2000;310;35-49;98;110;208;SEC_310
2000;608;25-34;77;112;189;SEC_608
2000;516;16-17;8;3;11;SEC_516
2000;315;00-02;17;26;43;SEC_315
2000;107;18-24;116;128;244;SEC_107
2000;413;03-11;27;19;46;SEC_413
2000;604;75 i +;25;15;40;SEC_604
2000;426;00-02;11;9;20;SEC_426
2000;530;35-49;120;115;235;SEC_530
2000;429;35-49;69;72;141;SEC_429
2000;136;50-64;104;106;210;SEC_136
2000;627;12-15;19;29;48;SEC_627
2000;627;00-02;16;4;20;SEC_627
2000;214;65-74;42;39;81;SEC_214
2000;609;35-49;54;49;103;SEC_609
2000;224;25-34;51;52;103;SEC_224
2000;307;12-15;27;34;61;SEC_307
2000;616;00-02;38;54;92;SEC_616
2000;523;18-24;61;71;132;SEC_523
2000;510;03-11;26;36;62;SEC_510
2000;112;35-49;191;168;359;SEC_112
2000;607;00-02;11;8;19;SEC_607
2000;536;25-34;83;90;173;SEC_536
2000;123;65-74;83;77;160;SEC_123
2000;415;00-02;1;6;7;SEC_415
2000;528;03-11;37;32;69;SEC_528
2000;416;12-15;11;10;21;SEC_416
2000;320;50-64;99;87;186;SEC_320
2000;508;00-02;3;5;8;SEC_508
2000;421;00-02;10;13;23;SEC_421
2000;216;35-49;114;101;215;SEC_216
2000;140;75 i +;47;27;74;SEC_140
2000;206;50-64;75;66;141;SEC_206
2000;614;16-17;4;8;12;SEC_614
2000;314;18-24;131;150;281;SEC_314
2000;118;03-11;66;64;130;SEC_118
2000;612;03-11;33;32;65;SEC_612
2000;612;18-24;58;71;129;SEC_612
2000;249;18-24;47;49;96;SEC_249
2000;423;00-02;7;10;17;SEC_423
2000;412;03-11;46;50;96;SEC_412
2000;401;65-74;103;86;189;SEC_401
2000;623;18-24;102;128;230;SEC_623
2000;118;75 i +;38;21;59;SEC_118
2000;210;16-17;4;9;13;SEC_210
2000;412;12-15;27;30;57;SEC_412
2000;517;65-74;70;57;127;SEC_517
2000;118;25-34;135;140;275;SEC_118
2000;517;03-11;34;42;76;SEC_517
2000;248;12-15;23;17;40;SEC_248
2000;322;65-74;58;49;107;SEC_322
2000;101;35-49;147;156;303;SEC_101
2000;205;75 i +;37;21;58;SEC_205
2000;507;35-49;78;75;153;SEC_507
2000;203;25-34;59;53;112;SEC_203
2000;219;75 i +;83;40;123;SEC_219
2000;441;03-11;69;69;138;SEC_441
2000;325;65-74;123;104;227;SEC_325
2000;518;75 i +;59;25;84;SEC_518
2000;212;00-02;16;14;30;SEC_212
2000;321;35-49;315;299;614;SEC_321
2000;516;03-11;16;26;42;SEC_516
2000;308;00-02;18;25;43;SEC_308
2000;621;03-11;58;55;113;SEC_621
2000;308;16-17;16;20;36;SEC_308
2000;104;50-64;68;71;139;SEC_104
2000;603;50-64;83;65;148;SEC_603
2000;429;50-64;48;57;105;SEC_429
2000;425;18-24;45;33;78;SEC_425
2000;613;75 i +;42;25;67;SEC_613
2000;519;16-17;6;3;9;SEC_519
2000;430;16-17;7;10;17;SEC_430
2000;238;00-02;6;8;14;SEC_238
2000;424;00-02;12;6;18;SEC_424
2000;428;18-24;24;20;44;SEC_428
2000;314;35-49;326;307;633;SEC_314
2000;241;75 i +;49;33;82;SEC_241
2000;614;65-74;55;45;100;SEC_614
2000;509;03-11;23;27;50;SEC_509
2000;205;35-49;90;90;180;SEC_205
2000;242;03-11;35;22;57;SEC_242
2000;538;03-11;30;40;70;SEC_538
2000;140;00-02;10;7;17;SEC_140
2000;414;65-74;68;60;128;SEC_414
2000;105;65-74;47;36;83;SEC_105
2000;317;25-34;90;88;178;SEC_317
2000;407;75 i +;38;34;72;SEC_407
2000;428;75 i +;28;23;51;SEC_428
2000;231;25-34;87;92;179;SEC_231
2000;522;50-64;68;58;126;SEC_522
2000;434;12-15;15;5;20;SEC_434
2000;127;16-17;8;7;15;SEC_127
2000;630;35-49;101;73;174;SEC_630
2000;533;75 i +;41;20;61;SEC_533
2000;524;03-11;37;49;86;SEC_524
2000;208;18-24;67;75;142;SEC_208
2000;522;75 i +;30;22;52;SEC_522
2000;601;00-02;13;9;22;SEC_601
2000;245;00-02;13;10;23;SEC_245
2000;113;03-11;53;65;118;SEC_113
2000;421;16-17;4;9;13;SEC_421
2000;225;65-74;46;28;74;SEC_225
2000;216;16-17;16;16;32;SEC_216
2000;210;12-15;6;13;19;SEC_210
2000;138;18-24;45;60;105;SEC_138
2000;412;16-17;18;17;35;SEC_412
2000;320;18-24;22;38;60;SEC_320
2000;311;75 i +;88;43;131;SEC_311
2000;325;18-24;99;97;196;SEC_325
2000;439;25-34;96;109;205;SEC_439
2000;309;65-74;30;28;58;SEC_309
2000;419;16-17;11;6;17;SEC_419
2000;602;75 i +;25;12;37;SEC_602
2000;323;25-34;230;267;497;SEC_323
2000;240;18-24;25;30;55;SEC_240
2000;523;35-49;118;121;239;SEC_523
2000;625;18-24;105;129;234;SEC_625
2000;623;03-11;43;55;98;SEC_623
2000;226;75 i +;72;35;107;SEC_226
2000;406;35-49;132;133;265;SEC_406
2000;520;12-15;15;15;30;SEC_520
2000;201;65-74;52;45;97;SEC_201
2000;246;25-34;104;99;203;SEC_246
2000;103;12-15;15;9;24;SEC_103
2000;536;50-64;101;90;191;SEC_536
2000;132;65-74;83;88;171;SEC_132
2000;249;00-02;9;8;17;SEC_249
2000;207;16-17;5;6;11;SEC_207
2000;605;25-34;67;80;147;SEC_605
2000;207;00-02;4;10;14;SEC_207
2000;307;65-74;83;54;137;SEC_307
2000;108;18-24;39;51;90;SEC_108
2000;417;35-49;61;60;121;SEC_417
2000;630;03-11;23;31;54;SEC_630
2000;248;00-02;16;11;27;SEC_248
2000;538;75 i +;60;31;91;SEC_538
2000;535;16-17;11;18;29;SEC_535
2000;609;50-64;145;129;274;SEC_609
2000;234;16-17;2;6;8;SEC_234
2000;421;35-49;79;81;160;SEC_421
2000;530;75 i +;71;29;100;SEC_530
2000;211;65-74;90;71;161;SEC_211
2000;516;75 i +;24;10;34;SEC_516
2000;419;12-15;13;8;21;SEC_419
2000;241;00-02;9;9;18;SEC_241
2000;323;03-11;139;137;276;SEC_323
2000;207;65-74;56;36;92;SEC_207
2000;114;25-34;161;150;311;SEC_114
2000;101;12-15;31;27;58;SEC_101
2000;229;65-74;53;51;104;SEC_229
2000;301;50-64;197;200;397;SEC_301
2000;302;18-24;94;109;203;SEC_302
2000;108;35-49;135;118;253;SEC_108
2000;234;35-49;82;76;158;SEC_234
2000;226;12-15;20;21;41;SEC_226
2000;428;35-49;46;49;95;SEC_428
2000;401;12-15;21;27;48;SEC_401
2000;631;25-34;118;127;245;SEC_631
2000;226;00-02;9;4;13;SEC_226
2000;615;65-74;36;38;74;SEC_615
2000;308;18-24;81;74;155;SEC_308
2000;124;00-02;7;6;13;SEC_124
2000;503;65-74;31;18;49;SEC_503
2000;417;50-64;65;55;120;SEC_417
2000;621;65-74;43;32;75;SEC_621
2000;533;12-15;16;15;31;SEC_533
2000;511;50-64;67;64;131;SEC_511
2000;227;50-64;69;61;130;SEC_227
2000;602;35-49;41;39;80;SEC_602
2000;227;18-24;31;32;63;SEC_227
2000;505;65-74;56;48;104;SEC_505
2000;516;18-24;29;28;57;SEC_516
2000;431;50-64;108;112;220;SEC_431
2000;613;25-34;147;170;317;SEC_613
2000;205;25-34;68;66;134;SEC_205
2000;210;75 i +;62;36;98;SEC_210
2000;209;16-17;4;5;9;SEC_209
2000;535;35-49;121;113;234;SEC_535
2000;134;65-74;49;34;83;SEC_134
2000;423;65-74;73;59;132;SEC_423
2000;520;18-24;41;58;99;SEC_520
2000;613;18-24;62;59;121;SEC_613
2000;245;50-64;79;66;145;SEC_245
2000;239;18-24;55;46;101;SEC_239
2000;219;65-74;80;58;138;SEC_219
2000;422;03-11;26;42;68;SEC_422
2000;105;18-24;88;75;163;SEC_105
2000;206;16-17;5;9;14;SEC_206
2000;406;00-02;7;14;21;SEC_406
2000;220;18-24;43;20;63;SEC_220
2000;118;35-49;237;191;428;SEC_118
2000;632;12-15;17;22;39;SEC_632
2000;412;00-02;7;6;13;SEC_412
2000;224;00-02;4;11;15;SEC_224
2000;222;18-24;39;58;97;SEC_222
2000;605;65-74;46;39;85;SEC_605
2000;104;65-74;78;49;127;SEC_104
2000;321;50-64;228;241;469;SEC_321
2000;416;18-24;23;31;54;SEC_416
2000;201;18-24;22;26;48;SEC_201
2000;136;18-24;64;69;133;SEC_136
2000;423;16-17;7;4;11;SEC_423
2000;618;25-34;55;72;127;SEC_618
2000;319;16-17;8;13;21;SEC_319
2000;628;50-64;136;145;281;SEC_628
2000;618;65-74;29;16;45;SEC_618
2000;126;75 i +;43;23;66;SEC_126
2000;531;16-17;4;10;14;SEC_531
2000;522;35-49;78;69;147;SEC_522
2000;618;75 i +;18;16;34;SEC_618
2000;420;65-74;83;64;147;SEC_420
2000;131;25-34;128;141;269;SEC_131
2000;130;18-24;36;38;74;SEC_130
2000;135;12-15;32;30;62;SEC_135
2000;427;12-15;7;7;14;SEC_427
2000;402;35-49;63;65;128;SEC_402
2000;536;75 i +;37;33;70;SEC_536
2000;125;65-74;51;48;99;SEC_125
2000;119;18-24;96;93;189;SEC_119
2000;212;75 i +;70;37;107;SEC_212
2000;231;65-74;80;70;150;SEC_231
2000;617;16-17;15;12;27;SEC_617
2000;206;00-02;5;4;9;SEC_206
2000;519;35-49;41;45;86;SEC_519
2000;238;12-15;9;12;21;SEC_238
2000;208;50-64;186;159;345;SEC_208
2000;625;50-64;130;145;275;SEC_625
2000;223;16-17;6;10;16;SEC_223
2000;320;16-17;6;6;12;SEC_320
2000;107;50-64;191;186;377;SEC_107
2000;212;65-74;74;74;148;SEC_212
2000;515;50-64;52;55;107;SEC_515
2000;422;50-64;82;79;161;SEC_422
2000;631;12-15;17;10;27;SEC_631
2000;524;25-34;124;111;235;SEC_524
2000;621;12-15;20;38;58;SEC_621
2000;615;12-15;10;9;19;SEC_615
2000;246;50-64;79;67;146;SEC_246
2000;214;35-49;50;59;109;SEC_214
2000;240;12-15;10;14;24;SEC_240
2000;630;75 i +;25;11;36;SEC_630
2000;124;12-15;21;16;37;SEC_124
2000;512;03-11;28;21;49;SEC_512
2000;606;00-02;13;13;26;SEC_606
2000;426;16-17;3;5;8;SEC_426
2000;322;12-15;20;20;40;SEC_322
2000;115;16-17;15;15;30;SEC_115
2000;426;03-11;22;26;48;SEC_426
2000;125;16-17;13;12;25;SEC_125
2000;119;25-34;103;127;230;SEC_119
2000;241;18-24;32;21;53;SEC_241
2000;505;35-49;84;73;157;SEC_505
2000;319;35-49;91;90;181;SEC_319
2000;501;16-17;13;8;21;SEC_501
2000;242;75 i +;52;50;102;SEC_242
2000;112;16-17;19;16;35;SEC_112
2000;202;65-74;49;40;89;SEC_202
2000;102;16-17;17;11;28;SEC_102
2000;419;25-34;84;90;174;SEC_419
2000;532;03-11;40;34;74;SEC_532
2000;130;12-15;10;7;17;SEC_130
2000;601;03-11;42;45;87;SEC_601
2000;408;12-15;19;10;29;SEC_408
2000;437;35-49;80;80;160;SEC_437
2000;130;50-64;98;70;168;SEC_130
2000;521;03-11;24;30;54;SEC_521
2000;232;18-24;43;41;84;SEC_232
2000;537;75 i +;54;29;83;SEC_537
2000;441;65-74;99;80;179;SEC_441
2000;121;00-02;8;17;25;SEC_121
2000;430;00-02;6;9;15;SEC_430
2000;224;50-64;40;39;79;SEC_224
2000;505;50-64;232;216;448;SEC_505
2000;526;35-49;62;66;128;SEC_526
2000;128;03-11;22;39;61;SEC_128
2000;430;25-34;83;71;154;SEC_430
2000;302;75 i +;53;20;73;SEC_302
2000;421;25-34;120;109;229;SEC_421
2000;240;75 i +;43;20;63;SEC_240
2000;424;65-74;30;41;71;SEC_424
2000;616;50-64;175;191;366;SEC_616
2000;308;35-49;148;155;303;SEC_308
2000;114;16-17;17;21;38;SEC_114
2000;519;12-15;8;9;17;SEC_519
2000;613;00-02;10;11;21;SEC_613
2000;420;25-34;114;113;227;SEC_420
2000;318;00-02;14;11;25;SEC_318
2000;403;12-15;25;17;42;SEC_403
2000;622;03-11;28;45;73;SEC_622
2000;113;65-74;52;34;86;SEC_113
2000;132;18-24;130;152;282;SEC_132
2000;406;03-11;39;39;78;SEC_406
2000;244;16-17;1;3;4;SEC_244
2000;315;25-34;128;129;257;SEC_315
2000;243;18-24;52;53;105;SEC_243
2000;101;00-02;21;14;35;SEC_101
2000;430;65-74;52;51;103;SEC_430
2000;612;50-64;173;142;315;SEC_612
2000;621;00-02;12;16;28;SEC_621
2000;137;12-15;27;31;58;SEC_137
2000;205;65-74;62;54;116;SEC_205
2000;316;00-02;12;16;28;SEC_316
2000;237;16-17;14;5;19;SEC_237
2000;203;18-24;29;31;60;SEC_203
2000;608;65-74;59;52;111;SEC_608
2000;234;12-15;12;11;23;SEC_234
2000;537;03-11;49;25;74;SEC_537
2000;404;75 i +;53;34;87;SEC_404
2000;224;18-24;30;24;54;SEC_224
2000;110;00-02;6;8;14;SEC_110
2000;510;16-17;7;10;17;SEC_510
2000;603;16-17;4;4;8;SEC_603
2000;114;12-15;26;23;49;SEC_114
2000;218;75 i +;45;20;65;SEC_218
2000;140;50-64;112;109;221;SEC_140
2000;123;18-24;64;68;132;SEC_123
2000;433;35-49;99;98;197;SEC_433
2000;538;00-02;12;13;25;SEC_538
2000;222;35-49;68;73;141;SEC_222
2000;105;25-34;73;85;158;SEC_105
2000;408;50-64;75;60;135;SEC_408
2000;420;16-17;11;13;24;SEC_420
2000;137;65-74;45;38;83;SEC_137
2000;405;03-11;24;21;45;SEC_405
2000;536;03-11;31;22;53;SEC_536
2000;228;00-02;4;6;10;SEC_228
2000;315;75 i +;49;28;77;SEC_315
2000;302;03-11;43;48;91;SEC_302
2000;241;03-11;39;25;64;SEC_241
2000;439;18-24;29;42;71;SEC_439
2000;113;16-17;26;24;50;SEC_113
2000;413;16-17;6;3;9;SEC_413
2000;207;18-24;31;27;58;SEC_207
2000;433;00-02;7;17;24;SEC_433
2000;522;16-17;15;5;20;SEC_522
2000;103;50-64;63;59;122;SEC_103
2000;624;25-34;106;130;236;SEC_624
2000;124;16-17;15;13;28;SEC_124
2000;103;25-34;68;63;131;SEC_103
2000;537;18-24;73;65;138;SEC_537
2000;243;25-34;150;136;286;SEC_243
2000;617;75 i +;24;24;48;SEC_617
2000;237;50-64;128;113;241;SEC_237
2000;604;00-02;8;7;15;SEC_604
2000;607;50-64;146;123;269;SEC_607
2000;233;00-02;7;8;15;SEC_233
2000;416;35-49;64;75;139;SEC_416
2000;232;12-15;15;12;27;SEC_232
2000;315;18-24;89;89;178;SEC_315
2000;411;35-49;87;79;166;SEC_411
2000;504;65-74;76;74;150;SEC_504
2000;627;65-74;30;28;58;SEC_627
2000;222;65-74;47;40;87;SEC_222
2000;103;35-49;83;69;152;SEC_103
2000;309;00-02;8;9;17;SEC_309
2000;249;50-64;102;82;184;SEC_249
2000;211;16-17;11;6;17;SEC_211
2000;203;03-11;19;17;36;SEC_203
2000;518;16-17;4;11;15;SEC_518
2000;439;12-15;7;19;26;SEC_439
2000;407;65-74;80;74;154;SEC_407
2000;244;50-64;51;46;97;SEC_244
2000;211;00-02;6;22;28;SEC_211
2000;603;75 i +;13;15;28;SEC_603
2000;322;18-24;67;62;129;SEC_322
2000;231;16-17;8;8;16;SEC_231
2000;311;65-74;86;74;160;SEC_311
2000;604;50-64;86;62;148;SEC_604
2000;323;16-17;52;53;105;SEC_323
2000;632;65-74;47;42;89;SEC_632
2000;534;16-17;4;7;11;SEC_534
2000;404;03-11;52;42;94;SEC_404
2000;127;50-64;53;53;106;SEC_127
2000;311;50-64;137;110;247;SEC_311
2000;219;16-17;5;13;18;SEC_219
2000;527;12-15;22;18;40;SEC_527
2000;117;65-74;70;57;127;SEC_117
2000;417;18-24;29;34;63;SEC_417
2000;301;35-49;178;199;377;SEC_301
2000;513;16-17;8;4;12;SEC_513
2000;518;00-02;10;8;18;SEC_518
2000;417;65-74;41;38;79;SEC_417
2000;609;65-74;35;38;73;SEC_609
2000;410;18-24;96;104;200;SEC_410
2000;434;18-24;27;24;51;SEC_434
2000;305;16-17;13;20;33;SEC_305
2000;211;75 i +;77;49;126;SEC_211
2000;137;03-11;55;44;99;SEC_137
2000;218;25-34;59;61;120;SEC_218
2000;516;65-74;49;37;86;SEC_516
2000;629;00-02;9;7;16;SEC_629
2000;125;03-11;37;40;77;SEC_125
2000;411;75 i +;50;34;84;SEC_411
2000;513;18-24;30;25;55;SEC_513
2000;124;35-49;107;86;193;SEC_124
2000;128;18-24;60;60;120;SEC_128
2000;140;03-11;13;16;29;SEC_140
2000;217;03-11;17;21;38;SEC_217
2000;203;00-02;5;12;17;SEC_203
2000;210;65-74;95;67;162;SEC_210
2000;316;50-64;191;218;409;SEC_316
2000;227;65-74;52;43;95;SEC_227
2000;303;25-34;172;207;379;SEC_303
2000;321;25-34;174;177;351;SEC_321
2000;301;25-34;226;230;456;SEC_301
2000;202;03-11;11;21;32;SEC_202
2000;313;12-15;35;37;72;SEC_313
2000;106;12-15;45;37;82;SEC_106
2000;409;65-74;40;39;79;SEC_409
2000;118;50-64;162;185;347;SEC_118
2000;534;50-64;110;92;202;SEC_534
2000;525;16-17;9;8;17;SEC_525
2000;228;18-24;34;30;64;SEC_228
2000;212;25-34;119;121;240;SEC_212
2000;238;50-64;64;66;130;SEC_238
2000;622;50-64;75;76;151;SEC_622
2000;433;50-64;73;71;144;SEC_433
2000;605;50-64;105;88;193;SEC_605
2000;224;65-74;46;34;80;SEC_224
2000;224;75 i +;41;13;54;SEC_224
2000;238;25-34;65;78;143;SEC_238
2000;319;65-74;35;21;56;SEC_319
2000;631;75 i +;30;18;48;SEC_631
2000;422;35-49;85;96;181;SEC_422
2000;225;03-11;10;15;25;SEC_225
2000;531;65-74;59;53;112;SEC_531
2000;508;16-17;8;6;14;SEC_508
2000;503;00-02;13;11;24;SEC_503
2000;318;18-24;53;51;104;SEC_318
2000;523;16-17;15;13;28;SEC_523
2000;138;35-49;107;91;198;SEC_138
2000;213;18-24;44;62;106;SEC_213
2000;227;00-02;6;9;15;SEC_227
2000;312;50-64;197;170;367;SEC_312
2000;521;50-64;162;187;349;SEC_521
2000;435;65-74;101;54;155;SEC_435
2000;315;50-64;118;128;246;SEC_315
2000;117;18-24;119;141;260;SEC_117
2000;417;75 i +;26;13;39;SEC_417
2000;413;00-02;1;3;4;SEC_413
2000;507;75 i +;38;23;61;SEC_507
2000;415;75 i +;46;29;75;SEC_415
2000;517;12-15;13;11;24;SEC_517
2000;220;75 i +;40;28;68;SEC_220
2000;224;12-15;7;10;17;SEC_224
2000;614;75 i +;35;16;51;SEC_614
2000;217;18-24;27;26;53;SEC_217
2000;129;65-74;46;34;80;SEC_129
2000;302;12-15;29;16;45;SEC_302
2000;136;35-49;124;118;242;SEC_136
2000;244;18-24;25;14;39;SEC_244
2000;129;00-02;6;17;23;SEC_129
2000;617;35-49;103;100;203;SEC_617
2000;113;35-49;199;167;366;SEC_113
2000;519;03-11;10;30;40;SEC_519
2000;425;75 i +;51;29;80;SEC_425
2000;233;03-11;19;17;36;SEC_233
2000;234;18-24;27;39;66;SEC_234
2000;106;35-49;264;226;490;SEC_106
2000;237;35-49;118;129;247;SEC_237
2000;503;18-24;64;74;138;SEC_503
2000;514;16-17;7;7;14;SEC_514
2000;612;00-02;8;7;15;SEC_612
2000;614;00-02;7;7;14;SEC_614
2000;610;18-24;75;68;143;SEC_610
2000;117;75 i +;57;28;85;SEC_117
2000;525;18-24;48;46;94;SEC_525
2000;112;12-15;30;23;53;SEC_112
2000;507;25-34;77;99;176;SEC_507
2000;528;25-34;114;117;231;SEC_528
2000;215;50-64;77;54;131;SEC_215
2000;319;50-64;77;75;152;SEC_319
2000;401;75 i +;42;20;62;SEC_401
2000;523;12-15;17;21;38;SEC_523
2000;524;00-02;19;13;32;SEC_524
2000;107;03-11;47;57;104;SEC_107
2000;304;50-64;108;105;213;SEC_304
2000;134;50-64;113;110;223;SEC_134
2000;116;18-24;105;107;212;SEC_116
2000;221;12-15;16;22;38;SEC_221
2000;247;16-17;3;9;12;SEC_247
2000;306;50-64;139;128;267;SEC_306
2000;519;65-74;44;41;85;SEC_519
2000;614;25-34;104;114;218;SEC_614
2000;519;50-64;55;48;103;SEC_519
2000;609;25-34;83;106;189;SEC_609
2000;408;18-24;31;49;80;SEC_408
2000;412;35-49;169;168;337;SEC_412
2000;219;00-02;16;11;27;SEC_219
2000;236;65-74;89;71;160;SEC_236
2000;432;50-64;146;152;298;SEC_432
2000;136;65-74;51;48;99;SEC_136
2000;228;65-74;47;40;87;SEC_228
2000;514;25-34;56;62;118;SEC_514
2000;322;03-11;37;41;78;SEC_322
2000;308;75 i +;75;41;116;SEC_308
2000;119;35-49;147;123;270;SEC_119
2000;135;35-49;174;163;337;SEC_135
2000;518;50-64;111;95;206;SEC_518
2000;404;50-64;124;113;237;SEC_404
2000;123;35-49;126;131;257;SEC_123
2000;616;18-24;193;207;400;SEC_616
2000;109;03-11;35;46;81;SEC_109
2000;321;00-02;34;28;62;SEC_321
2000;213;50-64;86;96;182;SEC_213
2000;219;18-24;47;51;98;SEC_219
2000;503;35-49;142;106;248;SEC_503
2000;211;50-64;90;72;162;SEC_211
2000;418;12-15;16;24;40;SEC_418
2000;119;00-02;11;10;21;SEC_119
2000;129;25-34;104;129;233;SEC_129
2000;522;03-11;25;15;40;SEC_522
2000;423;50-64;105;105;210;SEC_423
2000;208;25-34;119;144;263;SEC_208
2000;631;03-11;39;28;67;SEC_631
2000;524;65-74;77;54;131;SEC_524
2000;525;75 i +;36;29;65;SEC_525
2000;608;00-02;8;6;14;SEC_608
2000;422;75 i +;68;41;109;SEC_422
2000;230;18-24;27;28;55;SEC_230
2000;106;00-02;24;21;45;SEC_106
2000;527;65-74;69;44;113;SEC_527
2000;110;25-34;102;96;198;SEC_110
2000;514;50-64;66;53;119;SEC_514
2000;610;16-17;13;12;25;SEC_610
2000;511;16-17;1;4;5;SEC_511
2000;428;12-15;12;6;18;SEC_428
2000;620;65-74;22;27;49;SEC_620
2000;207;75 i +;65;28;93;SEC_207
2000;123;25-34;111;102;213;SEC_123
2000;606;12-15;24;18;42;SEC_606
2000;215;12-15;15;15;30;SEC_215
2000;303;16-17;4;12;16;SEC_303
2000;405;35-49;57;70;127;SEC_405
2000;133;03-11;16;32;48;SEC_133
2000;420;75 i +;72;38;110;SEC_420
2000;228;03-11;20;16;36;SEC_228
2000;204;65-74;52;41;93;SEC_204
2000;419;75 i +;42;18;60;SEC_419
2000;322;16-17;14;8;22;SEC_322
2000;604;18-24;38;48;86;SEC_604
2000;411;65-74;94;71;165;SEC_411
2000;510;00-02;17;23;40;SEC_510
2000;249;16-17;6;10;16;SEC_249
2000;511;18-24;30;26;56;SEC_511
2000;537;00-02;8;13;21;SEC_537
2000;426;65-74;60;45;105;SEC_426
2000;122;25-34;81;88;169;SEC_122
2000;117;12-15;52;51;103;SEC_117
2000;322;35-49;104;100;204;SEC_322
2000;215;65-74;75;52;127;SEC_215
2000;617;00-02;12;9;21;SEC_617
2000;222;16-17;9;8;17;SEC_222
2000;313;00-02;25;27;52;SEC_313
2000;611;16-17;13;10;23;SEC_611
2000;506;50-64;218;237;455;SEC_506
2000;404;25-34;113;128;241;SEC_404
2000;308;65-74;70;64;134;SEC_308
2000;607;16-17;7;11;18;SEC_607
2000;416;03-11;24;32;56;SEC_416
2000;516;50-64;64;53;117;SEC_516
2000;505;16-17;14;9;23;SEC_505
2000;502;25-34;115;131;246;SEC_502
2000;518;35-49;79;94;173;SEC_518
2000;206;12-15;15;12;27;SEC_206
2000;231;18-24;46;57;103;SEC_231
2000;616;16-17;54;31;85;SEC_616
2000;421;75 i +;50;33;83;SEC_421
2000;233;12-15;11;8;19;SEC_233
2000;517;18-24;44;62;106;SEC_517
2000;502;00-02;14;15;29;SEC_502
2000;109;16-17;9;15;24;SEC_109
2000;203;50-64;55;61;116;SEC_203
2000;615;35-49;51;52;103;SEC_615
2000;115;75 i +;49;26;75;SEC_115
2000;438;18-24;36;34;70;SEC_438
2000;202;25-34;66;74;140;SEC_202
2000;536;16-17;5;7;12;SEC_536
2000;210;35-49;76;82;158;SEC_210
2000;401;35-49;119;113;232;SEC_401
2000;223;65-74;80;70;150;SEC_223
2000;215;18-24;32;35;67;SEC_215
2000;127;18-24;35;41;76;SEC_127
2000;206;18-24;36;35;71;SEC_206
2000;606;65-74;78;64;142;SEC_606
2000;620;16-17;9;7;16;SEC_620
2000;630;25-34;64;72;136;SEC_630
2000;201;16-17;8;6;14;SEC_201
2000;235;25-34;121;111;232;SEC_235
2000;117;25-34;178;165;343;SEC_117
2000;134;16-17;11;14;25;SEC_134
2000;620;18-24;62;42;104;SEC_620
2000;218;12-15;7;18;25;SEC_218
2000;318;50-64;68;75;143;SEC_318
2000;102;35-49;156;142;298;SEC_102
2000;109;75 i +;46;24;70;SEC_109
2000;214;00-02;7;5;12;SEC_214
2000;608;12-15;19;25;44;SEC_608
2000;525;00-02;10;10;20;SEC_525
2000;318;75 i +;13;12;25;SEC_318
2000;315;12-15;24;28;52;SEC_315
2000;506;25-34;156;165;321;SEC_506
2000;128;35-49;94;89;183;SEC_128
2000;317;12-15;14;17;31;SEC_317
2000;104;03-11;30;19;49;SEC_104
2000;610;25-34;117;150;267;SEC_610
2000;535;50-64;147;144;291;SEC_535
2000;417;12-15;13;9;22;SEC_417
2000;113;18-24;101;87;188;SEC_113
2000;624;18-24;74;107;181;SEC_624
2000;237;03-11;35;30;65;SEC_237
2000;234;50-64;79;65;144;SEC_234
2000;119;75 i +;49;42;91;SEC_119
2000;218;18-24;33;37;70;SEC_218
2000;117;03-11;73;64;137;SEC_117
2000;318;03-11;40;45;85;SEC_318
2000;517;16-17;10;14;24;SEC_517
2000;314;00-02;28;28;56;SEC_314
2000;602;18-24;32;24;56;SEC_602
2000;126;16-17;10;9;19;SEC_126
2000;432;12-15;18;24;42;SEC_432
2000;441;16-17;37;32;69;SEC_441
2000;217;35-49;68;70;138;SEC_217
2000;418;25-34;95;107;202;SEC_418
2000;208;03-11;38;43;81;SEC_208
2000;533;25-34;86;91;177;SEC_533
2000;407;16-17;6;6;12;SEC_407
2000;402;50-64;80;74;154;SEC_402
2000;129;75 i +;40;20;60;SEC_129
2000;418;35-49;95;115;210;SEC_418
2000;607;03-11;35;33;68;SEC_607
2000;111;12-15;17;21;38;SEC_111
2000;320;03-11;16;26;42;SEC_320
2000;527;75 i +;56;28;84;SEC_527
2000;227;12-15;6;6;12;SEC_227
2000;406;50-64;130;120;250;SEC_406
2000;116;65-74;67;56;123;SEC_116
2000;534;25-34;90;104;194;SEC_534
2000;602;25-34;59;79;138;SEC_602
2000;204;35-49;41;56;97;SEC_204
2000;139;03-11;28;35;63;SEC_139
2000;504;03-11;19;25;44;SEC_504
2000;112;75 i +;64;17;81;SEC_112
2000;411;18-24;65;53;118;SEC_411
2000;421;18-24;54;55;109;SEC_421
2000;402;00-02;5;9;14;SEC_402
2000;440;18-24;66;67;133;SEC_440
2000;126;50-64;152;159;311;SEC_126
2000;504;16-17;14;5;19;SEC_504
2000;131;00-02;14;12;26;SEC_131
2000;508;75 i +;31;21;52;SEC_508
2000;412;25-34;108;134;242;SEC_412
2000;310;18-24;51;60;111;SEC_310
2000;524;75 i +;55;28;83;SEC_524
2000;243;65-74;104;94;198;SEC_243
2000;521;12-15;24;18;42;SEC_521
2000;612;65-74;46;56;102;SEC_612
2000;524;50-64;117;95;212;SEC_524
2000;101;25-34;97;107;204;SEC_101
2000;410;03-11;43;58;101;SEC_410
2000;212;03-11;38;43;81;SEC_212
2000;418;03-11;29;33;62;SEC_418
2000;112;25-34;120;112;232;SEC_112
2000;436;50-64;61;60;121;SEC_436
2000;325;25-34;158;174;332;SEC_325
2000;324;75 i +;52;24;76;SEC_324
2000;312;65-74;62;54;116;SEC_312
2000;245;35-49;96;93;189;SEC_245
2000;523;00-02;9;10;19;SEC_523
2000;432;35-49;124;117;241;SEC_432
2000;220;25-34;80;73;153;SEC_220
2000;534;18-24;46;51;97;SEC_534
2000;121;25-34;86;82;168;SEC_121
2000;306;12-15;22;36;58;SEC_306
2000;136;75 i +;57;28;85;SEC_136
2000;312;12-15;25;17;42;SEC_312
2000;426;50-64;74;73;147;SEC_426
2000;301;18-24;101;117;218;SEC_301
2000;132;75 i +;60;25;85;SEC_132
2000;606;50-64;103;81;184;SEC_606
2000;527;16-17;9;12;21;SEC_527
2000;407;50-64;97;78;175;SEC_407
2000;323;12-15;68;52;120;SEC_323
2000;508;25-34;42;51;93;SEC_508
2000;216;03-11;32;34;66;SEC_216
2000;130;00-02;9;10;19;SEC_130
2000;429;16-17;5;5;10;SEC_429
2000;427;75 i +;44;33;77;SEC_427
2000;118;16-17;33;31;64;SEC_118
2000;108;03-11;46;40;86;SEC_108
2000;116;00-02;17;15;32;SEC_116
2000;129;50-64;128;124;252;SEC_129
2000;201;25-34;58;57;115;SEC_201
2000;429;12-15;7;14;21;SEC_429
2000;420;18-24;52;73;125;SEC_420
2000;529;18-24;54;50;104;SEC_529
2000;117;35-49;248;241;489;SEC_117
2000;407;25-34;74;95;169;SEC_407
2000;616;12-15;73;89;162;SEC_616
2000;505;25-34;139;161;300;SEC_505
2000;238;03-11;16;18;34;SEC_238
2000;521;16-17;11;10;21;SEC_521
2000;311;25-34;126;144;270;SEC_311
2000;626;12-15;15;18;33;SEC_626
2000;127;00-02;15;10;25;SEC_127
2000;420;12-15;13;20;33;SEC_420
2000;413;50-64;45;47;92;SEC_413
2000;218;16-17;0;6;6;SEC_218
2000;601;65-74;56;68;124;SEC_601
2000;202;75 i +;31;24;55;SEC_202
2000;427;00-02;8;12;20;SEC_427
2000;510;25-34;107;106;213;SEC_510
2000;627;16-17;24;17;41;SEC_627
2000;430;75 i +;58;29;87;SEC_430
2000;607;75 i +;36;20;56;SEC_607
2000;529;12-15;14;16;30;SEC_529
2000;442;75 i +;30;20;50;SEC_442
2000;441;35-49;249;245;494;SEC_441
2000;243;00-02;20;21;41;SEC_243
2000;511;25-34;56;66;122;SEC_511
2000;109;50-64;89;95;184;SEC_109
2000;102;25-34;143;166;309;SEC_102
2000;324;00-02;16;12;28;SEC_324
2000;441;00-02;13;16;29;SEC_441
2000;111;18-24;37;56;93;SEC_111
2000;121;50-64;54;41;95;SEC_121
2000;532;25-34;131;126;257;SEC_532
2000;302;00-02;12;20;32;SEC_302
2000;205;50-64;82;74;156;SEC_205
2000;406;65-74;82;80;162;SEC_406
2000;306;35-49;170;161;331;SEC_306
2000;520;50-64;88;92;180;SEC_520
2000;133;50-64;87;80;167;SEC_133
2000;437;65-74;51;50;101;SEC_437
2000;422;16-17;14;7;21;SEC_422
2000;607;18-24;44;47;91;SEC_607
2000;609;16-17;7;9;16;SEC_609
2000;223;12-15;14;13;27;SEC_223
2000;535;00-02;6;8;14;SEC_535
2000;602;65-74;26;30;56;SEC_602
2000;507;12-15;17;18;35;SEC_507
2000;215;35-49;80;70;150;SEC_215
2000;402;75 i +;45;29;74;SEC_402
2000;101;18-24;59;64;123;SEC_101
2000;411;16-17;14;6;20;SEC_411
2000;307;35-49;201;157;358;SEC_307
2000;526;75 i +;37;19;56;SEC_526
2000;512;50-64;104;100;204;SEC_512
2000;420;50-64;120;102;222;SEC_420
2000;325;35-49;205;176;381;SEC_325
2000;520;16-17;8;9;17;SEC_520
2000;521;65-74;47;44;91;SEC_521
2000;114;65-74;67;67;134;SEC_114
2000;320;00-02;7;7;14;SEC_320
2000;131;50-64;159;170;329;SEC_131
2000;321;65-74;81;77;158;SEC_321
2000;530;16-17;12;14;26;SEC_530
2000;129;12-15;23;19;42;SEC_129
2000;419;65-74;36;34;70;SEC_419
2000;424;35-49;38;44;82;SEC_424
2000;139;65-74;35;27;62;SEC_139
2000;119;03-11;27;44;71;SEC_119
2000;217;50-64;35;38;73;SEC_217
2000;420;00-02;10;13;23;SEC_420
2000;405;75 i +;33;23;56;SEC_405
2000;134;35-49;136;119;255;SEC_134
2000;230;65-74;56;43;99;SEC_230
2000;430;50-64;83;81;164;SEC_430
2000;406;25-34;93;108;201;SEC_406
2000;132;12-15;44;43;87;SEC_132
2000;115;03-11;39;59;98;SEC_115
2000;231;03-11;36;23;59;SEC_231
2000;442;00-02;5;3;8;SEC_442
2000;603;00-02;9;6;15;SEC_603
2000;122;12-15;8;6;14;SEC_122
2000;507;65-74;36;35;71;SEC_507
2000;425;65-74;75;62;137;SEC_425
2000;116;35-49;162;142;304;SEC_116
2000;522;65-74;38;38;76;SEC_522
2000;222;03-11;36;27;63;SEC_222
2000;618;03-11;15;21;36;SEC_618
2000;108;50-64;109;104;213;SEC_108
2000;502;75 i +;73;43;116;SEC_502
2000;609;12-15;15;15;30;SEC_609
2000;128;12-15;13;14;27;SEC_128
2000;202;50-64;76;67;143;SEC_202
2000;626;18-24;58;64;122;SEC_626
2000;441;12-15;67;49;116;SEC_441
2000;502;65-74;66;61;127;SEC_502
2000;248;65-74;77;62;139;SEC_248
2000;441;18-24;118;111;229;SEC_441
2000;506;18-24;143;143;286;SEC_506
2000;318;12-15;18;24;42;SEC_318
2000;604;65-74;34;36;70;SEC_604
2000;522;18-24;39;41;80;SEC_522
2000;611;03-11;71;62;133;SEC_611
2000;305;00-02;15;15;30;SEC_305
2000;507;18-24;38;46;84;SEC_507
2000;415;50-64;54;53;107;SEC_415
2000;229;25-34;46;66;112;SEC_229
2000;219;12-15;20;23;43;SEC_219
2000;204;00-02;5;1;6;SEC_204
2000;623;25-34;150;154;304;SEC_623
2000;409;25-34;62;70;132;SEC_409
2000;516;35-49;46;66;112;SEC_516
2000;632;16-17;13;16;29;SEC_632
2000;628;18-24;68;83;151;SEC_628
2000;233;16-17;0;5;5;SEC_233
2000;104;00-02;15;11;26;SEC_104
2000;439;35-49;76;66;142;SEC_439
2000;247;12-15;18;17;35;SEC_247
2000;201;03-11;15;20;35;SEC_201
2000;136;16-17;11;12;23;SEC_136
2000;246;03-11;34;27;61;SEC_246
2000;417;03-11;20;17;37;SEC_417
2000;526;00-02;4;8;12;SEC_526
2000;243;16-17;15;5;20;SEC_243
2000;325;16-17;20;16;36;SEC_325
2000;537;65-74;81;60;141;SEC_537
2000;631;18-24;66;83;149;SEC_631
2000;605;03-11;10;18;28;SEC_605
2000;513;00-02;9;9;18;SEC_513
2000;438;03-11;25;24;49;SEC_438
2000;246;18-24;44;37;81;SEC_246
2000;317;00-02;9;15;24;SEC_317
2000;417;00-02;6;6;12;SEC_417
2000;125;50-64;129;142;271;SEC_125
2000;121;16-17;3;3;6;SEC_121
2000;517;75 i +;49;30;79;SEC_517
2000;307;16-17;21;13;34;SEC_307
2000;405;16-17;6;3;9;SEC_405
2000;302;35-49;157;114;271;SEC_302
2000;233;75 i +;74;29;103;SEC_233
2000;204;12-15;6;12;18;SEC_204
2000;212;16-17;14;8;22;SEC_212
2000;506;12-15;38;40;78;SEC_506
2000;305;65-74;84;54;138;SEC_305
2000;515;75 i +;24;14;38;SEC_515
2000;625;75 i +;15;8;23;SEC_625
2000;412;50-64;181;169;350;SEC_412
2000;601;16-17;12;16;28;SEC_601
2000;306;25-34;123;122;245;SEC_306
2000;429;25-34;30;40;70;SEC_429
2000;303;12-15;17;21;38;SEC_303
2000;309;18-24;40;49;89;SEC_309
2000;404;18-24;55;66;121;SEC_404
2000;530;03-11;50;42;92;SEC_530
2000;245;12-15;10;19;29;SEC_245
2000;630;50-64;105;118;223;SEC_630
2000;431;03-11;34;37;71;SEC_431
2000;603;65-74;24;23;47;SEC_603
2000;606;35-49;84;96;180;SEC_606
2000;620;03-11;20;31;51;SEC_620
2000;308;12-15;29;33;62;SEC_308
2000;301;00-02;32;17;49;SEC_301
2000;228;25-34;62;70;132;SEC_228
2000;310;25-34;82;74;156;SEC_310
2000;504;25-34;122;123;245;SEC_504
2000;112;65-74;56;48;104;SEC_112
2000;410;00-02;11;18;29;SEC_410
2000;530;18-24;51;80;131;SEC_530
2000;422;12-15;14;22;36;SEC_422
2000;614;50-64;137;119;256;SEC_614
2000;237;18-24;56;57;113;SEC_237
2000;605;00-02;4;5;9;SEC_605
2000;321;03-11;91;94;185;SEC_321
2000;415;35-49;64;69;133;SEC_415
2000;610;75 i +;35;26;61;SEC_610
2000;618;16-17;5;9;14;SEC_618
2000;526;18-24;27;39;66;SEC_526
2000;439;65-74;60;64;124;SEC_439
2000;515;16-17;7;4;11;SEC_515
2000;530;50-64;118;98;216;SEC_530
2000;401;50-64;96;93;189;SEC_401
2000;619;00-02;16;14;30;SEC_619
2000;617;50-64;119;96;215;SEC_617
2000;208;12-15;28;14;42;SEC_208
2000;430;12-15;14;14;28;SEC_430
2000;204;25-34;45;44;89;SEC_204
2000;202;16-17;4;6;10;SEC_202
2000;611;12-15;22;22;44;SEC_611
2000;107;16-17;14;20;34;SEC_107
2000;306;16-17;26;13;39;SEC_306
2000;532;65-74;86;78;164;SEC_532
2000;440;65-74;51;52;103;SEC_440
2000;414;35-49;87;81;168;SEC_414
2000;433;75 i +;47;20;67;SEC_433
2000;531;03-11;24;30;54;SEC_531
2000;125;12-15;24;18;42;SEC_125
2000;409;16-17;4;7;11;SEC_409
2000;226;25-34;86;76;162;SEC_226
2000;127;25-34;65;83;148;SEC_127
2000;601;35-49;124;124;248;SEC_601
2000;243;75 i +;82;45;127;SEC_243
2000;119;16-17;19;17;36;SEC_119
2000;110;03-11;34;44;78;SEC_110
2000;120;65-74;54;39;93;SEC_120
2000;502;50-64;151;156;307;SEC_502
2000;423;75 i +;50;24;74;SEC_423
2000;245;03-11;29;28;57;SEC_245
2000;509;00-02;6;14;20;SEC_509
2000;527;03-11;37;26;63;SEC_527
2000;321;75 i +;86;44;130;SEC_321
2000;103;75 i +;46;22;68;SEC_103
2000;325;75 i +;137;70;207;SEC_325
2000;107;25-34;173;209;382;SEC_107
2000;440;25-34;99;115;214;SEC_440
2000;517;35-49;106;111;217;SEC_517
2000;237;00-02;15;9;24;SEC_237
2000;628;65-74;44;43;87;SEC_628
2000;504;35-49;87;83;170;SEC_504
2000;621;50-64;188;228;416;SEC_621
2000;608;50-64;96;72;168;SEC_608
2000;404;16-17;11;6;17;SEC_404
2000;202;00-02;2;5;7;SEC_202
2000;229;16-17;6;6;12;SEC_229
2000;631;16-17;12;8;20;SEC_631
2000;535;25-34;74;101;175;SEC_535
2000;410;12-15;22;16;38;SEC_410
2000;618;18-24;40;33;73;SEC_618
2000;132;50-64;183;213;396;SEC_132
2000;233;65-74;45;44;89;SEC_233
2000;313;16-17;30;18;48;SEC_313
2000;427;50-64;68;50;118;SEC_427
2000;203;75 i +;52;26;78;SEC_203
2000;419;00-02;17;12;29;SEC_419
2000;324;50-64;70;68;138;SEC_324
2000;432;18-24;78;87;165;SEC_432
2000;229;00-02;8;4;12;SEC_229
2000;239;12-15;7;20;27;SEC_239
2000;421;12-15;8;11;19;SEC_421
2000;622;18-24;62;61;123;SEC_622
2000;102;12-15;30;30;60;SEC_102
2000;312;03-11;51;46;97;SEC_312
2000;442;65-74;26;26;52;SEC_442
2000;114;75 i +;59;20;79;SEC_114
2000;242;18-24;39;35;74;SEC_242
2000;521;00-02;5;4;9;SEC_521
2000;240;16-17;6;7;13;SEC_240
2000;533;65-74;63;63;126;SEC_533
2000;214;25-34;66;69;135;SEC_214
2000;619;75 i +;45;29;74;SEC_619
2000;416;25-34;58;66;124;SEC_416
2000;427;35-49;71;72;143;SEC_427
2000;220;16-17;9;11;20;SEC_220
2000;510;50-64;113;106;219;SEC_510
2000;232;50-64;94;87;181;SEC_232
2000;433;12-15;18;10;28;SEC_433
2000;223;00-02;8;6;14;SEC_223
2000;120;03-11;83;78;161;SEC_120
2000;306;03-11;56;45;101;SEC_306
2000;116;03-11;51;46;97;SEC_116
2000;402;12-15;10;12;22;SEC_402
2000;523;03-11;30;38;68;SEC_523
2000;249;03-11;24;29;53;SEC_249
2000;214;50-64;64;54;118;SEC_214
2000;616;25-34;233;270;503;SEC_616
2000;421;50-64;136;102;238;SEC_421
2000;131;18-24;105;98;203;SEC_131
2000;630;18-24;78;96;174;SEC_630
2000;314;65-74;67;55;122;SEC_314
2000;527;00-02;13;14;27;SEC_527
2000;537;50-64;148;125;273;SEC_537
2000;238;35-49;71;73;144;SEC_238
2000;103;00-02;12;8;20;SEC_103
2000;442;03-11;22;23;45;SEC_442
2000;631;00-02;6;12;18;SEC_631
2000;532;75 i +;72;37;109;SEC_532
2000;401;03-11;42;45;87;SEC_401
2000;235;35-49;92;95;187;SEC_235
2000;209;65-74;71;56;127;SEC_209
2000;534;65-74;53;58;111;SEC_534
2000;518;25-34;102;107;209;SEC_518
2000;526;50-64;61;62;123;SEC_526
2000;512;35-49;78;74;152;SEC_512
2000;206;03-11;18;23;41;SEC_206
2000;305;12-15;50;39;89;SEC_305
2000;629;65-74;42;43;85;SEC_629
2000;324;03-11;33;32;65;SEC_324
2000;126;00-02;11;8;19;SEC_126
2000;124;03-11;25;32;57;SEC_124
2000;532;00-02;21;12;33;SEC_532
2000;418;00-02;14;11;25;SEC_418
2000;238;16-17;7;3;10;SEC_238
2000;111;35-49;104;88;192;SEC_111
2000;305;18-24;75;81;156;SEC_305
2000;534;03-11;22;29;51;SEC_534
2000;109;00-02;19;12;31;SEC_109
2000;510;12-15;17;19;36;SEC_510
2000;601;25-34;102;136;238;SEC_601
2000;110;75 i +;53;29;82;SEC_110
2000;304;25-34;99;106;205;SEC_304
2000;412;18-24;95;109;204;SEC_412
2000;533;35-49;77;83;160;SEC_533
2000;316;75 i +;40;24;64;SEC_316
2000;316;25-34;103;104;207;SEC_316
2000;213;00-02;1;10;11;SEC_213
2000;408;65-74;58;61;119;SEC_408
2000;422;18-24;43;44;87;SEC_422
2000;523;50-64;137;120;257;SEC_523
2000;122;16-17;6;8;14;SEC_122
2000;538;16-17;10;10;20;SEC_538
2000;413;18-24;22;21;43;SEC_413
2000;624;16-17;17;13;30;SEC_624
2000;536;35-49;73;79;152;SEC_536
2000;202;18-24;37;40;77;SEC_202
2000;125;35-49;132;110;242;SEC_125
2000;218;65-74;40;30;70;SEC_218
2000;237;65-74;90;62;152;SEC_237
2000;230;03-11;25;27;52;SEC_230
2000;610;00-02;6;12;18;SEC_610
2000;434;16-17;8;11;19;SEC_434
2000;501;50-64;149;180;329;SEC_501
2000;120;75 i +;48;26;74;SEC_120
2000;627;75 i +;23;13;36;SEC_627
2000;118;00-02;20;28;48;SEC_118
2000;246;16-17;9;6;15;SEC_246
2000;111;25-34;75;109;184;SEC_111
2000;625;12-15;26;52;78;SEC_625
2000;324;65-74;55;40;95;SEC_324
2000;315;16-17;20;14;34;SEC_315
2000;403;00-02;9;5;14;SEC_403
2000;414;16-17;7;13;20;SEC_414
2000;217;16-17;6;9;15;SEC_217
2000;113;75 i +;45;24;69;SEC_113
2000;615;16-17;9;1;10;SEC_615
2000;211;25-34;108;122;230;SEC_211
2000;236;03-11;36;26;62;SEC_236
2000;207;35-49;76;64;140;SEC_207
2000;133;18-24;48;56;104;SEC_133
2000;419;18-24;26;42;68;SEC_419
2000;138;03-11;20;34;54;SEC_138
2000;437;00-02;16;4;20;SEC_437
2000;307;00-02;11;7;18;SEC_307
2000;245;25-34;73;93;166;SEC_245
2000;534;75 i +;45;22;67;SEC_534
2000;311;00-02;19;14;33;SEC_311
2000;231;35-49;97;104;201;SEC_231
2000;247;35-49;118;135;253;SEC_247
2000;205;00-02;11;7;18;SEC_205
2000;629;25-34;48;60;108;SEC_629
2000;519;25-34;60;54;114;SEC_519
2000;615;25-34;93;133;226;SEC_615
2000;427;65-74;77;57;134;SEC_427
2000;301;65-74;111;106;217;SEC_301
2000;126;12-15;12;13;25;SEC_126
2000;416;65-74;53;59;112;SEC_416
2000;442;16-17;7;5;12;SEC_442
2000;140;25-34;83;92;175;SEC_140
2000;139;50-64;85;82;167;SEC_139
2000;426;25-34;70;83;153;SEC_426
2000;227;25-34;67;65;132;SEC_227
2000;101;50-64;97;92;189;SEC_101
2000;310;65-74;42;38;80;SEC_310
2000;230;35-49;52;73;125;SEC_230
2000;307;50-64;166;166;332;SEC_307
2000;109;12-15;28;13;41;SEC_109
2000;513;35-49;58;62;120;SEC_513
2000;321;12-15;37;54;91;SEC_321
2000;234;65-74;83;49;132;SEC_234
2000;236;16-17;7;4;11;SEC_236
2000;110;50-64;161;154;315;SEC_110
2000;230;16-17;5;5;10;SEC_230
2000;112;50-64;141;150;291;SEC_112
2000;314;75 i +;65;34;99;SEC_314
2000;321;18-24;163;155;318;SEC_321
2000;123;12-15;21;12;33;SEC_123
2000;135;18-24;83;111;194;SEC_135
2000;245;16-17;2;7;9;SEC_245
2000;505;00-02;7;5;12;SEC_505
2000;311;12-15;19;16;35;SEC_311
2000;222;75 i +;33;20;53;SEC_222
2000;622;25-34;89;104;193;SEC_622
2000;322;50-64;93;90;183;SEC_322
2000;309;03-11;22;34;56;SEC_309
2000;106;16-17;36;33;69;SEC_106
2000;437;75 i +;25;15;40;SEC_437
2000;532;12-15;23;16;39;SEC_532
2000;436;16-17;4;8;12;SEC_436
2000;510;65-74;61;50;111;SEC_510
2000;412;65-74;94;92;186;SEC_412
2000;312;25-34;170;198;368;SEC_312
2000;213;75 i +;31;24;55;SEC_213
2000;510;18-24;47;51;98;SEC_510
2000;528;16-17;6;6;12;SEC_528
2000;221;25-34;100;73;173;SEC_221
2000;323;50-64;220;267;487;SEC_323
2000;120;12-15;40;45;85;SEC_120
2000;630;16-17;13;11;24;SEC_630
2000;528;65-74;63;59;122;SEC_528
2000;538;50-64;121;96;217;SEC_538
2000;130;16-17;4;5;9;SEC_130
2000;132;25-34;161;174;335;SEC_132
2000;516;25-34;68;62;130;SEC_516
2000;538;25-34;97;109;206;SEC_538
2000;214;16-17;2;7;9;SEC_214
2000;130;35-49;78;95;173;SEC_130
2000;529;65-74;88;87;175;SEC_529
2000;235;50-64;142;112;254;SEC_235
2000;622;35-49;97;89;186;SEC_622
2000;219;25-34;103;89;192;SEC_219
2000;240;25-34;60;65;125;SEC_240
2000;611;25-34;184;201;385;SEC_611
2000;624;50-64;159;179;338;SEC_624
2000;538;18-24;50;49;99;SEC_538
2000;237;25-34;106;147;253;SEC_237
2000;117;16-17;32;27;59;SEC_117
2000;515;00-02;6;4;10;SEC_515
2000;515;35-49;50;43;93;SEC_515
2000;625;65-74;38;36;74;SEC_625
2000;423;12-15;11;19;30;SEC_423
2000;509;35-49;74;65;139;SEC_509
2000;421;03-11;28;35;63;SEC_421
2000;605;35-49;52;41;93;SEC_605
2000;314;12-15;64;70;134;SEC_314
2000;525;65-74;59;50;109;SEC_525
2000;227;03-11;21;15;36;SEC_227
2000;521;75 i +;42;24;66;SEC_521
2000;221;16-17;7;12;19;SEC_221
2000;511;12-15;6;10;16;SEC_511
2000;501;18-24;108;128;236;SEC_501
2000;320;65-74;27;13;40;SEC_320
2000;249;25-34;78;91;169;SEC_249
2000;521;18-24;88;87;175;SEC_521
2000;128;00-02;8;6;14;SEC_128
2000;403;75 i +;50;25;75;SEC_403
2000;616;65-74;52;48;100;SEC_616
2000;232;65-74;78;55;133;SEC_232
2000;405;25-34;87;80;167;SEC_405
2000;222;00-02;10;5;15;SEC_222
2000;503;75 i +;27;11;38;SEC_503
2000;208;00-02;13;12;25;SEC_208
2000;428;16-17;2;3;5;SEC_428
2000;601;50-64;182;169;351;SEC_601
2000;215;00-02;5;6;11;SEC_215
2000;509;65-74;36;35;71;SEC_509
2000;526;03-11;20;25;45;SEC_526
2000;101;03-11;47;59;106;SEC_101
2000;135;00-02;19;14;33;SEC_135
2000;422;25-34;71;78;149;SEC_422
2000;213;03-11;30;32;62;SEC_213
2000;131;12-15;27;29;56;SEC_131
2000;138;50-64;91;79;170;SEC_138
2000;406;75 i +;50;31;81;SEC_406
2000;434;65-74;63;42;105;SEC_434
2000;415;12-15;8;12;20;SEC_415
2000;313;65-74;75;74;149;SEC_313
2000;207;12-15;8;11;19;SEC_207
2000;435;16-17;7;11;18;SEC_435
2000;301;16-17;19;25;44;SEC_301
2000;215;16-17;6;7;13;SEC_215
2000;303;50-64;207;180;387;SEC_303
2000;229;75 i +;47;19;66;SEC_229
2000;414;75 i +;43;28;71;SEC_414
2000;614;03-11;28;36;64;SEC_614
2000;512;75 i +;51;27;78;SEC_512
2000;435;12-15;23;24;47;SEC_435
2000;121;35-49;74;94;168;SEC_121
2000;108;25-34;103;98;201;SEC_108
2000;304;16-17;6;10;16;SEC_304
2000;425;00-02;8;10;18;SEC_425
2000;112;00-02;8;12;20;SEC_112
2000;429;18-24;34;43;77;SEC_429
2000;305;25-34;99;112;211;SEC_305
2000;625;00-02;14;10;24;SEC_625
2000;628;75 i +;32;15;47;SEC_628
2000;442;18-24;23;28;51;SEC_442
2000;104;12-15;5;8;13;SEC_104
2000;128;75 i +;38;24;62;SEC_128
2000;432;03-11;26;42;68;SEC_432
2000;521;35-49;103;82;185;SEC_521
2000;526;25-34;56;67;123;SEC_526
2000;533;50-64;84;71;155;SEC_533
2000;318;65-74;21;18;39;SEC_318
2000;418;75 i +;72;40;112;SEC_418
2000;427;03-11;19;30;49;SEC_427
2000;408;03-11;19;26;45;SEC_408
2000;232;00-02;8;11;19;SEC_232
2000;117;00-02;26;21;47;SEC_117
2000;611;00-02;13;18;31;SEC_611
2000;105;50-64;91;107;198;SEC_105
2000;206;65-74;64;60;124;SEC_206
2000;626;75 i +;26;21;47;SEC_626
2000;309;75 i +;27;12;39;SEC_309
2000;140;18-24;51;55;106;SEC_140
2000;507;50-64;93;96;189;SEC_507
2000;608;35-49;91;88;179;SEC_608
2000;243;50-64;127;106;233;SEC_243
2000;205;12-15;13;15;28;SEC_205
2000;424;18-24;24;44;68;SEC_424
2000;106;03-11;56;61;117;SEC_106
2000;604;25-34;61;84;145;SEC_604
2000;121;18-24;21;28;49;SEC_121
2000;135;50-64;138;150;288;SEC_135
2000;235;03-11;24;35;59;SEC_235
2000;121;03-11;42;35;77;SEC_121
2000;436;18-24;47;49;96;SEC_436
2000;501;00-02;12;9;21;SEC_501
2000;237;12-15;13;13;26;SEC_237
2000;631;35-49;86;74;160;SEC_631
2000;131;16-17;17;12;29;SEC_131
2000;506;16-17;16;25;41;SEC_506
2000;102;50-64;203;204;407;SEC_102
2000;242;25-34;69;80;149;SEC_242
2000;311;18-24;56;73;129;SEC_311
2000;436;00-02;11;17;28;SEC_436
2000;628;00-02;6;11;17;SEC_628
2000;415;65-74;44;33;77;SEC_415
2000;323;75 i +;46;16;62;SEC_323
2000;521;25-34;107;116;223;SEC_521
2000;120;35-49;219;224;443;SEC_120
2000;503;12-15;31;21;52;SEC_503
2000;518;12-15;14;18;32;SEC_518
2000;501;35-49;139;95;234;SEC_501
2000;438;35-49;67;67;134;SEC_438
2000;206;35-49;76;66;142;SEC_206
2000;515;65-74;33;22;55;SEC_515
2000;507;00-02;8;6;14;SEC_507
2000;239;00-02;10;13;23;SEC_239
2000;305;03-11;58;42;100;SEC_305
2000;207;25-34;44;39;83;SEC_207
2000;416;50-64;76;59;135;SEC_416
2000;217;25-34;40;63;103;SEC_217
2000;405;65-74;89;80;169;SEC_405
2000;241;16-17;5;5;10;SEC_241
2000;632;75 i +;25;13;38;SEC_632
2000;607;35-49;87;93;180;SEC_607
2000;204;18-24;19;21;40;SEC_204
2000;129;18-24;64;52;116;SEC_129
2000;201;12-15;7;11;18;SEC_201
2000;501;65-74;22;24;46;SEC_501
2000;535;03-11;30;37;67;SEC_535
2000;115;12-15;14;29;43;SEC_115
2000;437;16-17;9;7;16;SEC_437
2000;620;12-15;12;12;24;SEC_620
2000;621;16-17;21;26;47;SEC_621
2000;528;35-49;90;98;188;SEC_528
2000;111;16-17;10;5;15;SEC_111
2000;610;50-64;212;199;411;SEC_610
2000;140;65-74;67;60;127;SEC_140
2000;302;25-34;143;149;292;SEC_302
2000;210;03-11;25;20;45;SEC_210
2000;627;35-49;145;117;262;SEC_627
2000;123;16-17;10;14;24;SEC_123
2000;240;35-49;61;60;121;SEC_240
2000;610;65-74;59;52;111;SEC_610
2000;433;16-17;11;12;23;SEC_433
2000;618;50-64;73;77;150;SEC_618
2000;217;00-02;4;8;12;SEC_217
2000;602;50-64;85;75;160;SEC_602
2000;226;03-11;23;30;53;SEC_226
2000;221;03-11;41;44;85;SEC_221
2000;210;00-02;5;5;10;SEC_210
2000;135;25-34;120;114;234;SEC_135
2000;242;65-74;89;80;169;SEC_242
2000;402;03-11;25;14;39;SEC_402
2000;506;75 i +;64;37;101;SEC_506
2000;306;75 i +;75;47;122;SEC_306
2000;316;03-11;90;100;190;SEC_316
2000;430;03-11;24;41;65;SEC_430
2000;440;35-49;63;84;147;SEC_440
2000;247;18-24;57;51;108;SEC_247
2000;606;18-24;54;48;102;SEC_606
2000;127;03-11;33;35;68;SEC_127
2000;408;16-17;10;11;21;SEC_408
2000;308;50-64;169;167;336;SEC_308
2000;609;75 i +;29;11;40;SEC_609
2000;432;65-74;75;63;138;SEC_432
2000;228;12-15;7;8;15;SEC_228
2000;406;12-15;20;19;39;SEC_406
2000;408;75 i +;36;18;54;SEC_408
2000;432;00-02;10;8;18;SEC_432
2000;602;03-11;20;19;39;SEC_602
2000;139;00-02;12;8;20;SEC_139
2000;515;18-24;30;21;51;SEC_515
2000;139;18-24;55;58;113;SEC_139
2000;438;50-64;102;95;197;SEC_438
2000;532;50-64;151;147;298;SEC_532
2000;211;18-24;45;49;94;SEC_211
2000;629;18-24;34;34;68;SEC_629
2000;618;35-49;57;48;105;SEC_618
2000;128;65-74;47;49;96;SEC_128
2000;125;75 i +;35;22;57;SEC_125
2000;632;50-64;100;88;188;SEC_632
2000;413;65-74;48;40;88;SEC_413
2000;516;00-02;11;13;24;SEC_516
2000;501;25-34;93;120;213;SEC_501
2000;221;18-24;48;58;106;SEC_221
2000;240;50-64;58;53;111;SEC_240
2000;225;18-24;17;26;43;SEC_225
2000;436;12-15;15;15;30;SEC_436
2000;530;00-02;10;18;28;SEC_530
2000;512;16-17;7;5;12;SEC_512
2000;122;35-49;65;78;143;SEC_122
2000;138;00-02;10;7;17;SEC_138
2000;613;03-11;35;37;72;SEC_613
2000;419;03-11;32;30;62;SEC_419
2000;424;03-11;10;10;20;SEC_424
2000;616;75 i +;33;19;52;SEC_616
2000;305;75 i +;74;42;116;SEC_305
2000;505;03-11;25;20;45;SEC_505
2000;225;16-17;6;5;11;SEC_225
2000;509;25-34;61;82;143;SEC_509
2000;203;35-49;70;78;148;SEC_203
2000;235;18-24;47;55;102;SEC_235
2000;314;03-11;84;115;199;SEC_314
2000;133;35-49;90;87;177;SEC_133
2000;245;65-74;72;58;130;SEC_245
2000;218;35-49;73;79;152;SEC_218
2000;629;50-64;65;49;114;SEC_629
2000;408;25-34;68;79;147;SEC_408
2000;405;12-15;9;8;17;SEC_405
2000;626;16-17;10;8;18;SEC_626
2000;618;12-15;12;11;23;SEC_618
2000;214;75 i +;40;18;58;SEC_214
2000;304;00-02;12;13;25;SEC_304
2000;509;16-17;9;7;16;SEC_509
2000;209;35-49;88;95;183;SEC_209
2000;116;12-15;27;23;50;SEC_116
2000;239;50-64;119;70;189;SEC_239
2000;628;16-17;16;12;28;SEC_628
2000;536;65-74;78;64;142;SEC_536
2000;433;65-74;48;43;91;SEC_433
2000;604;12-15;10;12;22;SEC_604
2000;214;18-24;34;27;61;SEC_214
2000;320;75 i +;20;12;32;SEC_320
2000;128;50-64;104;91;195;SEC_128
2000;312;75 i +;46;30;76;SEC_312
2000;103;03-11;28;20;48;SEC_103
2000;434;00-02;7;2;9;SEC_434
2000;226;16-17;10;7;17;SEC_226
2000;101;16-17;24;16;40;SEC_101
2000;513;50-64;80;68;148;SEC_513
2000;235;00-02;14;11;25;SEC_235
2000;113;50-64;110;130;240;SEC_113
2000;425;35-49;76;86;162;SEC_425
2000;133;00-02;5;4;9;SEC_133
2000;318;16-17;15;9;24;SEC_318
2000;402;16-17;4;7;11;SEC_402
2000;404;12-15;16;18;34;SEC_404
2000;403;50-64;143;130;273;SEC_403
2000;526;16-17;4;5;9;SEC_526
2000;442;25-34;47;46;93;SEC_442
2000;322;75 i +;47;21;68;SEC_322
2000;247;25-34;96;107;203;SEC_247
2000;503;16-17;12;16;28;SEC_503
2000;606;75 i +;37;22;59;SEC_606
2000;228;35-49;44;49;93;SEC_228
2000;620;35-49;63;60;123;SEC_620
2000;308;03-11;44;45;89;SEC_308
2000;128;25-34;112;104;216;SEC_128
2000;613;16-17;8;5;13;SEC_613
2000;431;75 i +;63;41;104;SEC_431
2000;614;35-49;82;71;153;SEC_614
2000;415;03-11;21;23;44;SEC_415
2000;124;50-64;72;72;144;SEC_124
2000;241;12-15;15;8;23;SEC_241
2000;615;03-11;12;22;34;SEC_615
2000;112;18-24;93;79;172;SEC_112
2000;431;65-74;86;71;157;SEC_431
2000;140;12-15;8;12;20;SEC_140
2000;139;25-34;76;82;158;SEC_139
2000;409;00-02;13;5;18;SEC_409
2000;613;12-15;17;16;33;SEC_613
2000;626;25-34;79;117;196;SEC_626
2000;611;35-49;118;154;272;SEC_611
2000;131;65-74;61;53;114;SEC_131
2000;414;50-64;78;77;155;SEC_414
2000;122;65-74;50;48;98;SEC_122
2000;322;00-02;12;10;22;SEC_322
2000;410;50-64;199;178;377;SEC_410
2000;229;03-11;25;21;46;SEC_229
2000;529;00-02;13;17;30;SEC_529
2000;601;12-15;17;20;37;SEC_601
2000;220;50-64;71;53;124;SEC_220
2000;511;65-74;54;46;100;SEC_511
2000;511;03-11;18;21;39;SEC_511
2000;436;35-49;72;80;152;SEC_436
2000;442;50-64;64;56;120;SEC_442
2000;310;16-17;11;10;21;SEC_310
2000;240;65-74;63;46;109;SEC_240
2000;225;25-34;30;42;72;SEC_225
2000;513;25-34;62;64;126;SEC_513
2000;613;50-64;205;186;391;SEC_613
2000;131;03-11;45;49;94;SEC_131
2000;428;03-11;17;15;32;SEC_428
2000;135;65-74;61;54;115;SEC_135
2000;221;00-02;14;13;27;SEC_221
2000;312;16-17;12;13;25;SEC_312
2000;429;00-02;4;6;10;SEC_429
2000;303;65-74;111;115;226;SEC_303
2000;229;35-49;62;54;116;SEC_229
2000;209;03-11;20;37;57;SEC_209
2000;101;65-74;35;48;83;SEC_101
2000;323;00-02;54;40;94;SEC_323
2000;138;75 i +;19;13;32;SEC_138
2000;220;00-02;7;10;17;SEC_220
2000;523;75 i +;82;35;117;SEC_523
2000;413;25-34;44;57;101;SEC_413
2000;313;03-11;76;53;129;SEC_313
2000;502;35-49;149;135;284;SEC_502
2000;535;65-74;41;37;78;SEC_535
2000;527;25-34;84;92;176;SEC_527
2000;212;50-64;141;114;255;SEC_212
2000;612;75 i +;45;22;67;SEC_612
2000;133;75 i +;45;33;78;SEC_133
2000;624;03-11;36;33;69;SEC_624
2000;513;65-74;51;50;101;SEC_513
2000;205;18-24;44;44;88;SEC_205
2000;518;03-11;30;26;56;SEC_518
2000;102;65-74;98;71;169;SEC_102
2000;139;12-15;11;15;26;SEC_139
2000;529;25-34;100;98;198;SEC_529
2000;414;25-34;75;73;148;SEC_414
2000;209;50-64;85;67;152;SEC_209
2000;232;25-34;91;83;174;SEC_232
2000;632;00-02;19;13;32;SEC_632
2000;619;50-64;171;151;322;SEC_619
2000;304;18-24;50;53;103;SEC_304
2000;248;75 i +;64;40;104;SEC_248
2000;622;00-02;11;14;25;SEC_622
2000;628;12-15;20;23;43;SEC_628
2000;407;03-11;24;31;55;SEC_407
2000;509;75 i +;38;16;54;SEC_509
2000;429;75 i +;33;23;56;SEC_429
2000;244;35-49;67;76;143;SEC_244
2000;434;75 i +;55;33;88;SEC_434
2000;524;12-15;17;18;35;SEC_524
2000;529;75 i +;66;37;103;SEC_529
2000;244;75 i +;44;42;86;SEC_244
2000;619;25-34;104;125;229;SEC_619
2000;212;35-49;112;113;225;SEC_212
2000;630;12-15;19;15;34;SEC_630
